date,state,positive,negative,pending,hospitalizedCurrently,hospitalizedCumulative,inIcuCurrently,inIcuCumulative,onVentilatorCurrently,onVentilatorCumulative,recovered,hash,dateChecked,death,hospitalized,total,totalTestResults,posNeg,fips,deathIncrease,hospitalizedIncrease,negativeIncrease,positiveIncrease,totalTestResultsIncrease
20200402,AK,143,4879,,,9,,,,,,87a29f5de0e12ea1b772006bfa38cdee3327489e,2020-04-02T20:00:00Z,3,9,5022,5022,5022,02,0,0,409,10,419
20200402,AL,1233,7503,,,,,,,,,1a78d31c95bd0d315fc61461107fcd8c66e53b43,2020-04-02T20:00:00Z,32,,8736,8736,8736,01,6,0,806,156,962
20200402,AR,643,7880,,66,,,,23,,47,34259fa1839931debea61bd331ad6b244b1942b5,2020-04-02T20:00:00Z,12,,8523,8523,8523,05,2,0,526,59,585
20200402,AS,0,20,6,,,,,,,,7058273a82ba6625ccd3a695324eba9718a267c6,2020-04-02T20:00:00Z,0,,26,20,20,60,0,0,0,0,0
20200402,AZ,1598,21111,,,228,,83,,,,51dcd56d6738e79b41c1c6d32c5454a7d2d1e2bf,2020-04-02T20:00:00Z,32,228,22709,22709,22709,04,3,79,1466,185,1651
20200402,CA,9191,23809,59500,1922,,816,,,,,99877fe91b05bb13daef3f63c02c50d2a271e7f5,2020-04-02T20:00:00Z,203,,92500,33000,33000,06,32,0,2037,1036,3073
20200402,CO,3342,15303,,,620,,,,,,87f72739eeb827250a64fd310d95871229e9020f,2020-04-02T20:00:00Z,80,620,18645,18645,18645,08,11,111,1420,376,1796
20200402,CT,3824,14476,,827,,,,,,,bbaf84bc79e98252465e76199b3d66cb58316223,2020-04-02T20:00:00Z,112,,18300,18300,18300,09,27,0,1433,267,1700
20200402,DC,653,4417,,,,,,,,173,bb0f0a7da39336cefc7629d9814ca0bd2a83e358,2020-04-02T20:00:00Z,12,,5070,5070,5070,11,1,0,1155,67,1222
20200402,DE,393,4566,,56,,,,,,49,ed433f1aae9fc98fb0f7510f5bbd3f0bd9cdf5ab,2020-04-02T20:00:00Z,12,,4959,4959,4959,10,1,0,551,25,576
20200402,FL,8010,69286,1285,,1123,,,,,,174161bf2644248219c4f77323f7aa378fc8d409,2020-04-02T20:00:00Z,128,1123,78581,77296,77296,12,41,174,9757,1055,10812
20200402,GA,5348,17609,,,1056,,,,,,15b36e0f73598e9edefa4eb26b735231587f472d,2020-04-02T20:00:00Z,163,1056,22957,22957,22957,13,24,104,1921,710,2631
20200402,GU,82,442,,,19,,2,,,12,c1dc7b10d8fcbd564a478033f31f3dada3fdab32,2020-04-02T20:00:00Z,3,19,524,524,524,66,0,0,36,5,41
20200402,HI,258,10206,18,,15,,6,,,69,1667aacc243bb04be1feba216c23977710e071e8,2020-04-02T20:00:00Z,1,15,10482,10464,10464,15,0,2,1485,50,1535
20200402,IA,614,8054,,74,120,,,,,46,1f5c0a22d84a29b633b8b5a1fd1154e5b7a69bd9,2020-04-02T20:00:00Z,11,120,8668,8668,8668,19,2,21,750,65,815
20200402,ID,669,6613,,,49,,7,,,,378cb12d7518fb0b43fcd79e17608a1b0d3a2d1c,2020-04-02T20:00:00Z,9,49,7282,7282,7282,16,0,3,537,144,681
20200402,IL,7695,35961,,,,,,,,,1a8b1e0bab7743ed9c982d78d0d7844622a6d6a3,2020-04-02T20:00:00Z,157,,43656,43656,43656,17,16,0,2557,715,3272
20200402,IN,3039,13246,,,,,,,,,7efa7f48655167cc1d748ae1740c9b97dd06a209,2020-04-02T20:00:00Z,78,,16285,16285,16285,18,13,0,1436,474,1910
20200402,KS,552,6059,,,138,,,,,,e1d064496cc599d8997422f5393e363895fed048,2020-04-02T20:00:00Z,13,138,6611,6611,6611,20,3,24,648,70,718
20200402,KY,680,7220,,,,,,,,,9ab2e64fd49a2aba449f469559e03c171789906f,2020-04-02T20:00:00Z,20,,7900,7900,7900,21,3,0,255,89,344
20200402,LA,9150,41936,,,1639,,,,507,,00bc323a6acfed050d7eb6527cbc2edd1bea6eb7,2020-04-02T20:00:00Z,310,1639,51086,51086,51086,22,37,141,2584,2726,5310
20200402,MA,8966,47642,,,813,,,,,,79d0614d1b714ae75a41b332ec20fb5cbecebab8,2020-04-02T20:00:00Z,154,813,56608,56608,56608,25,32,131,3642,1228,4870
20200402,MD,2331,18890,,,582,,,,,81,ecc07bae25f936e57b3850a6ce3bcb5de2a72e94,2020-04-02T20:00:00Z,36,582,21221,21221,21221,24,5,60,1657,346,2003
20200402,ME,376,6088,,,68,,,,,94,06fbf4e13e1f498f67a0c8c3ed6230b5d2545f50,2020-04-02T20:00:00Z,7,68,6464,6464,6464,23,0,5,0,32,32
20200402,MI,10791,11893,,,,,,,,,6f2458a7d5643a87a271e0b9bb088a7bff260de3,2020-04-02T20:00:00Z,417,,22684,22684,22684,26,80,0,0,1457,1457
20200402,MN,742,21652,,75,138,38,38,,,,af6b7633af8e8dd204b0ba17fe37e8ade6cd0abb,2020-04-02T20:00:00Z,18,138,22394,22394,22394,27,1,16,1150,53,1203
20200402,MO,1834,17849,,,,,,,,,db61b660ddb54194c33a182e92605bcbeccb7e37,2020-04-02T20:00:00Z,19,,19683,19683,19683,29,1,0,2003,253,2256
20200402,MP,8,13,12,,,,,,,,4c6b9b16d6a6f74a9d5d88fac1a5f162fbf047df,2020-04-02T20:00:00Z,1,,33,21,21,69,1,0,13,2,15
20200402,MS,1177,4753,,,360,,,,,,3fcf47375c2d49eb03ea205131eac0e18c42a29d,2020-04-02T20:00:00Z,26,360,5930,5930,5930,28,4,28,1041,104,1145
20200402,MT,227,5093,,,20,,,,,,83ed127512ee7881e2dc28380478203d2775dbaa,2020-04-02T20:00:00Z,5,20,5320,5320,5320,30,0,3,383,19,402
20200402,NC,1857,26822,,184,204,,,,,,fc6505af359bdeaf2b3e4eb74c3845c86659e04c,2020-04-02T20:00:00Z,16,204,28679,28679,28679,37,6,0,2163,273,2436
20200402,ND,159,4821,,,28,,,,,43,772ba7dafcd9354101e253cccb816ef1eebf1dc7,2020-04-02T20:00:00Z,3,28,4980,4980,4980,38,0,5,470,17,487
20200402,NE,246,3978,11,,,,,,,,1e5adc3c19a8d6dfeddcd695a6e27c0091ee0f4a,2020-04-02T20:00:00Z,5,,4235,4224,4224,31,1,0,503,36,539
20200402,NH,415,6078,126,58,59,,,,,91,db06679a86edc18535729a4d8e32df90889b7a3f,2020-04-02T20:00:00Z,4,59,6619,6493,6493,33,0,0,93,0,93
20200402,NJ,25590,33520,,,,,,,,,1350231ad51ae6e7e6b55243f9566d17a5460703,2020-04-02T20:00:00Z,537,,59110,59110,59110,34,182,0,3133,3335,6468
20200402,NM,363,13648,,31,31,,,,,26,d4cbc6f4f974db9eb90a5c3f5df1b80235cb9e43,2020-04-02T20:00:00Z,6,31,14011,14011,14011,35,1,7,723,48,771
20200402,NV,1458,12588,,,,,,,,,ac281047995939a05d81fab70153c5a347c9a93f,2020-04-02T20:00:00Z,38,,14046,14046,14046,32,12,0,1069,179,1248
20200402,NY,92381,146584,,13383,20817,3396,,,,7434,764d0566c27be04c416c502640d5fffbcb8cad26,2020-04-02T20:00:00Z,2373,20817,238965,238965,238965,36,432,2449,9416,8669,18085
20200402,OH,2902,32016,,,802,,260,,,,9cb637113ec0c42f449d0e11e3fb945befdcb348,2020-04-02T20:00:00Z,81,802,34918,34918,34918,39,16,123,5024,355,5379
20200402,OK,879,1265,,,257,,,,,,566ac2a75a879b83eb20085c9ea44852fa14d63a,2020-04-02T20:00:00Z,34,257,2144,2144,2144,40,4,38,17,160,177
20200402,OR,736,14132,,134,167,,,38,40,,b771658b625232d8a1f579f80eab46699a03f83b,2020-04-02T20:00:00Z,19,167,14868,14868,14868,41,1,13,996,46,1042
20200402,PA,7016,47698,,,730,,,,,,0dc7935c18797a0f7616c41c364e159c12d62657,2020-04-02T20:00:00Z,90,730,54714,54714,54714,42,16,110,5271,1211,6482
20200402,PR,316,1604,1119,,,,,,,,2b9a9af18f7c56e17ab89f48b071e4c9afd668a9,2020-04-02T20:00:00Z,12,,3039,1920,1920,72,1,0,195,30,225
20200402,RI,657,4412,,72,,14,,6,6,35,7e7e0cb0eedf94e8de8cc04fbfcbb89fb9b01d54,2020-04-02T20:00:00Z,12,,5069,5069,5069,44,2,0,581,91,672
20200402,SC,1554,5441,,,896,,,,,,0226337007d3996a9de9db3c450c9eae6f65f47d,2020-04-02T20:00:00Z,31,896,6995,6995,6995,45,5,547,408,261,669
20200402,SD,165,4217,0,,17,,,,,57,4503bb5ad5f51410838cf0a227b9d7ebeb19f745,2020-04-02T20:00:00Z,2,17,4382,4382,4382,46,0,5,314,36,350
20200402,TN,2845,31766,,,263,,,,,220,59629453e17df16d80dffa1ce35c5dcb1e94c5a2,2020-04-02T20:00:00Z,32,263,34611,34611,34611,47,8,63,1997,162,2159
20200402,TX,4669,46010,,,196,,,,,38,7d8ea7ba1c7a7c798cfb9c6c3862a58278c06e3b,2020-04-02T20:00:00Z,70,196,50679,50679,50679,48,12,0,2150,672,2822
20200402,UT,1074,19991,,,100,,,,,,c52cf5f5cbc216f45b25fcef2adf90f644c2b052,2020-04-02T20:00:00Z,7,100,21065,21065,21065,49,0,9,-164,62,-102
20200402,VA,1706,15883,,246,305,,145,,108,,9796a8ec0aabb4d2cffe52ed46445fae43bd50c6,2020-04-02T20:00:00Z,41,305,17589,17589,17589,51,7,0,2023,222,2245
20200402,VI,33,149,42,,,,,,,25,0361adbd93f9cc390d8b9459a98f69fdd89577c7,2020-04-02T20:00:00Z,,,224,182,182,78,0,0,23,3,26
20200402,VT,338,4711,,29,45,,,,,15,7510d18997abe87e7201c6841efcdf23546e72e3,2020-04-02T20:00:00Z,17,45,5049,5049,5049,50,1,0,537,17,554
20200402,WA,5984,68814,,,254,,,,,,85955197769abfbadd9dcbe4a2678ab67b3e6822,2020-04-02T20:00:00Z,247,254,74798,74798,74798,53,23,0,8248,350,8598
20200402,WI,1730,20317,,,461,,,,,,834fc46c2905f903a94bd047bced3c8b65158dbe,2020-04-02T20:00:00Z,31,461,22047,22047,22047,55,7,63,1498,180,1678
20200402,WV,217,5276,,,1,,,,,,bf37a7e21c11c01b281839b088a20c114f1455eb,2020-04-02T20:00:00Z,2,1,5493,5493,5493,54,1,0,892,26,918
20200402,WY,150,2439,,19,,,,,,31,bee29b2c70a3352f788126b37e7e056a13198d49,2020-04-02T20:00:00Z,0,,2589,2589,2589,56,0,0,221,20,241
20200401,AK,133,4470,,,9,,,,,,28dfb9b2615a8df04f8c622ad2fb590a6f7da833,2020-04-01T20:00:00Z,3,9,4603,4603,4603,02,0,2,876,14,890
20200401,AL,1077,6697,,,,,,,,,9bd398e733a5ca5042bde1fd8ce2831fc248b0b1,2020-04-01T20:00:00Z,26,,7774,7774,7774,01,13,0,399,96,495
20200401,AR,584,7354,,56,90,,,25,32,42,eb0f33b592be1e182660fe530097a09b66431f2c,2020-04-01T20:00:00Z,10,90,7938,7938,7938,05,2,26,1395,61,1456
20200401,AS,0,20,6,,,,,,,,20abdaacb1a99121d3a25c769ce8dd1ac9bdab61,2020-04-01T20:00:00Z,0,,26,20,20,60,0,0,17,0,17
20200401,AZ,1413,19645,,,149,,51,,,,5dd22577aa9da74dba6c60ec793ebf24511645e1,2020-04-01T20:00:00Z,29,149,21058,21058,21058,04,5,71,1563,124,1687
20200401,CA,8155,21772,57400,1855,1855,774,774,,,,6fb93efce94c15c30e753005c45c7b45e390198c,2020-04-01T20:00:00Z,171,1855,87327,29927,29927,06,18,238,0,673,673
20200401,CO,2966,13883,,,509,,,,,,a3ee849de14da82b70a71d32f063b1237b9dff2b,2020-04-01T20:00:00Z,69,509,16849,16849,16849,08,18,95,1146,339,1485
20200401,CT,3557,13043,,766,766,,,,,,f749f0110af60be2bb7eda83cf543c95cfbfac5d,2020-04-01T20:00:00Z,85,766,16600,16600,16600,09,16,158,14,429,443
20200401,DC,586,3262,2,,,,,,,142,8a7aef6408b5c008467ada52ef83bc9e47d8af28,2020-04-01T20:00:00Z,11,,3850,3848,3848,11,2,0,0,91,91
20200401,DE,368,4015,,51,57,,,,,49,baa25d2006bd8abfc80790eac0381985836fa4f4,2020-04-01T20:00:00Z,11,57,4383,4383,4383,10,1,-7,319,-38,281
20200401,FL,6955,59529,1235,,949,,,,,,d9a24f33db59e2a7276a3019ee2e37f41f9bfb06,2020-04-01T20:00:00Z,87,949,67719,66484,66484,12,10,126,5244,617,5861
20200401,GA,4638,15688,,,952,,,,,,d6147a1075561f5d68ac98a7cb4dedb3e75bcd4c,2020-04-01T20:00:00Z,139,952,20326,20326,20326,13,28,119,3436,709,4145
20200401,GU,77,406,,,19,,2,,,9,0047869c42b3a30e447175952af42627408a157f,2020-04-01T20:00:00Z,3,19,483,483,483,66,1,0,35,8,43
20200401,HI,208,8721,18,,13,,6,,,58,79401f765922c25cfa1efb389f49348f13fa7b49,2020-04-01T20:00:00Z,1,13,8947,8929,8929,15,1,1,250,4,254
20200401,IA,549,7304,,63,99,,,,,118,c2d7f358dcc4c936b1651f06d65c5bd7ef3ab8a2,2020-04-01T20:00:00Z,9,99,7853,7853,7853,19,2,5,416,52,468
20200401,ID,525,6076,,,46,,7,,,,cc12e3fa599537f47fad0258e0009e6ef9fe0581,2020-04-01T20:00:00Z,9,46,6601,6601,6601,16,2,1,779,110,889
20200401,IL,6980,33404,,,,,,,,,026b984139faebf730612961db2541ecac874f45,2020-04-01T20:00:00Z,141,,40384,40384,40384,17,42,0,4173,986,5159
20200401,IN,2565,11810,,,,,,,,,fcc053001d98ddb6739b2610781931fbb476aac3,2020-04-01T20:00:00Z,65,,14375,14375,14375,18,16,0,596,406,1002
20200401,KS,482,5411,,,114,,,,,,d8abbc3a45478014e68bb1033ec072f19a68ec6a,2020-04-01T20:00:00Z,10,114,5893,5893,5893,20,1,35,415,54,469
20200401,KY,591,6965,,,,,,,,,d401a0f0702a3e7442668504f89d9bbf0fd9db08,2020-04-01T20:00:00Z,17,,7556,7556,7556,21,6,0,635,111,746
20200401,LA,6424,39352,,,1498,,,,490,,3e4974bc6afa3064f7b37913b0497195237d9651,2020-04-01T20:00:00Z,273,1498,45776,45776,45776,22,34,143,5622,1187,6809
20200401,MA,7738,44000,,,682,,,,,,70ea3d599c7c506eafd12cbed1d23daa16709040,2020-04-01T20:00:00Z,122,682,51738,51738,51738,25,33,120,3685,1118,4803
20200401,MD,1985,17233,,,522,,,,,,37fdabd80821d81988b5e5a11005bbe7e3a77a5f,2020-04-01T20:00:00Z,31,522,19218,19218,19218,24,13,93,2365,325,2690
20200401,ME,344,6088,,,63,,,,,80,d31aa8304a5b094eb4d5598468a141d0f896f408,2020-04-01T20:00:00Z,7,63,6432,6432,6432,23,2,6,0,41,41
20200401,MI,9334,11893,,,,,,,,,654f19f58224826f0114ad7d33661d9d8880ad78,2020-04-01T20:00:00Z,337,,21227,21227,21227,26,78,0,0,1719,1719
20200401,MN,689,20502,,54,122,27,27,,,,f3620fcfc12dce927a8e2f46922b59df0e351756,2020-04-01T20:00:00Z,17,122,21191,21191,21191,27,5,10,1351,60,1411
20200401,MO,1581,15846,,,,,,,,,dc97aa93ab282b95a3c23db92cd5efdf0b46ac22,2020-04-01T20:00:00Z,18,,17427,17427,17427,29,4,0,1232,254,1486
20200401,MP,6,,,,,,,,,,5fb1a4bb5496638fbba1216c23902a9938e1eaac,2020-04-01T20:00:00Z,,,6,6,6,69,0,0,0,4,4
20200401,MS,1073,3712,,,332,,,,,,03c61b979c5d42a05f6620424c0f7090acc01647,2020-04-01T20:00:00Z,22,332,4785,4785,4785,28,2,121,175,136,311
20200401,MT,208,4710,,,17,,,,,,5c9460763670b2514d789493ad77a8e06dc8bcc2,2020-04-01T20:00:00Z,5,17,4918,4918,4918,30,1,3,476,24,500
20200401,NC,1584,24659,,204,204,,,,,,e7d16063de0c0d172e6b3c63e9fa5886f5f3311f,2020-04-01T20:00:00Z,10,204,26243,26243,26243,37,2,47,3051,86,3137
20200401,ND,142,4351,,23,23,,,,,34,ab1dd18bfe3db1694179598fab36263f0532fe0a,2020-04-01T20:00:00Z,3,23,4493,4493,4493,38,0,2,220,16,236
20200401,NE,210,3475,8,,,,,,,,a736e9df99d379949dec4b420b4fe03c5a5b32b4,2020-04-01T20:00:00Z,4,,3693,3685,3685,31,1,0,544,38,582
20200401,NH,415,5985,97,,59,,,,,56,6fb656cf90040c55a5d29d3739819ab6457a8903,2020-04-01T20:00:00Z,4,59,6497,6400,6400,33,1,14,572,101,673
20200401,NJ,22255,30387,,,,,,,,,c70a3b11fb70789f402a5509b3c0000548c2587b,2020-04-01T20:00:00Z,355,,52642,52642,52642,34,88,0,3310,3559,6869
20200401,NM,315,12925,,24,24,,,,,26,555b761980125a8119c4d929f41f1f3a9e073a3f,2020-04-01T20:00:00Z,5,24,13240,13240,13240,35,1,2,679,34,713
20200401,NV,1279,11519,,,,,,,,,99ca8c448bcd3a57ffe6454db6a4b2533447a96b,2020-04-01T20:00:00Z,26,,12798,12798,12798,32,9,0,838,166,1004
20200401,NY,83712,137168,,12226,18368,3022,3022,,,6142,bc022c8f01dbc1a4d1f046ebce21c18a7b42cfa6,2020-04-01T20:00:00Z,1941,18368,220880,220880,220880,36,391,2464,7777,7917,15694
20200401,OH,2547,26992,,679,679,,222,,,,dbf14be5566651ac0a96384a5162108330436895,2020-04-01T20:00:00Z,65,679,29539,29539,29539,39,10,94,0,348,348
20200401,OK,719,1248,,,219,,,,,,ac29d7657881eeb536d49135e22894a8e669ba86,2020-04-01T20:00:00Z,30,219,1967,1967,1967,40,7,42,19,154,173
20200401,OR,690,13136,,132,154,,,40,40,,c37eb024e65c3469e098cccb5acb7c4e54ced2df,2020-04-01T20:00:00Z,18,154,13826,13826,13826,41,0,0,0,0,0
20200401,PA,5805,42427,,,620,,,,,,575ea7e224d4f1f6797bed8fe0a7902daad3ffab,2020-04-01T20:00:00Z,74,620,48232,48232,48232,42,11,106,4782,962,5744
20200401,PR,286,1409,897,,,,,,,,ae0129f382eb5f04d790633ebc4cfb9e7e00f89a,2020-04-01T20:00:00Z,11,,2592,1695,1695,72,3,0,214,47,261
20200401,RI,566,3831,,60,60,14,14,6,6,35,4a3df6b45504443ee54b0f0fa2910b3a13ffea72,2020-04-01T20:00:00Z,10,60,4397,4397,4397,44,2,1,355,78,433
20200401,SC,1293,5033,,,349,,,,,,a321818d113ea1e8063433667ca10f117f264d11,2020-04-01T20:00:00Z,26,349,6326,6326,6326,45,4,90,417,210,627
20200401,SD,129,3903,0,,12,,,,,51,321e6948f2b0f05bf9e515252aed1d4ec4873a57,2020-04-01T20:00:00Z,2,12,4032,4032,4032,46,1,0,294,21,315
20200401,TN,2683,29769,,,200,,,,,137,9e9bb3593287cbf3b938263422d21dba45a771e1,2020-04-01T20:00:00Z,24,200,32452,32452,32452,47,1,25,4648,444,5092
20200401,TX,3997,43860,,,196,,,,,38,d7eee4ced63cacacb4fa81132e1bc4fa3884f105,2020-04-01T20:00:00Z,58,196,47857,47857,47857,48,17,0,4134,731,4865
20200401,UT,1012,20155,,,91,,,,,,3060e79ad1d88a94c41b61754e101f096b677716,2020-04-01T20:00:00Z,7,91,21167,21167,21167,49,2,18,2529,125,2654
20200401,VA,1484,13860,,,305,,145,,108,,3978f9b311c4141c1b8cab5ace841ef8bff698d3,2020-04-01T20:00:00Z,34,305,15344,15344,15344,51,7,140,1709,234,1943
20200401,VI,30,126,24,,,,,,,21,a7b58dc10565c19782a05701feaed42d38a8fb8e,2020-04-01T20:00:00Z,,,180,156,156,78,0,0,0,0,0
20200401,VT,321,4174,,30,45,,,,,15,09d62e8a97e7673d2cb199f97cefebe931639672,2020-04-01T20:00:00Z,16,45,4495,4495,4495,50,3,9,217,28,245
20200401,WA,5634,60566,,,254,,,,,,d6cb23f0dc40421b2d167caba2408a74cfcaf9a1,2020-04-01T20:00:00Z,224,254,66200,66200,66200,53,29,0,0,738,738
20200401,WI,1550,18819,,,398,,,,,,3a304dc1edaaf3c59465b033f7b4aa76ad3dec32,2020-04-01T20:00:00Z,24,398,20369,20369,20369,55,8,61,1444,199,1643
20200401,WV,191,4384,,,1,,,,,,264082faaa6983c76d88bf13c4444943677bfd72,2020-04-01T20:00:00Z,1,1,4575,4575,4575,54,0,0,403,29,432
20200401,WY,130,2218,,,18,,,,,31,a5690ff900709e2e51e09c47b186c26c6bb7d126,2020-04-01T20:00:00Z,0,18,2348,2348,2348,56,0,1,219,21,240
20200331,AK,119,3594,,,7,,,,,,5ec8d7c9ede0e8d30b6f7b63be047ac0ead0b49b,2020-03-31T20:00:00Z,3,7,3713,3713,3713,02,0,0,54,5,59
20200331,AL,981,6298,,,,,,,,,42eecba7755e229592355c2a117a0c76245f655a,2020-03-31T20:00:00Z,13,,7279,7279,7279,01,7,0,604,122,726
20200331,AR,523,5959,,64,64,,,23,23,35,579d8a2bcc21e0e9cf9532993a99b66989dade11,2020-03-31T20:00:00Z,8,64,6482,6482,6482,05,1,2,697,50,747
20200331,AS,,3,2,,,,,,,,097ecd19aff7932c01ea48277887ef648419f0f0,2020-03-31T20:00:00Z,0,,5,3,3,60,0,0,3,0,3
20200331,AZ,1289,18082,,,78,,30,,,,7a61f6c2f0d045bd7450398a13971715a698bf8d,2020-03-31T20:00:00Z,24,78,19371,19371,19371,04,4,0,2480,132,2612
20200331,CA,7482,21772,57400,1617,1617,657,657,,,,8aa120a4c2d14e4da8b37e1148edb1eec68c9797,2020-03-31T20:00:00Z,153,1617,86654,29254,29254,06,20,185,1223,1035,2258
20200331,CO,2627,12737,,,414,,,,,,94036534fc5ae0cbc3e63e2576bdb553dda374c1,2020-03-31T20:00:00Z,51,414,15364,15364,15364,08,0,0,0,0,0
20200331,CT,3128,13029,,608,608,,,,,,cc7f9b9641974587a09bd4816bc59a78cd471641,2020-03-31T20:00:00Z,69,608,16157,16157,16157,09,33,91,1000,557,1557
20200331,DC,495,3262,2,,,,,,,121,5434bf0aabd9cdefb5f6ade62555f66bf0231f65,2020-03-31T20:00:00Z,9,,3759,3757,3757,11,0,0,580,94,674
20200331,DE,406,3696,,57,64,,,,,22,a42482f541e17f90c263af1075357ccfe1e22b20,2020-03-31T20:00:00Z,10,64,4102,4102,4102,10,4,19,1480,142,1622
20200331,FL,6338,54285,1163,,823,,,,,,c0d094c60a3352b108e4b759b45b066bd56cc068,2020-03-31T20:00:00Z,77,823,61786,60623,60623,12,14,171,6060,865,6925
20200331,GA,3929,12252,,,833,,,,,,59e2183e84ee35f0e1c3432ef7380d6b2ba4f740,2020-03-31T20:00:00Z,111,833,16181,16181,16181,13,24,126,2337,1120,3457
20200331,GU,69,371,,,19,,2,,,7,3592ef9cb9ff6a6178a943e49a6230b4a9354c22,2020-03-31T20:00:00Z,2,19,440,440,440,66,1,0,19,11,30
20200331,HI,204,8471,11,,12,,6,,,49,22c1ed86f4e22ca2157d52556df192c3aa58cf31,2020-03-31T20:00:00Z,0,12,8686,8675,8675,15,0,0,646,29,675
20200331,IA,497,6888,,61,94,,,,,33,4ec1acfc172943306bb03e7153d7f1958591191d,2020-03-31T20:00:00Z,7,94,7385,7385,7385,19,1,20,726,73,799
20200331,ID,415,5297,,,45,,6,,,,6f7851470fbaf9166e84cbeb782d870ec1bbb384,2020-03-31T20:00:00Z,7,45,5712,5712,5712,16,1,6,901,105,1006
20200331,IL,5994,29231,,,,,,,,,979983c53f3fef1cf573ae3a61de7f9166197b17,2020-03-31T20:00:00Z,99,,35225,35225,35225,17,26,0,3842,937,4779
20200331,IN,2159,11214,,,,,,,,,76b4fbd00067fbb532bb2d0c63800ffa814d75c9,2020-03-31T20:00:00Z,49,,13373,13373,13373,18,14,0,1342,373,1715
20200331,KS,428,4996,,,79,,,,,,12716e5b136e60836429eab2bb08477c7ca6d529,2020-03-31T20:00:00Z,9,79,5424,5424,5424,20,1,13,442,60,502
20200331,KY,480,6330,,,,,,,,,37e85814eaa2e8744faaf12a5995d3a1d5958614,2020-03-31T20:00:00Z,11,,6810,6810,6810,21,2,0,751,41,792
20200331,LA,5237,33730,,,1355,,,,438,,9afe3b0050bd01d1928766a6d12d65c23f10d0b9,2020-03-31T20:00:00Z,239,1355,38967,38967,38967,22,54,170,3722,1212,4934
20200331,MA,6620,40315,,,562,,,,,,b113daa2aa839e30f1f3605f00483292aa39a60e,2020-03-31T20:00:00Z,89,562,46935,46935,46935,25,33,109,3274,868,4142
20200331,MD,1660,14868,,,429,,,,,,d7bfec3c323983994ff111c9de7dc7addc251550,2020-03-31T20:00:00Z,18,429,16528,16528,16528,24,3,76,1552,247,1799
20200331,ME,303,6088,,,57,,,,,68,9a8dc48e67c43030905fcae8d51b29844ca227ad,2020-03-31T20:00:00Z,5,57,6391,6391,6391,23,2,8,2694,28,2722
20200331,MI,7615,11893,,,,,,,,,9c0cc8c0bb411d253f820471b33fd6f20fc98c35,2020-03-31T20:00:00Z,259,,19508,19508,19508,26,75,0,0,1117,1117
20200331,MN,629,19151,,56,112,26,26,,,,cb5ae95ed3bb94c2e6a93343b3be56544a28c7e0,2020-03-31T20:00:00Z,12,112,19780,19780,19780,27,2,20,905,53,958
20200331,MO,1327,14614,,,,,,,,,4fc56f79bf2224a97947093ebb74ae8bf0a5c36f,2020-03-31T20:00:00Z,14,,15941,15941,15941,29,1,0,1410,296,1706
20200331,MP,2,,,,,,,,,,ffa5f54a292f871515c1817ce333527b48f76d79,2020-03-31T20:00:00Z,,,2,2,2,69,0,0,0,0,0
20200331,MS,937,3537,,,211,,,,,,b44e85184d9a95e733dd5b77766d46986a09876a,2020-03-31T20:00:00Z,20,211,4474,4474,4474,28,4,16,548,90,638
20200331,MT,184,4234,,,14,,,,,,501a4ed165fe9f891b45ef2af4b82b23f264ef3a,2020-03-31T20:00:00Z,4,14,4418,4418,4418,30,0,4,273,13,286
20200331,NC,1498,21608,,157,157,,,,,,00f281d116a1250c3ca125211efd13eea4b844cd,2020-03-31T20:00:00Z,8,157,23106,23106,23106,37,2,20,2051,191,2242
20200331,ND,126,4131,,21,21,,,,,30,7baa9d453487d33dfb1af22bce4b3801654e1289,2020-03-31T20:00:00Z,3,21,4257,4257,4257,38,1,2,403,17,420
20200331,NE,172,2931,8,,,,,,,,b3674a50a3d04771860eca37b3917ee82b88fbba,2020-03-31T20:00:00Z,3,,3111,3103,3103,31,1,0,347,27,374
20200331,NH,314,5413,65,45,45,,,,,,80a5062cdd7103af585452431f416aca04bafd34,2020-03-31T20:00:00Z,3,45,5792,5727,5727,33,0,0,27,0,27
20200331,NJ,18696,27077,,,,,,,,,f358cd5dac93690b31a9d665dcb3fb4b046eca97,2020-03-31T20:00:00Z,267,,45773,45773,45773,34,69,0,1853,2060,3913
20200331,NM,281,12246,,22,22,,,,,26,f9d7697d0d8c2f7b650b831591b1a36a35481630,2020-03-31T20:00:00Z,4,22,12527,12527,12527,35,2,0,1304,44,1348
20200331,NV,1113,10681,,,,,,,,,75bc5c5fe829f18065e4706cf35ef2994fb69f7b,2020-03-31T20:00:00Z,17,,11794,11794,11794,32,2,0,474,105,579
20200331,NY,75795,129391,,10929,15904,2710,2710,,,4975,a3afdea93fae4daf8073978749d736d46e9134c6,2020-03-31T20:00:00Z,1550,15904,205186,205186,205186,36,332,2183,9420,9298,18718
20200331,OH,2199,26992,,387,585,,198,,,,2b80954e16b24e4b7d7e8599a71763c1081a8715,2020-03-31T20:00:00Z,55,585,29191,29191,29191,39,16,110,1650,266,1916
20200331,OK,565,1229,,,177,,,,,,7644495f3049f57946f6ac8b36f1eb1ffc6b7991,2020-03-31T20:00:00Z,23,177,1794,1794,1794,40,6,24,22,84,106
20200331,OR,690,13136,,132,154,,,40,40,,e44596521fd7149cd51b2feacaf8439e95aa4e5d,2020-03-31T20:00:00Z,18,154,13826,13826,13826,41,2,14,859,84,943
20200331,PA,4843,37645,,,514,,,,,,f2ddb226108bf8650a4c9d6b6394ff9083e3adbc,2020-03-31T20:00:00Z,63,514,42488,42488,42488,42,14,128,3868,756,4624
20200331,PR,239,1195,854,,,,,,,,78117516d9037f5282375c81906d6c029a53bf68,2020-03-31T20:00:00Z,8,,2288,1434,1434,72,2,0,264,65,329
20200331,RI,488,3476,,59,59,9,9,6,6,35,2fd78f73348d718301c48a71cd60267dac78171d,2020-03-31T20:00:00Z,8,59,3964,3964,3964,44,4,18,289,80,369
20200331,SC,1083,4616,,,259,,,,,,34a657bc2def360f99f18a1a872eae0f3b37583b,2020-03-31T20:00:00Z,22,259,5699,5699,5699,45,4,130,456,158,614
20200331,SD,108,3609,0,,12,,,,,44,1dfa391214d591fb4af733f72b7006016c4f3309,2020-03-31T20:00:00Z,1,12,3717,3717,3717,46,0,12,131,7,138
20200331,TN,2239,25121,,,175,,,,,121,8b236550ae5ec5e539ddcd63854658d0193987d2,2020-03-31T20:00:00Z,23,175,27360,27360,27360,47,10,27,3651,405,4056
20200331,TX,3266,39726,,,196,,,,,38,49880c7d533574ad29d17299ae133096cba20a3c,2020-03-31T20:00:00Z,41,196,42992,42992,42992,48,7,196,6723,389,7112
20200331,UT,887,17626,,,73,,,,,,df48bc20a6b94395ef809b6483a81ac976f07c72,2020-03-31T20:00:00Z,5,73,18513,18513,18513,49,1,73,2429,81,2510
20200331,VA,1250,12151,,,165,,,,,,94c6ced5cbd2d7474ef25844e4f1c69d185328b8,2020-03-31T20:00:00Z,27,165,13401,13401,13401,51,2,29,1133,230,1363
20200331,VI,30,126,24,,,,,,,21,aa85d4eb0661c567f1f2843ad6583c65fa67411e,2020-03-31T20:00:00Z,,,180,156,156,78,0,0,0,0,0
20200331,VT,293,3957,,21,36,,,,,15,f7ff1c5b387b478086752b2ba379a2aaab0bf9fd,2020-03-31T20:00:00Z,13,36,4250,4250,4250,50,1,18,283,37,320
20200331,WA,4896,60566,,,254,,,,,,215fd829abdd735dea112aded7893ab62d5310ac,2020-03-31T20:00:00Z,195,254,65462,65462,65462,53,0,0,0,0,0
20200331,WI,1351,17375,,,337,,,,,,5743ca4c966b5e5a927d00d404c31fbb7cc91341,2020-03-31T20:00:00Z,16,337,18726,18726,18726,55,2,337,1519,130,1649
20200331,WV,162,3981,,,1,,,,,,8e2d2b08f0436cdcaf61239f004ddbef807c2a89,2020-03-31T20:00:00Z,1,1,4143,4143,4143,54,0,0,997,36,1033
20200331,WY,109,1999,,,17,,,,,26,56481c095ddf7e629ed8e0a3c0eedf3ce33180f7,2020-03-31T20:00:00Z,0,17,2108,2108,2108,56,0,0,159,15,174
20200330,AK,114,3540,,,7,,,,,,98553897a21c05aeec18d5391001f5bdb25eb44e,2020-03-30T20:00:00Z,3,7,3654,3654,3654,02,1,1,308,12,320
20200330,AL,859,5694,,,,,,,,,4552863c924f79edb83615e6b3642696b80a83cf,2020-03-30T20:00:00Z,6,,6553,6553,6553,01,2,0,1510,53,1563
20200330,AR,473,5262,,62,62,,,21,21,29,3c184f4aba9e9753d9d8adff46e6c2fd7fc68e8b,2020-03-30T20:00:00Z,7,62,5735,5735,5735,05,1,14,2235,47,2282
20200330,AS,,,,,,,,,,,016909ef598616403b32e8c8d61b26a0498b9bfb,2020-03-30T20:00:00Z,0,,0,0,0,60,0,0,0,0,0
20200330,AZ,1157,15602,,,78,,30,,,,7fed0e7f482053630e42fe6cde50397bc8aaeaac,2020-03-30T20:00:00Z,20,78,16759,16759,16759,04,3,0,2649,238,2887
20200330,CA,6447,20549,64400,1432,1432,597,597,,,,b2fd37c8b374d544e8f30c2b619be88799980737,2020-03-30T20:00:00Z,133,1432,91396,26996,26996,06,10,398,0,739,739
20200330,CO,2627,12737,,,414,,,,,,2f09674b8bfb4f141d2ef246cfc410dd972a1efc,2020-03-30T20:00:00Z,51,414,15364,15364,15364,08,7,140,1522,566,2088
20200330,CT,2571,12029,,517,517,,,,,,d485d42512127c98051f824a384ea55685212a39,2020-03-30T20:00:00Z,36,517,14600,14600,14600,09,2,113,2122,578,2700
20200330,DC,401,2682,2,,,,,193,193,106,205441388fb26e9e101a1729a00f90b6fed41b9e,2020-03-30T20:00:00Z,9,,3085,3083,3083,11,4,0,213,59,272
20200330,DE,264,2216,,,45,,,,,9,96d1a7c87a7e6d01c91b8cf45208e49aadb24052,2020-03-30T20:00:00Z,6,45,2480,2480,2480,10,0,12,2180,32,2212
20200330,FL,5473,48225,,,652,,,,,,9a3e8154ce0eca0c63b55151a437a020a79406e3,2020-03-30T20:00:00Z,63,652,53698,53698,53698,12,7,58,9155,1227,10382
20200330,GA,2809,9915,,,707,,,,,,25ceba85ecebfa065b3994c5a0511a721902a2a5,2020-03-30T20:00:00Z,87,707,12724,12724,12724,13,7,41,2,158,160
20200330,GU,58,352,,,19,,2,,,7,d2640f3728eb4a2a7553d55f91bb60da8a48a22e,2020-03-30T20:00:00Z,1,19,410,410,410,66,0,4,18,2,20
20200330,HI,175,7825,13,,12,,,,,,86503db359633015fc41c86c991f47abdee97992,2020-03-30T20:00:00Z,0,12,8013,8000,8000,15,0,0,976,24,1000
20200330,IA,424,6162,,51,74,,,,,23,bb8559f53afd6bd1498d5d61c82adc745f314b7d,2020-03-30T20:00:00Z,6,74,6586,6586,6586,19,2,6,1149,88,1237
20200330,ID,310,4396,,,39,,,,,,7199499861b27b9737de62f8b6fcccfd09b03ad8,2020-03-30T20:00:00Z,6,39,4706,4706,4706,16,1,3,375,49,424
20200330,IL,5057,25389,,,,,,,,,49eda929cdc14ecc7beeaffc5a03863b651175f5,2020-03-30T20:00:00Z,73,,30446,30446,30446,17,8,0,2223,461,2684
20200330,IN,1786,9872,,,,,,,,,1eb08f6c84c1646c1611f46dfcb77c86a50479fc,2020-03-30T20:00:00Z,35,,11658,11658,11658,18,3,0,1556,272,1828
20200330,KS,368,4554,,,66,,,,,,740551d80bb24aabc7ddbc519fc876c31ec53920,2020-03-30T20:00:00Z,8,66,4922,4922,4922,20,2,11,360,49,409
20200330,KY,439,5579,,,,,,,,,e683db18146f3c70866e5138f7c84f76f04bc09a,2020-03-30T20:00:00Z,9,,6018,6018,6018,21,0,0,432,45,477
20200330,LA,4025,30008,,,1185,,,,385,,83cdef3008fd6d32b51fc602cee4e1df98d1e7e0,2020-03-30T20:00:00Z,185,1185,34033,34033,34033,22,34,58,5677,485,6162
20200330,MA,5752,37041,,,453,,,,,,559b7707f9c7203da0ea8c07a2bfc9577d331c97,2020-03-30T20:00:00Z,56,453,42793,42793,42793,25,8,54,2930,797,3727
20200330,MD,1413,13316,,,353,,,,,,ea51bd505bfb1c35306ee4e4b22abdad5d2820d8,2020-03-30T20:00:00Z,15,353,14729,14729,14729,24,5,76,962,174,1136
20200330,ME,275,3394,,,49,,,,,41,fe7606d23c550ea474d64f9540019641a5da2680,2020-03-30T20:00:00Z,3,49,3669,3669,3669,23,0,49,0,22,22
20200330,MI,6498,11893,,,,,,,,,1f7c04934f736a642fad67de889c8616b7d6c0bf,2020-03-30T20:00:00Z,184,,18391,18391,18391,26,52,0,0,1012,1012
20200330,MN,576,18246,,56,92,24,24,,,,f4fd6f4736f788b58399563a48e0a4a14c120ff4,2020-03-30T20:00:00Z,10,92,18822,18822,18822,27,1,17,1092,73,1165
20200330,MO,1031,13204,,,,,,,,,932b312edc6f1709cc6feaa4afd9e492c17be555,2020-03-30T20:00:00Z,13,,14235,14235,14235,29,3,0,1657,193,1850
20200330,MP,2,,,,,,,,,,330007cfa03e74e1da2c74b8b75a41f075ed1f10,2020-03-30T20:00:00Z,,,2,2,2,69,0,0,0,0,0
20200330,MS,847,2989,,,195,,,,,,306cc9d00ab15c39bbba409f447156bbece99bfe,2020-03-30T20:00:00Z,16,195,3836,3836,3836,28,2,-40,429,89,518
20200330,MT,171,3961,,,10,,,,,,3fd12c2881fd187e82754915f87b299c0bdafcef,2020-03-30T20:00:00Z,4,10,4132,4132,4132,30,3,2,-182,17,-165
20200330,NC,1307,19557,,137,137,,,,,,5551d7943af1b24215d118be796d0d507f3ebc57,2020-03-30T20:00:00Z,6,137,20864,20864,20864,37,2,46,1652,267,1919
20200330,ND,109,3728,,,19,,,,,19,68a3b5338b8b1424629db87b97ecbd0c347d7317,2020-03-30T20:00:00Z,2,19,3837,3837,3837,38,1,2,373,11,384
20200330,NE,145,2584,5,,,,,,,,088432e8d55e51cb7eaba7eba13d364259f8842c,2020-03-30T20:00:00Z,2,,2734,2729,2729,31,0,0,616,37,653
20200330,NH,314,5386,144,,45,,,,,,09deb0331b52dd98962c90342290df5b9d20b889,2020-03-30T20:00:00Z,3,45,5844,5700,5700,33,1,12,862,100,962
20200330,NJ,16636,25224,,,,,,,,,0d0e43bb75f7d3018b323178e9b3ff278f6f6451,2020-03-30T20:00:00Z,198,,41860,41860,41860,34,37,0,3008,3250,6258
20200330,NM,237,10942,,22,22,,,,,26,e5c401be427ed6426e5369712551d5d1918261be,2020-03-30T20:00:00Z,2,22,11179,11179,11179,35,0,3,173,0,173
20200330,NV,1008,10207,,,,,,,,,34628b797fa0cbc9196833ea89dc685929e71e86,2020-03-30T20:00:00Z,15,,11215,11215,11215,32,1,0,1795,270,2065
20200330,NY,66497,119971,,9517,13721,2352,2352,,,4204,a749060bc47c2573b505c13198673b348ed3cc2b,2020-03-30T20:00:00Z,1218,13721,186468,186468,186468,36,253,1646,7124,6984,14108
20200330,OH,1933,25342,,312,475,,163,,,,4919c330ab80341299bf33ea25f67dd58a96dd17,2020-03-30T20:00:00Z,39,475,27275,27275,27275,39,10,72,6330,280,6610
20200330,OK,481,1207,,,153,,,,,,b3b3a86a6005e6bb134a5072898bce9dfe1e5b69,2020-03-30T20:00:00Z,17,153,1688,1688,1688,40,1,13,2,52,54
20200330,OR,606,12277,,,140,,,39,39,,c543299db7bd820697dd1e52f379790ec57de15a,2020-03-30T20:00:00Z,16,140,12883,12883,12883,41,3,11,1399,58,1457
20200330,PA,4087,33777,,,386,,,,,,cac05153a6de7331306734979416c0bbbca4be85,2020-03-30T20:00:00Z,49,386,37864,37864,37864,42,11,-296,3716,693,4409
20200330,PR,174,931,794,,,,,,,,fd89d6c3b101b8f486f201f326442d416bfd4a2d,2020-03-30T20:00:00Z,6,,1899,1105,1105,72,1,0,90,47,137
20200330,RI,408,3187,,41,41,9,9,6,6,,0b793432db85ade06b16b6eff37fd1791b7c17e3,2020-03-30T20:00:00Z,4,41,3595,3595,3595,44,1,6,646,114,760
20200330,SC,925,4160,,,129,,,,,,ceb9937dd126bead37bfbbd92bde9286cf955c64,2020-03-30T20:00:00Z,18,129,5085,5085,5085,45,2,0,1145,151,1296
20200330,SD,101,3478,0,,,,,,,34,0bb03d9210c26f22f5301e7d3d05499e38494ffb,2020-03-30T20:00:00Z,1,,3579,3579,3579,46,0,0,351,11,362
20200330,TN,1834,21470,,,148,,,,,,ec22bf9d70375a31624ca8e4f9483a01aac06b52,2020-03-30T20:00:00Z,13,148,23304,23304,23304,47,6,15,2433,297,2730
20200330,TX,2877,33003,,,,,,,,38,97f0dea6f50c349bb0a5bb31afde8cf9ad5ffcf8,2020-03-30T20:00:00Z,34,,35880,35880,35880,48,0,0,9795,325,10120
20200330,UT,806,15197,,,,,,,,,9c05aaa04b932a442629dc78d9f4015fc3648184,2020-03-30T20:00:00Z,4,,16003,16003,16003,49,2,0,1923,87,2010
20200330,VA,1020,11018,,,136,,,,,,1b814b67e1fc83c5f9fdc2e3ca2dc1e7d1fa66d7,2020-03-30T20:00:00Z,25,136,12038,12038,12038,51,3,24,1299,130,1429
20200330,VI,30,126,24,,,,,,,,b32a1c0cf911b225e766bdbf0fd0890dc047acdc,2020-03-30T20:00:00Z,,,180,156,156,78,0,0,3,7,10
20200330,VT,256,3674,,,18,,,,,,707ea7e30f8939272fe9b6691b379a0385237953,2020-03-30T20:00:00Z,12,18,3930,3930,3930,50,0,0,208,21,229
20200330,WA,4896,60566,,,254,,,,,,c734382e8a516a0f55f370aacda4ac92b877649e,2020-03-30T20:00:00Z,195,254,65462,65462,65462,53,6,0,5670,586,6256
20200330,WI,1221,15856,,,,,,,,,23dce446b3a30d5d3dda0c1c88c909196d75aaab,2020-03-30T20:00:00Z,14,,17077,17077,17077,55,1,0,-694,109,-585
20200330,WV,126,2984,0,,1,,,,,,ce4f1662c7da92e2834a2a7b3bfdc61882f80794,2020-03-30T20:00:00Z,1,1,3110,3110,3110,54,1,0,279,13,292
20200330,WY,94,1840,,,17,,,,,24,d063fc044d9f24bbc91ef6e673e1bc6e0a0b4e4b,2020-03-30T20:00:00Z,0,17,1934,1934,1934,56,0,2,286,8,294
20200329,AK,102,3232,,,6,,,,,,422bc4f921be7a7ead06e6f738314ef1911a8407,2020-03-29T20:00:00Z,2,6,3334,3334,3334,02,0,1,396,17,413
20200329,AL,806,4184,,,,,,,,,0c2a7ece10172b9bd60b53579fd6d9a53f5e9f03,2020-03-29T20:00:00Z,4,,4990,4990,4990,01,1,0,0,110,110
20200329,AR,426,3027,,43,48,,,16,17,28,34c885db5e28ed0dc59208f0e776c0286c2fa829,2020-03-29T20:00:00Z,6,48,3453,3453,3453,05,1,0,89,22,111
20200329,AS,,,,,,,,,,,b71912eee827fe10f806cb56123974239fa7b3d5,2020-03-29T20:00:00Z,0,,0,0,0,60,0,0,0,0,0
20200329,AZ,919,12953,,,78,,30,,,,030af14227822ea13853568cdf2a79a864fc73d6,2020-03-29T20:00:00Z,17,78,13872,13872,13872,04,2,78,5498,46,5544
20200329,CA,5708,20549,64400,1034,1034,410,410,,,,1b6fd0782f7e0f6178ea2f83a468c5d2471cc0d7,2020-03-29T20:00:00Z,123,1034,90657,26257,26257,06,22,0,0,1065,1065
20200329,CO,2061,11215,,,274,,,,,,73715d6db63053b6e3b672daf90f74bd2164eef6,2020-03-29T20:00:00Z,44,274,13276,13276,13276,08,13,35,1273,327,1600
20200329,CT,1993,9907,,,404,,,,,,81670eca1c3cba6fb7e9c07bec78ea6eeba53e4e,2020-03-29T20:00:00Z,34,404,11900,11900,11900,09,7,231,2798,702,3500
20200329,DC,342,2469,1,,,,,,,66,4781282de2140f0f63dcd581d9f45c684bf3fb32,2020-03-29T20:00:00Z,5,,2812,2811,2811,11,1,0,258,38,296
20200329,DE,232,36,,,33,,,,,9,c92dc538f521b9753e53d7600d9a0cae7139c5e2,2020-03-29T20:00:00Z,6,33,268,268,268,10,3,2,0,18,18
20200329,FL,4246,39070,,,594,,,,,,39553e3ec095e3143e776031465d2e90ade6c787,2020-03-29T20:00:00Z,56,594,43316,43316,43316,12,2,68,3704,483,4187
20200329,GA,2651,9913,,,666,,,,,,8fd5124a5d60c405bdada62747c232a41e2f9111,2020-03-29T20:00:00Z,80,666,12564,12564,12564,13,11,49,1228,285,1513
20200329,GU,56,334,,,15,,,,,7,0417959b80faa4e19e23394dc15fa6c86141ae14,2020-03-29T20:00:00Z,1,15,390,390,390,66,0,0,35,1,36
20200329,HI,151,6849,4,,12,,,,,,6bce64a9864df0e36d1f27e9a9a7f937f0b24d91,2020-03-29T20:00:00Z,0,12,7004,7000,7000,15,0,4,2492,31,2523
20200329,IA,336,5013,,51,68,,,,,17,0390f1a7c97c62a24050e5d9ebac698026cb1467,2020-03-29T20:00:00Z,4,68,5349,5349,5349,19,1,7,638,38,676
20200329,ID,261,4021,,,36,,,,,,8979502556f020e81fc4c2989d1a752bf6e3068d,2020-03-29T20:00:00Z,5,36,4282,4282,4282,16,1,11,679,31,710
20200329,IL,4596,23166,,,,,,,,,bd7639325f1e033630241a08bc0e4cfebae48436,2020-03-29T20:00:00Z,65,,27762,27762,27762,17,18,0,1166,1105,2271
20200329,IN,1514,8316,,,,,,,,,7218f7ee5dcf63b69f6d3a8be6ab8404ecd588c4,2020-03-29T20:00:00Z,32,,9830,9830,9830,18,1,0,1141,282,1423
20200329,KS,319,4194,,,55,,,,,,5bcb9dae92d0bbe8c3b18551ded266dd24876d38,2020-03-29T20:00:00Z,6,55,4513,4513,4513,20,1,28,523,58,581
20200329,KY,394,5147,,,,,,,,,466fb0bcb56c8e91014554ef6a8818029299ecfd,2020-03-29T20:00:00Z,9,,5541,5541,5541,21,1,0,326,92,418
20200329,LA,3540,24331,,,1127,,,,380,,c7306243e89fb0a9690d4531ca9ba00b354540bd,2020-03-29T20:00:00Z,151,1127,27871,27871,27871,22,14,200,2485,225,2710
20200329,MA,4955,34111,,,399,,,,,,1de5b22e00296e1b0a1fea40b858c4f6d2eeb1b0,2020-03-29T20:00:00Z,48,399,39066,39066,39066,25,4,49,3319,698,4017
20200329,MD,1239,12354,,,277,,,,,,43e502f79bd427c342c79c2281412b86f1c174e1,2020-03-29T20:00:00Z,10,277,13593,13593,13593,24,5,51,838,247,1085
20200329,ME,253,3394,,,,,,,,41,1f1feafef96ccfc55b84c7fc1ec38625fc276029,2020-03-29T20:00:00Z,3,,3647,3647,3647,23,2,0,0,42,42
20200329,MI,5486,11893,,,,,,,,,c8453def420acac39ac418e88b3fa6143a8907e7,2020-03-29T20:00:00Z,132,,17379,17379,17379,26,40,0,2784,1829,4613
20200329,MN,503,17154,,39,75,,17,,,252,74247593bee28b5b049c8db9e1db79859e9d48fb,2020-03-29T20:00:00Z,9,75,17657,17657,17657,27,4,18,1466,62,1528
20200329,MO,838,11547,,,,,,,,,c9427dccdae92e441cee6fbb2787ea3a231dc686,2020-03-29T20:00:00Z,10,,12385,12385,12385,29,0,0,1465,0,1465
20200329,MP,2,,,,,,,,,,80c72d24c28e3245151244a3e59d6ee9fe9a391b,2020-03-29T20:00:00Z,,,2,2,2,69,0,0,0,0,0
20200329,MS,758,2560,,,235,,,,,,7e0258b174e76d4043c8b6164aa265e2ea9b1f53,2020-03-29T20:00:00Z,14,235,3318,3318,3318,28,1,16,0,95,95
20200329,MT,154,4143,,,8,,,,,,8e59ae6eb967f41c99ed548a2cd1a8e66fafb8e1,2020-03-29T20:00:00Z,1,8,4297,4297,4297,30,0,1,887,25,912
20200329,NC,1040,17905,,91,91,,,,,,829b3e91f90f0f3a90688f7a2f51641e3511c3c2,2020-03-29T20:00:00Z,4,91,18945,18945,18945,37,0,4,1313,105,1418
20200329,ND,98,3355,,,17,,,,,18,9ea37c7842380c19726ed92b58103490a1d7de53,2020-03-29T20:00:00Z,1,17,3453,3453,3453,38,0,1,546,15,561
20200329,NE,108,1968,4,,,,,,,,a91fc8b0c0abec3ecc573422316a5421f9afd0ed,2020-03-29T20:00:00Z,2,,2080,2076,2076,31,0,0,64,12,76
20200329,NH,214,4524,285,,33,,,,,,0802aecb450515b575cf19e88b8b137764d666dc,2020-03-29T20:00:00Z,2,33,5023,4738,4738,33,0,3,868,27,895
20200329,NJ,13386,22216,,,,,,,,,818cb76f7734f5c5a61d07feec6d212f8717396e,2020-03-29T20:00:00Z,161,,35602,35602,35602,34,21,0,2830,2262,5092
20200329,NM,237,10769,,19,19,,,,,2,195ec3c6ab47d477f8aa0013a5e40f1ce8a2af25,2020-03-29T20:00:00Z,2,19,11006,11006,11006,35,1,2,1573,46,1619
20200329,NV,738,8412,,,,,,,,,0c74530736aea27f85556493e8fa89eb8b417763,2020-03-29T20:00:00Z,14,,9150,9150,9150,32,4,0,511,117,628
20200329,NY,59513,112847,,8503,12075,2037,2037,,,3572,b5656122e28105ae4788a0d68eabb1ef68a06287,2020-03-29T20:00:00Z,965,12075,172360,172360,172360,36,237,2021,9231,7195,16426
20200329,OH,1653,19012,,,403,,139,,,,10c9da94683ad45dfb568422d04af2604ade7ca3,2020-03-29T20:00:00Z,29,403,20665,20665,20665,39,4,59,0,247,247
20200329,OK,429,1205,,,140,,,,,,90830f70410babf14d5be9257a440aec4c3a2752,2020-03-29T20:00:00Z,16,140,1634,1634,1634,40,1,14,25,52,77
20200329,OR,548,10878,,107,129,,,37,37,,fe238901e3353621bc8b5a2c6bdc5b61a26b07fb,2020-03-29T20:00:00Z,13,129,11426,11426,11426,41,0,12,1185,69,1254
20200329,PA,3394,30061,,,682,,,,,,4c253cefa0ee9e2d70aceb14295f9bdc65824c0e,2020-03-29T20:00:00Z,38,682,33455,33455,33455,42,4,0,4807,643,5450
20200329,PR,127,841,817,,,,,,,,e0fd73e5dd7429d9fdff54eda5df78010bbd83c6,2020-03-29T20:00:00Z,5,,1785,968,968,72,2,0,102,27,129
20200329,RI,294,2541,,35,35,9,9,6,6,,c2ea9ba40403442374f7cb8372bdda06ad8d6297,2020-03-29T20:00:00Z,3,35,2835,2835,2835,44,3,7,235,91,326
20200329,SC,774,3015,,,129,,,,,,6e080ec1f424aec417c9000a8c610501e2870c5a,2020-03-29T20:00:00Z,16,129,3789,3789,3789,45,3,0,607,235,842
20200329,SD,90,3127,1,,,,,,,29,c81ef2d008bae4c0458db5684079af5ccdbe5abe,2020-03-29T20:00:00Z,1,,3218,3217,3217,46,0,0,535,22,557
20200329,TN,1537,19037,,,133,,,,,,13f3a406e572a8d2c810f9154c0c08a615f21fb1,2020-03-29T20:00:00Z,7,133,20574,20574,20574,47,1,15,2072,164,2236
20200329,TX,2552,23208,,,,,,,,,a9b7fb107b90949f6bd5ab29b957e2cf6e46f9c5,2020-03-29T20:00:00Z,34,,25760,25760,25760,48,7,0,0,500,500
20200329,UT,719,13274,,,,,,,,,c9720da2b069f73256af2086f464a94afc3ade35,2020-03-29T20:00:00Z,2,,13993,13993,13993,49,0,0,2564,117,2681
20200329,VA,890,9719,,,112,,,,,,c69c5d634a01118e8c0e248abc63805871431f51,2020-03-29T20:00:00Z,22,112,10609,10609,10609,51,5,13,1292,151,1443
20200329,VI,23,123,37,,,,,,,,fc797a1ff071a1407658e2f2635370e51d0b804d,2020-03-29T20:00:00Z,,,183,146,146,78,0,0,17,1,18
20200329,VT,235,3466,,,18,,,,,,6378ad325a9d0e9f7f1edfeb369856d460b5e9d8,2020-03-29T20:00:00Z,12,18,3701,3701,3701,50,0,0,1303,24,1327
20200329,WA,4310,54896,,,254,,,,,,79de2d56dfc5fe5931f0670e225388f974f163a9,2020-03-29T20:00:00Z,189,254,59206,59206,59206,53,14,0,5881,587,6468
20200329,WI,1112,16550,,,,,,,,,8687db826f68ba2e1871b9798043b5acf7de9e5e,2020-03-29T20:00:00Z,13,,17662,17662,17662,55,0,0,1318,123,1441
20200329,WV,113,2705,0,,1,,,,,,95339cc3a82c7850a55cdc2d30895277e29795d5,2020-03-29T20:00:00Z,0,1,2818,2818,2818,54,0,0,374,17,391
20200329,WY,86,1554,,,15,,,,,20,521448649e211047b886a9ac18dbc0b0bd35cf3e,2020-03-29T20:00:00Z,0,15,1640,1640,1640,56,0,1,79,4,83
20200328,AK,85,2836,,,5,,,,,,8a84438657945de664a61b77351faf30fafb9111,2020-03-28T20:00:00Z,2,5,2921,2921,2921,02,1,2,517,16,533
20200328,AL,696,4184,,,,,,,,,63de5e074e982530fe275d036c8318c14eabf49f,2020-03-28T20:00:00Z,3,,4880,4880,4880,01,0,0,0,109,109
20200328,AR,404,2938,0,48,48,,,17,17,24,412f7c3459c4b2a0a3735a1aee9248bad67ba3b6,2020-03-28T20:00:00Z,5,48,3342,3342,3342,05,2,0,1393,23,1416
20200328,AS,0,,0,,,,,,,,9ca49bdf3c0e49320253cd7224d932fff82e51a2,2020-03-28T20:00:00Z,0,,0,0,0,60,0,0,0,0,0
20200328,AZ,873,7455,21,,,,,,,,06aad51da966e2299f0c0537e0cf4fbba4c6c696,2020-03-28T20:00:00Z,15,,8349,8328,8328,04,2,0,0,137,137
20200328,CA,4643,20549,64400,1034,1034,410,410,,,,8c30beb89dd131ed8a1aacaa4d70b47e58810777,2020-03-28T20:00:00Z,101,1034,89592,25192,25192,06,23,288,3169,764,3933
20200328,CO,1734,9942,,,239,,,,,,037a22a41313b25a40b92f4113fa04f784d3b5c1,2020-03-28T20:00:00Z,31,239,11676,11676,11676,08,7,55,1250,304,1554
20200328,CT,1524,8676,,,205,,,,,,86371e1868776142a360e113c0677d283d829a84,2020-03-28T20:00:00Z,33,205,10200,10200,10200,09,6,32,1567,233,1800
20200328,DC,304,2211,1,,,,,,,51,1a0f746e0a4c29b6d4b0f58ba80a30d82fbc3ccb,2020-03-28T20:00:00Z,4,,2516,2515,2515,11,1,0,314,37,351
20200328,DE,214,36,,,31,,,,,9,105eb2213c38b8c874d81c0d41b587c7bfa1fa61,2020-03-28T20:00:00Z,3,31,250,250,250,10,1,16,0,51,51
20200328,FL,3763,35366,,,526,,,,,,14cf93a61518d7efeec334a7c7fb1c959060c9f8,2020-03-28T20:00:00Z,54,526,39129,39129,39129,12,20,70,7180,998,8178
20200328,GA,2366,8685,,,617,,,,,,202f88e65247b72d32891c53d6d6c15fd209d322,2020-03-28T20:00:00Z,69,617,11051,11051,11051,13,5,51,821,365,1186
20200328,GU,55,299,,,15,,,,,7,718f3702c16e8cbcd6767c2f80eaa12fc9af0817,2020-03-28T20:00:00Z,1,15,354,354,354,66,0,4,0,4,4
20200328,HI,120,4357,3,,8,,,,,,7fdb2023a9af424e34e84bcf8b0290d7ac8355ba,2020-03-28T20:00:00Z,0,8,4480,4477,4477,15,0,1,0,14,14
20200328,IA,298,4375,,46,61,,,,,15,a6e6297aaacb70cf1998fe078852e2d7c0446496,2020-03-28T20:00:00Z,3,61,4673,4673,4673,19,0,11,635,63,698
20200328,ID,230,3342,,,25,,,,,,9a384c62a22020c8ec086d3f520e57d5f47d80e1,2020-03-28T20:00:00Z,4,25,3572,3572,3572,16,1,25,674,41,715
20200328,IL,3491,22000,,,,,,,,,073372a26378c93d1b5b6ee7307fb9c030f82f2d,2020-03-28T20:00:00Z,47,,25491,25491,25491,17,13,0,3484,465,3949
20200328,IN,1232,7175,,,,,,,,,bb33e7862d580175dc4ae2bfe3b91be2dd68c719,2020-03-28T20:00:00Z,31,,8407,8407,8407,18,7,0,1220,251,1471
20200328,KS,261,3671,,,27,,,,,,aa84b44c0851b4d887ab1410a969451c25976b52,2020-03-28T20:00:00Z,5,27,3932,3932,3932,20,1,0,442,59,501
20200328,KY,302,4821,,,,,,,,,ea4c264896e76b10ebe1600f6c5705d613dc6f9e,2020-03-28T20:00:00Z,8,,5123,5123,5123,21,2,0,1053,54,1107
20200328,LA,3315,21846,,,927,,,,336,,4a0d79bda0eb000ea91e7c858e929eb0342be5af,2020-03-28T20:00:00Z,137,927,25161,25161,25161,22,18,154,3233,569,3802
20200328,MA,4257,30792,,,350,,,,,,c038ffa81528722c23a2ffffda17f2495a188ded,2020-03-28T20:00:00Z,44,350,35049,35049,35049,25,9,131,4661,1017,5678
20200328,MD,992,11516,,,226,,,,,,9a4f0c46cc3178a20535820bef6c0096ec60c487,2020-03-28T20:00:00Z,5,226,12508,12508,12508,24,0,53,11422,218,11640
20200328,ME,211,3394,,,,,,,,36,6a5bccaf6b59cc976bba660e1db01c905136fd21,2020-03-28T20:00:00Z,1,,3605,3605,3605,23,0,0,0,43,43
20200328,MI,3657,9109,,,,,,,,,19385f58abdb5af8402070c8c995ced4e4a7dd67,2020-03-28T20:00:00Z,92,,12766,12766,12766,26,0,0,2559,0,2559
20200328,MN,441,15688,,30,57,,17,,,220,a8973e480f151382f19549d1bdfc538a4e03c387,2020-03-28T20:00:00Z,5,57,16129,16129,16129,27,1,6,2083,43,2126
20200328,MO,838,10082,,,,,,,,,e3f4b93a6ae042958eb8189a70db6a5157dcbfbe,2020-03-28T20:00:00Z,10,,10920,10920,10920,29,2,0,9713,169,9882
20200328,MP,2,,,,,,,,,,7b50f60167cf1b698fab776267ec6db2d2d94e8e,2020-03-28T20:00:00Z,,,2,2,2,69,0,0,0,2,2
20200328,MS,663,2560,,,219,,,,,,6abee145ef8e88027852840cb9a48bc1ad203737,2020-03-28T20:00:00Z,13,219,3223,3223,3223,28,5,34,0,84,84
20200328,MT,129,3256,,,7,,,,,,92e123a507931bf1b282c0575331bdd0d17fba98,2020-03-28T20:00:00Z,1,7,3385,3385,3385,30,1,0,666,21,687
20200328,NC,935,16592,,87,87,,,,,,4490e409e3e6c1a5225b5a95861d3d183aecb0d8,2020-03-28T20:00:00Z,4,87,17527,17527,17527,37,1,10,2219,172,2391
20200328,ND,83,2809,,,16,,,,,16,b3dcd39ac30934f3e505d5d57bc88442172b358f,2020-03-28T20:00:00Z,1,16,2892,2892,2892,38,1,3,382,18,400
20200328,NE,96,1904,,,,,,,,,ba991b0ef3a5d94c0f5b994ff54cc8053cfde2b7,2020-03-28T20:00:00Z,2,,2000,2000,2000,31,2,0,143,11,154
20200328,NH,187,3656,296,,30,,,,,,3372eb26e404d2af3105361a92e2fcff4bdd04e7,2020-03-28T20:00:00Z,2,30,4139,3843,3843,33,1,5,261,29,290
20200328,NJ,11124,19386,,,,,,,,,c6cebd8484d76c0eb029b134ec375b577bb3c0fa,2020-03-28T20:00:00Z,140,,30510,30510,30510,34,32,0,2839,2299,5138
20200328,NM,191,9196,,17,17,,,,,,b993009444826db35c4e34917abeeb36c139fe36,2020-03-28T20:00:00Z,1,17,9387,9387,9387,35,0,17,819,55,874
20200328,NV,621,7901,,,,,,,,,38aee6610ca54e785d7593c3916d7256e0ac2a9b,2020-03-28T20:00:00Z,10,,8522,8522,8522,32,0,0,1740,86,1826
20200328,NY,52318,103616,,7328,10054,1755,1755,,,2726,7592db95575a5d4ef226ff6014283d8d85a0db52,2020-03-28T20:00:00Z,728,10054,155934,155934,155934,36,209,1528,2498,7683,10181
20200328,OH,1406,19012,,,344,,123,,,,e1ae2e6533d6476a00dce3fdf53a9d06d6df11c3,2020-03-28T20:00:00Z,25,344,20418,20418,20418,39,6,68,0,269,269
20200328,OK,377,1180,,,126,,,,,,0955acd0f7dadd282ecf522f79bd9042b3af7b95,2020-03-28T20:00:00Z,15,126,1557,1557,1557,40,7,21,96,55,151
20200328,OR,479,9693,,107,117,,,31,31,,4615188d4b688420245f6cee70b98db2cee2680e,2020-03-28T20:00:00Z,13,117,10172,10172,10172,41,1,15,1183,65,1248
20200328,PA,2751,25254,,,682,,,,,,364fcd9e3dda34165e3b738cc0b6003f43ae74f0,2020-03-28T20:00:00Z,34,682,28005,28005,28005,42,12,131,4238,533,4771
20200328,PR,100,739,792,,,,,,,,c1f61bf559aeba0b90d63533c15308234532ea16,2020-03-28T20:00:00Z,3,,1631,839,839,72,0,0,220,21,241
20200328,RI,203,2306,138,28,28,9,9,6,6,,0bed0a7e68897a419c999e031bb047fe8344d76f,2020-03-28T20:00:00Z,,28,2647,2509,2509,44,0,5,940,38,978
20200328,SC,539,2408,,,129,,,,,,4328bb39fcb99f8666b72daf09cc3812ab1727cf,2020-03-28T20:00:00Z,13,129,2947,2947,2947,45,4,20,101,83,184
20200328,SD,68,2592,0,,,,,,,26,f6d58782a216be383150078737dd5aa359ef916d,2020-03-28T20:00:00Z,1,,2660,2660,2660,46,0,0,205,10,215
20200328,TN,1373,16965,,,118,,,,,,645205ffe209d5acbff94f4dd98d7d981e97a644,2020-03-28T20:00:00Z,6,118,18338,18338,18338,47,0,15,2077,170,2247
20200328,TX,2052,23208,,,,,,,,,9d601857ab7b38aa375d52c046e21db2fe147e92,2020-03-28T20:00:00Z,27,,25260,25260,25260,48,4,0,1273,321,1594
20200328,UT,602,10710,,,,,,,,,eff17f1a0f1557568ff842519c39e1fbc56c66ae,2020-03-28T20:00:00Z,2,,11312,11312,11312,49,0,0,1946,122,2068
20200328,VA,739,8427,,,99,,,,,,4a9486b875debc40351684839a6e07900f0fd3ca,2020-03-28T20:00:00Z,17,99,9166,9166,9166,51,3,16,1694,135,1829
20200328,VI,22,106,55,,,,,,,,a72d22e25c64a506247e64802e4b379c6ad85da3,2020-03-28T20:00:00Z,0,,183,128,128,78,0,0,51,3,54
20200328,VT,211,2163,,,18,,,,,,c531c6adaae5c5623a25bebe275eb0269f0e549e,2020-03-28T20:00:00Z,12,18,2374,2374,2374,50,2,0,86,27,113
20200328,WA,3723,49015,,,254,,,,,,aa547bbffd960fa3d6684722df352a64ab786e19,2020-03-28T20:00:00Z,175,254,52738,52738,52738,53,28,254,5842,516,6358
20200328,WI,989,15232,,,,,,,,,cc9a38626e488667d80901c4814ba600f9f923cb,2020-03-28T20:00:00Z,13,,16221,16221,16221,55,0,0,2092,147,2239
20200328,WV,96,2331,6,,1,,,,,,673594f71200f16f129f2a5e2d70765e7785bb3e,2020-03-28T20:00:00Z,0,1,2433,2427,2427,54,0,0,552,20,572
20200328,WY,82,1475,,,14,,,,,18,33814ce4191a5dcfd2db3346f01e91095209c877,2020-03-28T20:00:00Z,0,14,1557,1557,1557,56,0,3,264,12,276
20200327,AK,69,2319,13,,3,,,,,,4440492623bf23f8e264cde045f01820bcf5eb1f,2020-03-27T20:00:00Z,1,3,2401,2388,2388,02,0,0,518,10,528
20200327,AL,587,4184,,,,,,,,,07d7df62adf5e730a3da751291c1fba471551397,2020-03-27T20:00:00Z,3,,4771,4771,4771,01,2,0,591,81,672
20200327,AR,381,1545,0,48,48,,,17,17,19,c2a33c66ca291bafc54edb8e9bb2bdb04a02ac38,2020-03-27T20:00:00Z,3,48,1926,1926,1926,05,0,7,41,46,87
20200327,AS,0,,0,,,,,,,,400cfc6bea633fc7dca5b095b5dbf9f025a02099,2020-03-27T20:00:00Z,0,,0,0,0,60,0,0,0,0,0
20200327,AZ,736,7455,30,,,,,,,,ed32559e21a38aa4dcf186932bc2e858d1974669,2020-03-27T20:00:00Z,13,,8221,8191,8191,04,5,0,7108,159,7267
20200327,CA,3879,17380,57400,746,746,200,200,,,,10bb2a3981dc15348851c537abdb117a3e09d2a3,2020-03-27T20:00:00Z,78,746,78659,21259,21259,06,13,746,0,873,873
20200327,CO,1430,8692,,,184,,,,,,9429f394429920c07d58b96d744275aaed7bb88b,2020-03-27T20:00:00Z,24,184,10122,10122,10122,08,5,36,1714,344,2058
20200327,CT,1291,7109,,,173,,,,,,3c8514200b49122389594ce0362801f8667bfc67,2020-03-27T20:00:00Z,27,173,8400,8400,8400,09,6,48,1484,279,1763
20200327,DC,267,1897,2,,,,,,,49,05e7fe78e293ec8a664077ad665e2495d86713bd,2020-03-27T20:00:00Z,3,,2166,2164,2164,11,0,0,271,36,307
20200327,DE,163,36,,,15,,,,,9,31d53bb84c5e9bfaceb7402a234c7fc1540bbba3,2020-03-27T20:00:00Z,2,15,199,199,199,10,1,2,0,33,33
20200327,FL,2765,28186,1517,,456,,,,,,b93ab29f799aa9d89c0f98c7f427278725445572,2020-03-27T20:00:00Z,34,456,32468,30951,30951,12,6,50,4445,410,4855
20200327,GA,2001,7864,,,566,,,,,,b85e11000166a29096d95a7188bd6313144ef7fe,2020-03-27T20:00:00Z,64,566,9865,9865,9865,13,16,93,463,476,939
20200327,GU,51,299,,,11,,,,,,acdee4d6457233f974e2858a61350934cc0888fe,2020-03-27T20:00:00Z,1,11,350,350,350,66,0,0,36,6,42
20200327,HI,106,4357,3,,7,,,,,,4c833f5762955379315a64926a584e8ded586c74,2020-03-27T20:00:00Z,,7,4466,4463,4463,15,0,2,0,11,11
20200327,IA,235,3740,,32,50,,,,,18,a23c3b107d9c1fdabfcdbf0d850c781b78831c20,2020-03-27T20:00:00Z,3,50,3975,3975,3975,19,2,4,1162,56,1218
20200327,ID,189,2668,,,,,,,,,e07b9d6372f5b9719ff22ba8d64b136f5aabe538,2020-03-27T20:00:00Z,3,,2857,2857,2857,16,3,0,603,66,669
20200327,IL,3026,18516,,,,,,,,,65f47d4e133e84caba214c7a0efd4f69e51ceb5a,2020-03-27T20:00:00Z,34,,21542,21542,21542,17,8,0,4423,488,4911
20200327,IN,981,5955,,,,,,,,,3708ffb8604728a20d1032f73b6da67ee72ea866,2020-03-27T20:00:00Z,24,,6936,6936,6936,18,7,0,1949,336,2285
20200327,KS,202,3229,,,27,,,,,,00010abd938af813b268bdf5dfe70271ba5d42aa,2020-03-27T20:00:00Z,4,27,3431,3431,3431,20,1,27,360,34,394
20200327,KY,248,3768,,,,,,,,,c8caceb5970b63067f283dfe604e520e4034f198,2020-03-27T20:00:00Z,6,,4016,4016,4016,21,2,0,666,50,716
20200327,LA,2746,18613,,,773,,,,270,,8403ec4e8479f56c60ee105634c0b15796c301c3,2020-03-27T20:00:00Z,119,773,21359,21359,21359,22,36,97,2889,441,3330
20200327,MA,3240,26131,,,219,,,,,,016484cf6143f06b89bdb98758e558945940304e,2020-03-27T20:00:00Z,35,219,29371,29371,29371,25,10,0,4927,823,5750
20200327,MD,774,94,,,173,,,,,25,0a28c9d4e27baa6cdf5626370be8d76e282880d6,2020-03-27T20:00:00Z,5,173,868,868,868,24,1,41,0,194,194
20200327,ME,168,3394,,,,,,,,24,7150d501b5d1f77e6ab73e054bb65b8ac1d6685b,2020-03-27T20:00:00Z,1,,3562,3562,3562,23,1,0,0,13,13
20200327,MI,3657,6550,,,,,,,,,9a88e637206f03a02622b999c68fa4e0b400b417,2020-03-27T20:00:00Z,92,,10207,10207,10207,26,32,0,0,801,801
20200327,MN,398,13605,,34,51,,17,,,180,7c0b3f30124d18556eddb9a53cba26e8b144daca,2020-03-27T20:00:00Z,4,51,14003,14003,14003,27,2,10,1001,52,1053
20200327,MO,669,369,,,,,,,,,e164635689d048e1c9a7125b8b7fe42bd18dfd3d,2020-03-27T20:00:00Z,8,,1038,1038,1038,29,0,0,0,167,167
20200327,MP,0,,,,,,,,,,2f5f231a6bd383fd894c67af3b27dee189d2815e,2020-03-27T20:00:00Z,0,,0,0,0,69,0,0,0,0,0
20200327,MS,579,2560,,,185,,,,,,cb4ab3b814e5417a4015c0a7ae69eb7eaa092c9a,2020-03-27T20:00:00Z,8,185,3139,3139,3139,28,2,35,269,94,363
20200327,MT,108,2590,,,7,,,,,,80cf224382b2b613d31d3a1a3987b68e42389ca3,2020-03-27T20:00:00Z,,7,2698,2698,2698,30,0,6,462,37,499
20200327,NC,763,14373,,77,77,,,,,,37a877325357e4e49c996759f5e5df827fa53973,2020-03-27T20:00:00Z,3,77,15136,15136,15136,37,1,48,2099,127,2226
20200327,ND,65,2427,,,13,,,,,15,4211f51616b6afba9db6498b58fc90ab33be7172,2020-03-27T20:00:00Z,0,13,2492,2492,2492,38,0,3,388,13,401
20200327,NE,85,1761,,,,,,,,,64cd084ae1882a6e72f9f4b3908fd89881bb007f,2020-03-27T20:00:00Z,0,,1846,1846,1846,31,0,0,177,12,189
20200327,NH,158,3395,592,,25,,,,,,a82fcad4f7253fef19c71e71f7f2429e17e1c1a7,2020-03-27T20:00:00Z,1,25,4145,3553,3553,33,0,6,394,21,415
20200327,NJ,8825,16547,,,,,,,,,4f710137c0893063153d8fe5d0e84c4ea0db8bc4,2020-03-27T20:00:00Z,108,,25372,25372,25372,34,27,0,2886,1949,4835
20200327,NM,136,8377,,,,,,,,,a96718b15dd4f8b2bf0aa0cf64145d513d35f6e6,2020-03-27T20:00:00Z,1,,8513,8513,8513,35,0,0,696,24,720
20200327,NV,535,6161,,,,,,,,,c45254e1c7f4cc7635c3cc42cc996a47b745d36c,2020-03-27T20:00:00Z,10,,6696,6696,6696,32,0,0,1464,115,1579
20200327,NY,44635,101118,,6481,8526,1583,1583,,,2045,d7f2dd3fcfbabebfdaeaa0a19e5db38d94fb112a,2020-03-27T20:00:00Z,519,8526,145753,145753,145753,36,134,1682,16272,7377,23649
20200327,OH,1137,19012,,,276,,107,,,,775347bbd54dbd3e3235391c7d2d5eb4c87cab2c,2020-03-27T20:00:00Z,19,276,20149,20149,20149,39,4,53,2563,270,2833
20200327,OK,322,1084,,,105,,,,,,01208f5d22ac2638f9654bb25fdb4bbe426dd561,2020-03-27T20:00:00Z,8,105,1406,1406,1406,40,1,19,126,74,200
20200327,OR,414,8510,,91,102,,,31,31,,b60609c583643679e2b128c34d9394e1a6104f4d,2020-03-27T20:00:00Z,12,102,8924,8924,8924,41,1,12,1557,87,1644
20200327,PA,2218,21016,,,551,,,,,,fd19aa2aff1d4344dacb287cc60878c5197ca944,2020-03-27T20:00:00Z,22,551,23234,23234,23234,42,6,551,4575,531,5106
20200327,PR,79,519,334,,,,,,,,aefe7a30d1464bfc9d4213163b6f4e311db5a14b,2020-03-27T20:00:00Z,3,,932,598,598,72,1,0,142,15,157
20200327,RI,165,1366,138,23,23,9,9,6,6,,3aa8781ddb1a283fea34688735c02184efabee03,2020-03-27T20:00:00Z,,23,1669,1531,1531,44,0,0,27,0,27
20200327,SC,456,2307,,,109,,,,,,eba42fa8d4d9d65fdf8d2aefb0cc7cf13e75ee31,2020-03-27T20:00:00Z,9,109,2763,2763,2763,45,0,0,0,0,0
20200327,SD,58,2387,20,,,,,,,21,5d1fd96fd9c93ab88a3ac21f0a7fb8314ab018ef,2020-03-27T20:00:00Z,1,,2465,2445,2445,46,0,0,414,12,426
20200327,TN,1203,14888,,,103,,,,,,c3a5af8cf2531b13791648be5b30584a9e811787,2020-03-27T20:00:00Z,6,103,16091,16091,16091,47,3,27,936,246,1182
20200327,TX,1731,21935,,,,,,,,,8409fedc70d96ce072fcd2c62d1101488f155d94,2020-03-27T20:00:00Z,23,,23666,23666,23666,48,5,0,1907,335,2242
20200327,UT,480,8764,,,,,,,,,59049455f72c15c38a8ad386ca6a601e271b4a6d,2020-03-27T20:00:00Z,2,,9244,9244,9244,49,1,0,1456,78,1534
20200327,VA,604,6733,,,83,,,,,,376dd9385db92b70861adb4e990699e2ae38ea4f,2020-03-27T20:00:00Z,14,83,7337,7337,7337,51,1,18,1004,144,1148
20200327,VI,19,55,2,,,,,,,,9d4a9356e2a46f3d6adfaa8df2adb5ac097e4973,2020-03-27T20:00:00Z,0,,76,74,74,78,0,0,0,2,2
20200327,VT,184,2077,,,18,,,,,,0064eda2b4b2bd74f386a29d0fa13b8378aff141,2020-03-27T20:00:00Z,10,18,2261,2261,2261,50,1,18,227,26,253
20200327,WA,3207,43173,,,,,,,,,c6ef40387ed54825d111164344c738e39fc62ef5,2020-03-27T20:00:00Z,147,,46380,46380,46380,53,15,0,11461,627,12088
20200327,WI,842,13140,,,,,,,,,8c63c548c621e8d51f2c08c5e2e7a34947238262,2020-03-27T20:00:00Z,13,,13982,13982,13982,55,5,0,1557,135,1692
20200327,WV,76,1779,43,,1,,,,,,67ad4031bd5dd9dfb1b414880205d3698549469c,2020-03-27T20:00:00Z,0,1,1898,1855,1855,54,0,0,748,25,773
20200327,WY,70,1211,,,11,,,,,17,ece3b4c4bd5b7103d4e083be4a022cb425a1924f,2020-03-27T20:00:00Z,0,11,1281,1281,1281,56,0,11,159,17,176
20200326,AK,59,1801,,,3,,,,,,141c8e163d64a2762eb6ce6fab3863ab853929a4,2020-03-26T20:00:00Z,1,3,1860,1860,1860,02,0,2,152,17,169
20200326,AL,506,3593,,,,,,,,,fbb44aa6b758e39d9ca03edb761c2463bc6d09e7,2020-03-26T20:00:00Z,1,,4099,4099,4099,01,1,0,1064,223,1287
20200326,AR,335,1504,0,,41,,,13,13,13,656e4e9b9d53f6e3be192d6f9585097318f7fb71,2020-03-26T20:00:00Z,3,41,1839,1839,1839,05,1,19,67,55,122
20200326,AS,0,,,,,,,,,,98da741ffed4cd778657b01c77b48a449f3d2d4a,2020-03-26T20:00:00Z,0,,0,0,0,60,0,0,0,0,0
20200326,AZ,577,347,33,,66,,22,,,,deb2212f309289845fd1870568f7257709f3f009,2020-03-26T20:00:00Z,8,66,957,924,924,04,2,58,24,127,151
20200326,CA,3006,17380,57400,,,,,,,,d073989819811eaa4edd1a4f71a3716c44b653ac,2020-03-26T20:00:00Z,65,,77786,20386,20386,06,12,0,1459,651,2110
20200326,CO,1086,6978,,,148,,,,,,cbe89fafefaf1d9173be314f959f33e567cf4dd2,2020-03-26T20:00:00Z,19,148,8064,8064,8064,08,8,64,189,174,363
20200326,CT,1012,5625,,,125,,,,,,051ee3a0ff5962ca5aa0f29cad1950bc8408c88a,2020-03-26T20:00:00Z,21,125,6637,6637,6637,09,2,12,602,137,739
20200326,DC,231,1626,1,,,,,,,21,be59e63006a0dcd465209f8d1b3097218f92f343,2020-03-26T20:00:00Z,3,,1858,1857,1857,11,1,0,203,48,251
20200326,DE,130,36,,,13,,,,,4,0d755f6bd49fb4e9f225cc7c4d88b57451a21d68,2020-03-26T20:00:00Z,1,13,166,166,166,10,1,2,0,15,15
20200326,FL,2355,23741,1443,,406,,,,,,1290ba6a489ffe158fa4333c279e73b7c728543e,2020-03-26T20:00:00Z,28,406,27539,26096,26096,12,6,90,8367,673,9040
20200326,GA,1525,7401,,,473,,,,,,5bd7f61bc12b4e207e0ceda50e5fe469273a6b44,2020-03-26T20:00:00Z,48,473,8926,8926,8926,13,8,79,2469,278,2747
20200326,GU,45,263,,,11,,,,,,e1cae0461dad015119d3fe4abb4848007a468bd1,2020-03-26T20:00:00Z,1,11,308,308,308,66,0,1,30,8,38
20200326,HI,95,4357,,,5,,,,,,cdbfa8c05d4138523b7bd76294518d1ef0dac898,2020-03-26T20:00:00Z,,5,4452,4452,4452,15,0,-1,0,5,5
20200326,IA,179,2578,,31,46,,,,,15,411e2fbdf3f70764fb24db7b34feb147bc2ecb13,2020-03-26T20:00:00Z,1,46,2757,2757,2757,19,0,10,0,34,34
20200326,ID,123,2065,,,,,,,,,accd7f2d4f84c66bb09e13ee9e72790b73ed7751,2020-03-26T20:00:00Z,0,,2188,2188,2188,16,0,0,178,50,228
20200326,IL,2538,14093,,,,,,,,,ede372266e78d0a0ceff08d95ac84932e0fcfc7d,2020-03-26T20:00:00Z,26,,16631,16631,16631,17,7,0,1749,673,2422
20200326,IN,645,4006,,,,,,,,,d09dec87fbea244ee83df1fb0d61288197978934,2020-03-26T20:00:00Z,17,,4651,4651,4651,18,3,0,1127,168,1295
20200326,KS,168,2869,,,,,,,,,aa2e17ec747401ff3e73105d0b833fa0b4f03d67,2020-03-26T20:00:00Z,3,,3037,3037,3037,20,0,0,509,42,551
20200326,KY,198,3102,,,,,,,,,3a82ab3456c2469d52b7790c96cb4cfa30f25cd5,2020-03-26T20:00:00Z,4,,3300,3300,3300,21,0,0,237,41,278
20200326,LA,2305,15724,,,676,,,,239,,a3dd3f994877e467e4b0eede332659cfeca99714,2020-03-26T20:00:00Z,83,676,18029,18029,18029,22,18,185,6068,510,6578
20200326,MA,2417,21204,,,219,,,,,,83a4a37ff66f38e205b0b18839828d141802f5c1,2020-03-26T20:00:00Z,25,219,23621,23621,23621,25,10,116,3248,579,3827
20200326,MD,580,94,,,132,,,,,,871e46620cc8507563260a7f3a0336d8e426ab51,2020-03-26T20:00:00Z,4,132,674,674,674,24,0,132,0,157,157
20200326,ME,155,3394,,,,,,,,16,482e706965e1aaacc7b8f40547be7a63dbcb4b7d,2020-03-26T20:00:00Z,,,3549,3549,3549,23,0,0,217,6,223
20200326,MI,2856,6550,,,,,,,,,310c71abd72cba718d14795224e4119494c942b2,2020-03-26T20:00:00Z,60,,9406,9406,9406,26,17,0,4481,562,5043
20200326,MN,346,12604,,31,41,,,,,,54abcd207865204ef3da6e8985ee95f798f94255,2020-03-26T20:00:00Z,2,41,12950,12950,12950,27,1,6,1416,59,1475
20200326,MO,502,369,,,,,,,,,5d322e752d7a1f4672917629e7702c7bc26a93f6,2020-03-26T20:00:00Z,8,,871,871,871,29,0,0,0,146,146
20200326,MP,0,,,,,,,,,,4f1e047c3e63f3349e4f7c617874492431c8a5f9,2020-03-26T20:00:00Z,0,,0,0,0,69,0,0,0,0,0
20200326,MS,485,2291,,,150,,,,,,20667611a63432824d0ff16867b5adc4c06b5936,2020-03-26T20:00:00Z,6,150,2776,2776,2776,28,4,33,725,108,833
20200326,MT,71,2128,,,1,,,,,,e7caf7619a1d9a6677a95d9d85eb24598221158d,2020-03-26T20:00:00Z,,1,2199,2199,2199,30,0,1,180,18,198
20200326,NC,636,12274,,29,29,,,,,,b8eeb5c864773c3f14bc449f0e27f832d9ced2b0,2020-03-26T20:00:00Z,2,29,12910,12910,12910,37,1,0,2289,132,2421
20200326,ND,52,2039,,,10,,,,,,e574ee98155f078e25da07dbc6404e23add90f9b,2020-03-26T20:00:00Z,0,10,2091,2091,2091,38,0,2,305,13,318
20200326,NE,73,1584,,,,,,,,,b1e3ffd00324b8a8500be3b3a4b0e378b57710b5,2020-03-26T20:00:00Z,0,,1657,1657,1657,31,0,0,280,12,292
20200326,NH,137,3001,712,,19,,,,,,a37cd44af5e89e3f36bcbc424c61162b18173e05,2020-03-26T20:00:00Z,1,19,3850,3138,3138,33,0,6,645,29,674
20200326,NJ,6876,13661,,,,,,,,,71a03230e8915d5c02cdc6c56ad1fb7e389070b8,2020-03-26T20:00:00Z,81,,20537,20537,20537,34,19,0,3209,2474,5683
20200326,NM,112,7681,,,,,,,,,1e43be6fccfd53482152b6f0032c9f5380179480,2020-03-26T20:00:00Z,1,,7793,7793,7793,35,0,0,939,12,951
20200326,NV,420,4697,,,,,,,,,8439b92c8ef2ecd1b055e3ed1acbab7bedd90001,2020-03-26T20:00:00Z,10,,5117,5117,5117,32,4,0,446,99,545
20200326,NY,37258,84846,,5327,6844,1290,1290,,,,c9e5180c39aab68a5662116651d17a05f4e4b966,2020-03-26T20:00:00Z,385,6844,122104,122104,122104,36,100,3039,12178,6447,18625
20200326,OH,867,16449,,,223,,91,,,,ec54f23b722a56fc6cb60ec0603c774a574b1b58,2020-03-26T20:00:00Z,15,223,17316,17316,17316,39,5,41,2389,163,2552
20200326,OK,248,958,,,86,,,,,,6a5dd746a3fa2c1898256473098b5715589457c2,2020-03-26T20:00:00Z,7,86,1206,1206,1206,40,2,27,153,84,237
20200326,OR,327,6953,,,90,,,,,,ddb030ea072a2fe01a8d71d2a5a24e917d4e8ea2,2020-03-26T20:00:00Z,11,90,7280,7280,7280,41,3,29,2603,118,2721
20200326,PA,1687,16441,,,,,,,,,7712fd7f15f40e975c2a503bd7633edd4387df7e,2020-03-26T20:00:00Z,16,,18128,18128,18128,42,5,0,5248,560,5808
20200326,PR,64,377,335,,,,,,,,f0017006486c2085b91f1f75468f643da3153af8,2020-03-26T20:00:00Z,2,,776,441,441,72,0,0,60,13,73
20200326,RI,165,1339,181,23,23,9,9,6,6,,9d7cee089d5fa0072f878937365b6bd9edcce159,2020-03-26T20:00:00Z,,23,1685,1504,1504,44,0,7,196,41,237
20200326,SC,456,2307,,,109,,,,,,4c55b055bf2708a25455b71cdb3d6115453ed71c,2020-03-26T20:00:00Z,9,109,2763,2763,2763,45,2,7,4,32,36
20200326,SD,46,1973,125,,,,,,,16,279cd2d4767245d1841274ed2d19a0a4f5c9b673,2020-03-26T20:00:00Z,1,,2144,2019,2019,46,0,0,1154,5,1159
20200326,TN,957,13952,,,76,,,,,,d3ce5ed8216ba2c78107cb4d4ec9da1dd0b0f77f,2020-03-26T20:00:00Z,3,76,14909,14909,14909,47,0,23,2940,173,3113
20200326,TX,1396,20028,,,,,,,,,fa643c14dbc1c896f7d243f22f25aa05e563d6af,2020-03-26T20:00:00Z,18,,21424,21424,21424,48,6,0,7508,422,7930
20200326,UT,402,7308,,,,,,,,,dd83cffb270720784e9e520a6513c7c8f1ec68c5,2020-03-26T20:00:00Z,1,,7710,7710,7710,49,0,0,817,56,873
20200326,VA,460,5729,,,65,,,,,,60d151765c90a17f38487d1089ef283796e1c122,2020-03-26T20:00:00Z,13,65,6189,6189,6189,51,4,6,750,69,819
20200326,VI,17,55,2,,,,,,,,0b6ff1f5ca40d1b5f45a6c082027ae81b69ccd8c,2020-03-26T20:00:00Z,0,,74,72,72,78,0,0,0,0,0
20200326,VT,158,1850,,,,,,,,,994b0d80648160d62da49b803410ff385ef7f906,2020-03-26T20:00:00Z,9,,2008,2008,2008,50,1,0,261,35,296
20200326,WA,2580,31712,,,,,,,,,e178057fc2a88562fb8b27dcb5cb7ce3bb9da334,2020-03-26T20:00:00Z,132,,34292,34292,34292,53,9,0,0,111,111
20200326,WI,707,11583,,,,,,,,,9683cfe2bd653af14dcfc375a493d40198712796,2020-03-26T20:00:00Z,8,,12290,12290,12290,55,1,0,1494,122,1616
20200326,WV,51,1031,19,,1,,,,,,ea32f587f060c45231c6013fa4924abbc339400a,2020-03-26T20:00:00Z,0,1,1101,1082,1082,54,0,0,272,12,284
20200326,WY,53,1052,,,,,,,,12,4fb67721dfe7158af2d510dc704638497f0a8359,2020-03-26T20:00:00Z,,,1105,1105,1105,56,0,0,98,9,107
20200325,AK,42,1649,,,1,,,,,,d0981dc0ff9e0b50793d2307ce11831905ea3c01,2020-03-25T20:00:00Z,1,1,1691,1691,1691,02,1,1,663,6,669
20200325,AL,283,2529,,,,,,,,,2f45607dc8271295dd36e91588d93ebaa1bc3110,2020-03-25T20:00:00Z,0,,2812,2812,2812,01,0,0,423,68,491
20200325,AR,280,1437,0,,22,,,4,4,11,61e9fcf63e4e65989b0d7d33799dc5a4ebb561c1,2020-03-25T20:00:00Z,2,22,1717,1717,1717,05,2,0,490,62,552
20200325,AS,0,,,,,,,,,,ff91b0fef7a79ce57e895f7f72649764a72b683b,2020-03-25T20:00:00Z,0,,0,0,0,60,0,0,0,0,0
20200325,AZ,450,323,53,,8,,,,,,dc556f3dc293fb7a55dee7fe3c218072dbf23e43,2020-03-25T20:00:00Z,6,8,826,773,773,04,1,0,10,93,103
20200325,CA,2355,15921,48600,,,,,,,,8d9cf944b6bf56c413644ce7729ef18efa3d75a0,2020-03-25T20:00:00Z,53,,66876,18276,18276,06,13,0,2469,253,2722
20200325,CO,912,6789,,,84,,,,,,8c313a278c9f6cf6f983d33ae981c70da8f94b76,2020-03-25T20:00:00Z,11,84,7701,7701,7701,08,4,12,1285,192,1477
20200325,CT,875,5023,,,113,,,,,,7fd69cdd6c25f9c6b2da4c3feb12f0ac36c44c16,2020-03-25T20:00:00Z,19,113,5898,5898,5898,09,7,42,341,257,598
20200325,DC,183,1423,3,,,,,,,,4c94c1d06cba80ba6ca85bc5eb70dab16b46b6bf,2020-03-25T20:00:00Z,2,,1609,1606,1606,11,0,0,228,46,274
20200325,DE,115,36,,,11,,,,,,176d5e478db0e4032758e1858abe680e3dc11dba,2020-03-25T20:00:00Z,0,11,151,151,151,10,0,11,0,24,24
20200325,FL,1682,15374,1233,,316,,,,,,3824a66b112cf25a03e7e1701dc1af01026bd711,2020-03-25T20:00:00Z,22,316,18289,17056,17056,12,4,57,2247,270,2517
20200325,GA,1247,4932,,,394,,,,,,0608d7952fefcad2df075352ee28eb32e13426be,2020-03-25T20:00:00Z,40,394,6179,6179,6179,13,8,394,474,221,695
20200325,GU,37,233,,,10,,,,,,c747d0e2beb8d0f2a82dbd31e226598481d3f9d9,2020-03-25T20:00:00Z,1,10,270,270,270,66,0,5,32,5,37
20200325,HI,90,4357,,2,6,,,,,,a5c696c2ff0356dad2baa04274b0ec77b5bbe835,2020-03-25T20:00:00Z,1,6,4447,4447,4447,15,0,2,768,13,781
20200325,IA,145,2578,,23,36,,,,,,13d8e16121979021bb57103d7b961e31b3dfee2e,2020-03-25T20:00:00Z,1,36,2723,2723,2723,19,1,9,263,21,284
20200325,ID,73,1887,,,,,,,,,a4fa527e00632ae29efb14c92c81b06642e554cb,2020-03-25T20:00:00Z,0,,1960,1960,1960,16,0,0,0,23,23
20200325,IL,1865,12344,,,,,,,,,de4c69056480e6111af2b8aeb434f5f8d597b170,2020-03-25T20:00:00Z,19,,14209,14209,14209,17,3,0,2410,330,2740
20200325,IN,477,2879,,,1,,,,,,1a6af9e7ccb688e3321a736a824bb1fe799b7ef8,2020-03-25T20:00:00Z,14,1,3356,3356,3356,18,2,0,313,112,425
20200325,KS,126,2360,,,,,,,,,deae962902c0a2fb252f981aaba83eda616d6029,2020-03-25T20:00:00Z,3,,2486,2486,2486,20,1,0,274,28,302
20200325,KY,157,2865,,,,,,,,,8fc7de737c41520c298dcbceba279e065ddceeb7,2020-03-25T20:00:00Z,4,,3022,3022,3022,21,0,0,1123,33,1156
20200325,LA,1795,9656,,,491,,,,163,,b9c6d4f81c9f0b6777df7bd4190349d006d90222,2020-03-25T20:00:00Z,65,491,11451,11451,11451,22,19,220,2441,407,2848
20200325,MA,1838,17956,,,103,,,,,,95bb4fdcf8938f1681915e4ab6cd29914ed60b24,2020-03-25T20:00:00Z,15,103,19794,19794,19794,25,4,9,5366,679,6045
20200325,MD,423,94,,,,,,,,,ef79567177f07f1f10279b6a4bbb1326684bbd00,2020-03-25T20:00:00Z,4,,517,517,517,24,1,0,0,74,74
20200325,ME,149,3177,,,,,,,,7,6a21285c01dfd9378d220175d14dc3a772dfe3fe,2020-03-25T20:00:00Z,,,3326,3326,3326,23,0,0,163,24,187
20200325,MI,2294,2069,,,,,,,,,a9f71d967c982eca5345379d53b1d83b96be4e15,2020-03-25T20:00:00Z,43,,4363,4363,4363,26,19,0,0,503,503
20200325,MN,287,11188,,26,35,,,,,122,0901433ad4b755a7fa7bf999a5d1cb967f3b843e,2020-03-25T20:00:00Z,1,35,11475,11475,11475,27,0,14,5638,25,5663
20200325,MO,356,369,,,,,,,,,f7ac8ac4376125f549f2d3237af885e7effab1b5,2020-03-25T20:00:00Z,8,,725,725,725,29,5,0,0,173,173
20200325,MP,0,,,,,,,,,,2412f6b612ee38dd778455fcf069651b33a164a0,2020-03-25T20:00:00Z,0,,0,0,0,69,0,0,0,0,0
20200325,MS,377,1566,,,117,,,,,,9968fd3d3074b5b25f4930d48c5c7269f0a83495,2020-03-25T20:00:00Z,2,117,1943,1943,1943,28,1,31,14,57,71
20200325,MT,53,1948,,,,,,,,,25cdd51b3866c8760da24735f8c0b495d8ea371c,2020-03-25T20:00:00Z,,,2001,2001,2001,30,0,0,305,7,312
20200325,NC,504,9985,,29,29,,,,,,f1ebbf14648813a80f26774a206119e81adfdd97,2020-03-25T20:00:00Z,1,29,10489,10489,10489,37,1,29,1844,106,1950
20200325,ND,39,1734,,,8,,,,,,6c0feae4a6bfd4cf279d43da9bed66faff769fa4,2020-03-25T20:00:00Z,0,8,1773,1773,1773,38,0,3,280,5,285
20200325,NE,61,1304,,,,,,,,,72bc397b422f829aa332430ba9e018a98aec8427,2020-03-25T20:00:00Z,0,,1365,1365,1365,31,0,0,329,9,338
20200325,NH,108,2356,804,,13,,,,,,ba894271c0369b91572e02c61dbe15afd68c146b,2020-03-25T20:00:00Z,1,13,3268,2464,2464,33,0,2,909,7,916
20200325,NJ,4402,10452,,,,,,,,,db32961abdc494e4610cb9201238755c5dbe9c9d,2020-03-25T20:00:00Z,62,,14854,14854,14854,34,18,0,2127,727,2854
20200325,NM,100,6742,,,,,,,,,b1128704739dbdde58897b48092a9f580fa1ee73,2020-03-25T20:00:00Z,1,,6842,6842,6842,35,1,0,852,17,869
20200325,NV,321,4251,0,,,,,,,,00de92ade569ceeb91261a39215a34cd9d7876fb,2020-03-25T20:00:00Z,6,,4572,4572,4572,32,2,0,297,43,340
20200325,NY,30811,72668,,,3805,,,,,,332b18596170cd3e35617cfba48a5723aa2ec8f3,2020-03-25T20:00:00Z,285,3805,103479,103479,103479,36,75,571,7063,5146,12209
20200325,OH,704,14060,,,182,,74,,,,37f081a41326a68ac5070d7ed52344f4839699b4,2020-03-25T20:00:00Z,10,182,14764,14764,14764,39,2,37,13920,140,14060
20200325,OK,164,805,,,59,,,,,,0a9c58ed26188df9e615374204dca8c4e9bded41,2020-03-25T20:00:00Z,5,59,969,969,969,40,2,34,70,58,128
20200325,OR,209,4350,,,61,,,,,,5a3e8848f9b6371e0c31274fd62117c40f06a0a3,2020-03-25T20:00:00Z,8,61,4559,4559,4559,41,0,0,0,0,0
20200325,PA,1127,11193,,,,,,,,,a04cdbf57ddbd0c489b48882295db9559fb037b5,2020-03-25T20:00:00Z,11,,12320,12320,12320,42,4,0,2550,276,2826
20200325,PR,51,317,70,,,,,,,,a29866b5ad6a6ac14b8d352af3b9af315c1f1c63,2020-03-25T20:00:00Z,2,,438,368,368,72,0,0,49,12,61
20200325,RI,124,1143,196,16,16,,,,,,93a324631369ebe04fc4e8023ec4be560dc61c8e,2020-03-25T20:00:00Z,,16,1463,1267,1267,44,0,16,23,18,41
20200325,SC,424,2303,,,102,,,,,,eee95db6f47c1427fd6e5482cf0deeced90a8f05,2020-03-25T20:00:00Z,7,102,2727,2727,2727,45,2,102,291,126,417
20200325,SD,41,819,268,,,,,,,,26eb16cec32ca8e58e78f3faa6b2bf73b60aeecc,2020-03-25T20:00:00Z,1,,1128,860,860,46,0,0,29,11,40
20200325,TN,784,11012,,,53,,,,,,99bf1065223280d5519a05c0f2363f77244d41a9,2020-03-25T20:00:00Z,3,53,11796,11796,11796,47,1,53,495,117,612
20200325,TX,974,12520,,,,,,,,,94d22076ee33e8232bf343c6e7cb48853cad8083,2020-03-25T20:00:00Z,12,,13494,13494,13494,48,3,0,1763,564,2327
20200325,UT,346,6491,,,,,,,,,0edf4fe386389c4acf4c834fa913fa86ba48669b,2020-03-25T20:00:00Z,1,,6837,6837,6837,49,0,0,967,47,1014
20200325,VA,391,4979,,,59,,,,,,f6276b380e5e6e9a92435116b52b41ae24db94df,2020-03-25T20:00:00Z,9,59,5370,5370,5370,51,2,14,799,101,900
20200325,VI,17,55,2,,,,,,,,a4875c74f0d88f851187106cd0a2c99766569c2d,2020-03-25T20:00:00Z,0,,74,72,72,78,0,0,55,0,55
20200325,VT,123,1589,,,,,,,,,007aa638edad042e4ae3bc4e7d899f62b3d3ffee,2020-03-25T20:00:00Z,8,,1712,1712,1712,50,1,0,149,28,177
20200325,WA,2469,31712,,,,,,,,,44b3cb99139fc5b8f131fa7216e447a156a958b4,2020-03-25T20:00:00Z,123,,34181,34181,34181,53,13,0,0,248,248
20200325,WI,585,10089,,,,,,,,,990d1cee0a0325690dd1ddb866cc2ec4d457130a,2020-03-25T20:00:00Z,7,,10674,10674,10674,55,2,0,1852,128,1980
20200325,WV,39,759,6,,1,,,,,,e23f509ba05bca7c485e27672c0beea77f7608e7,2020-03-25T20:00:00Z,0,1,804,798,798,54,0,0,149,19,168
20200325,WY,44,954,,,,,,,,7,9eeedd6bac08a0fa82e127b99fd62ab414a2f690,2020-03-25T20:00:00Z,,,998,998,998,56,0,0,244,15,259
20200324,AK,36,986,,,0,,,,,,86d9a09be1d74e12fd125a0d9309b80ca0cdd92d,2020-03-24T20:00:00Z,,0,1022,1022,1022,02,0,0,40,14,54
20200324,AL,215,2106,,,,,,,,,c212a8468e01e67b91f78d053b0440276641d84f,2020-03-24T20:00:00Z,0,,2321,2321,2321,01,0,0,441,48,489
20200324,AR,218,947,0,,22,,,,,,0b94fc3f2ae505e0dd8151e1419c11a85382e78d,2020-03-24T20:00:00Z,0,22,1165,1165,1165,05,0,9,41,44,85
20200324,AS,0,,,,,,,,,,5cf89452dcad215bb1a9977e24d0e1cd842dca62,2020-03-24T20:00:00Z,0,,0,0,0,60,0,0,0,0,0
20200324,AZ,357,313,22,,8,,,,,,449d58f08329418edaec9016f670d8449ffedf9e,2020-03-24T20:00:00Z,5,8,692,670,670,04,3,8,4,92,96
20200324,CA,2102,13452,12100,,,,,,,,de4019ee1e7e99d093947ecd2a91c6093439f221,2020-03-24T20:00:00Z,40,,27654,15554,15554,06,13,0,885,369,1254
20200324,CO,720,5504,,,72,,,,,,c947881e894b49f30ec05924ca6a34637dddc741,2020-03-24T20:00:00Z,7,72,6224,6224,6224,08,1,14,659,129,788
20200324,CT,618,4682,,,71,,,,,,612d0cb8b3d8f54b99ab9aeb2e9cfd65b7f5e923,2020-03-24T20:00:00Z,12,71,5300,5300,5300,09,2,17,597,203,800
20200324,DC,137,1195,2,,,,,,,,b0e3891c7034fd64b2031778208ec8934a5f2ddf,2020-03-24T20:00:00Z,2,,1334,1332,1332,11,0,0,82,21,103
20200324,DE,91,36,,,0,,,,,,f7380b5d7171743791a97122afb7f725b1bebf65,2020-03-24T20:00:00Z,0,0,127,127,127,10,0,0,0,23,23
20200324,FL,1412,13127,1008,,259,,,,,,01f224778b595c53a53b114c66966c5987214220,2020-03-24T20:00:00Z,18,259,15547,14539,14539,12,4,42,2064,241,2305
20200324,GA,1026,4458,,,,,,,,,837865a88d570829d28bd06b24a4d97e5e901ddb,2020-03-24T20:00:00Z,32,,5484,5484,5484,13,7,0,161,254,415
20200324,GU,32,201,,,5,,,,,,d9dff2a8e6d232c4474e25568da416b4d03baa5f,2020-03-24T20:00:00Z,1,5,233,233,233,66,0,5,40,3,43
20200324,HI,77,3589,,,4,,,,,,fdb4277e9dd95701d6ff1546a0136e5a3be12c5e,2020-03-24T20:00:00Z,1,4,3666,3666,3666,15,1,4,634,21,655
20200324,IA,124,2315,,,27,,,,,,7cc0fd2b921b97c1bfacb447011ac898b4781078,2020-03-24T20:00:00Z,,27,2439,2439,2439,19,0,27,272,19,291
20200324,ID,50,1887,,,,,,,,,027fc25af7fa5b80a0a2d8e1f588710a5a0b223f,2020-03-24T20:00:00Z,0,,1937,1937,1937,16,0,0,578,3,581
20200324,IL,1535,9934,,,,,,,,,9c757789b4681fc36efffd962d3e75fb4ee6374f,2020-03-24T20:00:00Z,16,,11469,11469,11469,17,4,0,1351,262,1613
20200324,IN,365,2566,,,1,,,,,,d20aff6badc212807b7cd5db58fc6d2b08795e49,2020-03-24T20:00:00Z,12,1,2931,2931,2931,18,5,0,865,106,971
20200324,KS,98,2086,,,,,,,,,282cc098a42c426e6cf2f9a0d3fcff306bfe1547,2020-03-24T20:00:00Z,2,,2184,2184,2184,20,0,0,1669,16,1685
20200324,KY,124,1742,,,,,,,,,6d68c9646c28d3b3f584173aed361e0a5a8c9204,2020-03-24T20:00:00Z,4,,1866,1866,1866,21,1,0,-20,20,0
20200324,LA,1388,7215,,,271,,,,,,c443054e2ff12e070077b14d3071b89ea08d7346,2020-03-24T20:00:00Z,46,271,8603,8603,8603,22,12,271,2439,216,2655
20200324,MA,1159,12590,,,94,,,,,,7dba190b6c130ef5b8427912adbcf550a3e63368,2020-03-24T20:00:00Z,11,94,13749,13749,13749,25,2,15,4445,382,4827
20200324,MD,349,94,,,,,,,,,266357ae1f44a606612441a5a7418a525dda2e4b,2020-03-24T20:00:00Z,3,,443,443,443,24,0,0,0,61,61
20200324,ME,125,3014,,,,,,,,,9f0c2d2a6bfd36968270dd1dce4ecdfcb0e894bd,2020-03-24T20:00:00Z,,,3139,3139,3139,23,0,0,223,18,241
20200324,MI,1791,2069,,,,,,,,,51b4853b99e397722bba7993d875ce4f9cf72d4c,2020-03-24T20:00:00Z,24,,3860,3860,3860,26,9,0,0,463,463
20200324,MN,262,5550,,,21,,,,,,4359be22f1d018582c52f57f0005ecd6da7e3697,2020-03-24T20:00:00Z,1,21,5812,5812,5812,27,0,4,1039,27,1066
20200324,MO,183,369,,,,,,,,,9e947531084071a07ed377efd8d57dac769fed9f,2020-03-24T20:00:00Z,3,,552,552,552,29,0,0,0,0,0
20200324,MP,0,,,,,,,,,,52d83ea3d9e40fdcb085782a62b7e421b38959eb,2020-03-24T20:00:00Z,0,,0,0,0,69,0,0,0,0,0
20200324,MS,320,1552,,,86,,,,,,4b6d159c684e2e8f23fc95e94397d786890afbd4,2020-03-24T20:00:00Z,1,86,1872,1872,1872,28,0,53,409,71,480
20200324,MT,46,1643,,,,,,,,,fc865b228236789c9beaaf57416291a8b341f1ed,2020-03-24T20:00:00Z,,,1689,1689,1689,30,0,0,497,12,509
20200324,NC,398,8141,,,,,,,,,48a75030e4fdc67a802eb4afde3e104c229b4eca,2020-03-24T20:00:00Z,0,,8539,8539,8539,37,0,0,0,101,101
20200324,ND,34,1454,,,5,,,,,,4e468d07760eca0f47732febc8a8afab1800febe,2020-03-24T20:00:00Z,0,5,1488,1488,1488,38,0,1,101,4,105
20200324,NE,52,975,,,,,,,,,8b9d1afc73a62509d249a7f707364e01b05db6b1,2020-03-24T20:00:00Z,0,,1027,1027,1027,31,0,0,619,2,621
20200324,NH,101,1447,869,,11,,,,,,eb6013bb5115cbbe92d9b4d3830dd1fc8f64c164,2020-03-24T20:00:00Z,1,11,2417,1548,1548,33,1,11,73,23,96
20200324,NJ,3675,8325,45,,,,,,,,3298b6676fb93503cc4695dfd502db188db72854,2020-03-24T20:00:00Z,44,,12045,12000,12000,34,17,0,7966,831,8797
20200324,NM,83,5890,,,,,,,,,01ee7963abb7aa5321d1d1ea06baaad72fc05588,2020-03-24T20:00:00Z,,,5973,5973,5973,35,0,0,569,18,587
20200324,NV,278,3954,0,,,,,,,,235104a86eaec318d30593b04bff7a986b4292da,2020-03-24T20:00:00Z,4,,4232,4232,4232,32,0,0,464,33,497
20200324,NY,25665,65605,,,3234,,,,,,ea3323c8187b8ff5574d3576f83791e01dd1521f,2020-03-24T20:00:00Z,210,3234,91270,91270,91270,36,96,599,8191,4790,12981
20200324,OH,564,140,,,145,,,,,,63b5a22304ed473e83bfbf270a76c1032acea29e,2020-03-24T20:00:00Z,8,145,704,704,704,39,2,41,0,122,122
20200324,OK,106,735,,,25,,,,,,6f7920a3fbf6e8734988631827d4e088b3e392e1,2020-03-24T20:00:00Z,3,25,841,841,841,40,1,10,41,25,66
20200324,OR,209,4350,,,61,,,,,,48f6f90138b010e86974032f5c2c2831e7fb4a75,2020-03-24T20:00:00Z,8,61,4559,4559,4559,41,3,5,701,18,719
20200324,PA,851,8643,,,,,,,,,ce0a280d338c6cb38fc09e23260c4a9d36b61a64,2020-03-24T20:00:00Z,7,,9494,9494,9494,42,1,0,2048,207,2255
20200324,PR,39,268,42,,,,,,,,a4422b62864b4880eb9b5ca60650238cb712aae5,2020-03-24T20:00:00Z,2,,349,307,307,72,0,0,79,8,87
20200324,RI,106,1120,77,,,,,,,,ad48e36a041ed872084786bb3ab82a7dd19ef455,2020-03-24T20:00:00Z,,,1303,1226,1226,44,0,0,188,0,188
20200324,SC,298,2012,,,,,,,,,3ee6b47e4fe208a1a7422880f344f3f32f67679b,2020-03-24T20:00:00Z,5,,2310,2310,2310,45,0,0,546,-1,545
20200324,SD,30,790,268,,,,,,,,f1b660e61e0b8a627c426d7b62a346a72b2e7797,2020-03-24T20:00:00Z,1,,1088,820,820,46,0,0,28,2,30
20200324,TN,667,10517,,,,,,,,,4c9bb8e4a36f22b926ee84af65928e341d4fef89,2020-03-24T20:00:00Z,2,,11184,11184,11184,47,0,0,7245,52,7297
20200324,TX,410,10757,,,,,,,,,f004eb8a9503c7e97a5fc6cd7c6d33278d7a4305,2020-03-24T20:00:00Z,9,,11167,11167,11167,48,1,0,1054,58,1112
20200324,UT,299,5524,,,,,,,,,ded18a05ae98e3a2dd796af47b0463703d38fd1e,2020-03-24T20:00:00Z,1,,5823,5823,5823,49,0,0,734,42,776
20200324,VA,290,4180,,,45,,,,,,c50739256e2bff651beb24c7d3bf783301d228bd,2020-03-24T20:00:00Z,7,45,4470,4470,4470,51,1,7,737,36,773
20200324,VI,17,,,,,,,,,,35ddf8fee63a0be7c0a22c080f5a10386b85cc9c,2020-03-24T20:00:00Z,0,,17,17,17,78,0,0,0,0,0
20200324,VT,95,1440,,,,,,,,,a0057043daf21cd5b60d9e10d5109d9aa2dbb574,2020-03-24T20:00:00Z,7,,1535,1535,1535,50,2,0,334,20,354
20200324,WA,2221,31712,,,,,,,,,9da4d0ab70b396d48bb42e53afa63e5d21c41aef,2020-03-24T20:00:00Z,110,,33933,33933,33933,53,15,0,2833,225,3058
20200324,WI,457,8237,,,,,,,,,f3b3b8071eeb99db0f8a0ba361cffbf1d17aa843,2020-03-24T20:00:00Z,5,,8694,8694,8694,55,0,0,1187,41,1228
20200324,WV,20,610,0,,1,,,,,,b1e8c04bf831d17f0262bc42ab7656b32f937f44,2020-03-24T20:00:00Z,0,1,630,630,630,54,0,0,166,4,170
20200324,WY,29,710,,,,,,,,,98459e884507e1d53a1bdd0bc4cb1ab9ccd26ffc,2020-03-24T20:00:00Z,,,739,739,739,56,0,0,118,3,121
20200323,AK,22,946,,,0,,,,,,5b877bb95cb6757628e204dc5d905269b0adeb80,2020-03-23T20:00:00Z,,0,968,968,968,02,0,0,0,0,0
20200323,AL,167,1665,,,,,,,,,83712877a917de925fb93de8aaa8443850e13f5e,2020-03-23T20:00:00Z,0,,1832,1832,1832,01,0,0,201,29,230
20200323,AR,174,906,0,,13,,,,,,e09e8b2605a7009ec131f16ddea0823b160084fe,2020-03-23T20:00:00Z,0,13,1080,1080,1080,05,0,0,195,9,204
20200323,AS,,,,,,,,,,,90a046f9acb7ff5dfa0d4311a5b944b5103ab579,2020-03-23T20:00:00Z,0,,0,0,0,60,0,0,0,0,0
20200323,AZ,265,309,6,,,,,,,,14d6aadf353c2d7f46fa679d1eef562ab766560e,2020-03-23T20:00:00Z,2,,580,574,574,04,0,0,27,113,140
20200323,CA,1733,12567,12100,,,,,,,,71c982ee815f7305f8cc4c93014774584620fa5f,2020-03-23T20:00:00Z,27,,26400,14300,14300,06,0,0,1263,197,1460
20200323,CO,591,4845,,,58,,,,,,6b1fa67763ae63bce2ebcbebf278b71c202743cd,2020-03-23T20:00:00Z,6,58,5436,5436,5436,08,1,9,770,116,886
20200323,CT,415,4085,,,54,,,,,,2518c62f7473aa16f7d4006600fa46f294a5365e,2020-03-23T20:00:00Z,10,54,4500,4500,4500,09,5,11,1208,192,1400
20200323,DC,116,1113,,,,,,,,,a4ac9750469218e985257eae6f8bf345a38e2e94,2020-03-23T20:00:00Z,2,,1229,1229,1229,11,1,0,156,18,174
20200323,DE,68,36,,,0,,,,,,985e87646f1f998dc688b69d711d73d1646cd85e,2020-03-23T20:00:00Z,0,0,104,104,104,10,0,0,0,12,12
20200323,FL,1171,11063,860,,217,,,,,,fefea265e78e4106c70c1907bee630dd8b5d76ad,2020-03-23T20:00:00Z,14,217,13094,12234,12234,12,1,32,3073,341,3414
20200323,GA,772,4297,,,,,,,,,0f7832c9c3f96874233ce85032ac2f2d78f66eb8,2020-03-23T20:00:00Z,25,,5069,5069,5069,13,2,0,877,172,1049
20200323,GU,29,161,,,,,,,,,ce31ff4a54165054ac6f5f94f5fe0f449c7fa847,2020-03-23T20:00:00Z,1,,190,190,190,66,0,0,35,2,37
20200323,HI,56,2955,,,,,,,,,a64b1c79f254b53625563c06841dd934ec71c54b,2020-03-23T20:00:00Z,,,3011,3011,3011,15,0,0,2692,8,2700
20200323,IA,105,2043,,,,,,,,,e300223bdb614731413a2a2689d16cd9d67b28be,2020-03-23T20:00:00Z,,,2148,2148,2148,19,0,0,828,15,843
20200323,ID,47,1309,,,,,,,,,671c3f6d3a73ffe687fb7f61e9f4ee48557c2217,2020-03-23T20:00:00Z,0,,1356,1356,1356,16,0,0,134,5,139
20200323,IL,1273,8583,,,,,,,,,0d6671c3e7d63029f51e664df09115c8458b7875,2020-03-23T20:00:00Z,12,,9856,9856,9856,17,3,0,1312,224,1536
20200323,IN,259,1701,,,1,,,,,,b98a92f68b8f40cdb0f7aac19be6caeff46c5480,2020-03-23T20:00:00Z,7,1,1960,1960,1960,18,1,0,408,58,466
20200323,KS,82,417,,,,,,,,,3e1f376103afb2bf2e72cbfb075ca706098eecda,2020-03-23T20:00:00Z,2,,499,499,499,20,0,0,0,18,18
20200323,KY,104,1762,,,,,,,,,1da5d1dc8e4c52e1ff55eb3170d02ea0200a4cb0,2020-03-23T20:00:00Z,3,,1866,1866,1866,21,0,0,290,5,295
20200323,LA,1172,4776,,,,,,,,,fd499be556bb029c4bc349ac19373d9ba7b95fcd,2020-03-23T20:00:00Z,34,,5948,5948,5948,22,14,0,2115,335,2450
20200323,MA,777,8145,,,79,,,,,,40b8c6ab57a8cd588c84704eea95f5d596cb66f6,2020-03-23T20:00:00Z,9,79,8922,8922,8922,25,4,8,2686,131,2817
20200323,MD,288,94,,,,,,,,,6e4ed4b8716381c2a1daaa4d89c4647815bc188e,2020-03-23T20:00:00Z,3,,382,382,382,24,0,0,0,44,44
20200323,ME,107,2791,,,,,,,,,88636589511012ea8869a31269dbb2c701023479,2020-03-23T20:00:00Z,,,2898,2898,2898,23,0,0,527,18,545
20200323,MI,1328,2069,,,,,,,,,b3d92249498258b511c3e0096b4740313fcc50e7,2020-03-23T20:00:00Z,15,,3397,3397,3397,26,7,0,0,293,293
20200323,MN,235,4511,,,17,,,,,,d688eeb57c635ed77ed2196359d616a3dae38e3e,2020-03-23T20:00:00Z,1,17,4746,4746,4746,27,0,5,0,66,66
20200323,MO,183,369,,,,,,,,,d451a8053ea326216b31c935b674d0457532b596,2020-03-23T20:00:00Z,3,,552,552,552,29,0,0,0,93,93
20200323,MP,0,,,,,,,,,,55022701b87eeeffb616fb7eae76d2e2fe55bb3b,2020-03-23T20:00:00Z,0,,0,0,0,69,0,0,0,0,0
20200323,MS,249,1143,,,33,,,,,,2ed97cbc9d4455685f466d3ba3c9e7edbd3413ef,2020-03-23T20:00:00Z,1,33,1392,1392,1392,28,0,0,29,42,71
20200323,MT,34,1146,,,,,,,,,e824730ff62964c60931b7f59c00c1e8ee7ea035,2020-03-23T20:00:00Z,,,1180,1180,1180,30,0,0,0,3,3
20200323,NC,297,8141,,,,,,,,,f498171c52256d450302d4d6e478d260e7d5b51d,2020-03-23T20:00:00Z,0,,8438,8438,8438,37,0,0,1958,42,2000
20200323,ND,30,1353,,,4,,,,,,b45813a4a0e083874a405d5ffb64d2944abf2d5f,2020-03-23T20:00:00Z,0,4,1383,1383,1383,38,0,1,93,2,95
20200323,NE,50,356,,,,,,,,,93f27986c82b8f07b7360321ad9d715951ff14e0,2020-03-23T20:00:00Z,0,,406,406,406,31,0,0,0,2,2
20200323,NH,78,1374,889,,,,,,,,ea9ab3f6c3061a5ed37885a1478f700d7c44c9b6,2020-03-23T20:00:00Z,,,2341,1452,1452,33,0,0,186,13,199
20200323,NJ,2844,359,94,,,,,,,,31b24615de8d15c0b6de14c1d8d6d4f06708f56f,2020-03-23T20:00:00Z,27,,3297,3203,3203,34,7,0,32,930,962
20200323,NM,65,5321,,,,,,,,,fd468d865dcbf3b9efc33a3819fbe8ad824cbec7,2020-03-23T20:00:00Z,,,5386,5386,5386,35,0,0,599,8,607
20200323,NV,245,3490,0,,,,,,,,2aab20307742f5fb55e14b7dda981537b641addd,2020-03-23T20:00:00Z,4,,3735,3735,3735,32,2,0,1042,55,1097
20200323,NY,20875,57414,,,2635,,,,,,40440cdc2bc6ecd1d88040f01ebbdcb130a33257,2020-03-23T20:00:00Z,114,2635,78289,78289,78289,36,0,661,11181,5707,16888
20200323,OH,442,140,,,104,,,,,,8966d12c492b67747a0413f8a0fb4ee97bc8b1d6,2020-03-23T20:00:00Z,6,104,582,582,582,39,3,21,0,91,91
20200323,OK,81,694,102,,15,,,,,,06988832908c4bd0101aa70897aaa31f44bf1f07,2020-03-23T20:00:00Z,2,15,877,775,775,40,0,4,25,14,39
20200323,OR,191,3649,,,56,,,,,,d32dc80aee60746bbda8cd2ded2558efd103b76d,2020-03-23T20:00:00Z,5,56,3840,3840,3840,41,1,13,785,30,815
20200323,PA,644,6595,,,,,,,,,f34848bd60ba259abd8ba905bbf1a2edc2e450da,2020-03-23T20:00:00Z,6,,7239,7239,7239,42,4,0,1631,165,1796
20200323,PR,31,189,35,,,,,,,,f11fb4d67e27feb9ecd7b591d6c96fd2073b15eb,2020-03-23T20:00:00Z,2,,255,220,220,72,2,0,6,8,14
20200323,RI,106,932,216,,,,,,,,09e8adb16f2e4c7b3b6358125df41faf1077f1ee,2020-03-23T20:00:00Z,,,1254,1038,1038,44,0,0,0,23,23
20200323,SC,299,1466,,,,,,,,,33a15e3a79d4ed06c2d35f85b493ce03724ecf6d,2020-03-23T20:00:00Z,5,,1765,1765,1765,45,2,0,0,104,104
20200323,SD,28,762,265,,,,,,,,042646860048b05f38e0717c8322ccb5dcf0a33e,2020-03-23T20:00:00Z,1,,1055,790,790,46,0,0,22,7,29
20200323,TN,615,3272,,,,,,,,,2c5ac2c1a6353ca8ed3b942a6580e298e333a7ff,2020-03-23T20:00:00Z,2,,3887,3887,3887,47,2,0,0,110,110
20200323,TX,352,9703,,,,,,,,,b8898c676a614ee7ce5cba28465922cb7b1b025e,2020-03-23T20:00:00Z,8,,10055,10055,10055,48,3,0,1281,18,1299
20200323,UT,257,4790,,,,,,,,,1c0d56f6022578f0b588db0251a1c880d278c1c8,2020-03-23T20:00:00Z,1,,5047,5047,5047,49,0,0,1282,76,1358
20200323,VA,254,3443,,,38,,,,,,f04ccf03a897d757c0d98d7b10c12edb59dbbc33,2020-03-23T20:00:00Z,6,38,3697,3697,3697,51,3,6,325,35,360
20200323,VI,17,,,,,,,,,,be5239897627f12aa169a01e3af7a96e28078d4a,2020-03-23T20:00:00Z,0,,17,17,17,78,0,0,0,11,11
20200323,VT,75,1106,,,,,,,,,72af0f2c9c2f632f233a942199d61c606b68fd90,2020-03-23T20:00:00Z,5,,1181,1181,1181,50,3,0,0,23,23
20200323,WA,1996,28879,,,,,,,,,a3330315ca0c6d8393cbffc5d4da83ba0e7a116b,2020-03-23T20:00:00Z,95,,30875,30875,30875,53,1,0,3551,203,3754
20200323,WI,416,7050,,,,,,,,,4d367dd2bdc949d101983f7dca73a29062b3f1f7,2020-03-23T20:00:00Z,5,,7466,7466,7466,55,1,0,820,31,851
20200323,WV,16,444,4,,1,,,,,,93a7366dbdbbe8314dac0702465b28a583e20467,2020-03-23T20:00:00Z,0,1,464,460,460,54,0,0,59,4,63
20200323,WY,26,592,,,,,,,,,61e5cc96d0195daeb49d495e5abec3130fbb841f,2020-03-23T20:00:00Z,,,618,618,618,56,0,0,154,2,156
20200322,AK,22,946,,,0,,,,,,504bd8c46a81250111c4f843793c7109a771b3c1,2020-03-22T20:00:00Z,,0,968,968,968,02,0,0,188,8,196
20200322,AL,138,1464,,,,,,,,,336c2b990aa3df11f73436c012fb53a71c5b36fd,2020-03-22T20:00:00Z,0,,1602,1602,1602,01,0,0,1436,14,1450
20200322,AR,165,711,119,,13,,,,,,5789c418a7bed092bbe6aac119688f2c4d56b0a9,2020-03-22T20:00:00Z,0,13,995,876,876,05,0,13,144,47,191
20200322,AS,,,,,,,,,,,7922fdb5c81d4a4b4549e23485608a699255d3c9,2020-03-22T20:00:00Z,0,,0,0,0,60,0,0,0,0,0
20200322,AZ,152,282,87,,,,,,,,4cbd0a587cb58735684352d0a8dea494c4e5510a,2020-03-22T20:00:00Z,2,,521,434,434,04,1,0,42,48,90
20200322,CA,1536,11304,,,,,,,,,894c0795f019e9dad5fb2ea4b76464bd93ca011e,2020-03-22T20:00:00Z,27,,12840,12840,12840,06,3,0,55,257,312
20200322,CO,475,4075,,,49,,,,,,fab49da0cdb600a59150ddac2560c877980a2738,2020-03-22T20:00:00Z,5,49,4550,4550,4550,08,1,5,758,112,870
20200322,CT,223,2877,,,43,,,,,,5ec45e857aa3f53058bff9441efe10f05aeff922,2020-03-22T20:00:00Z,5,43,3100,3100,3100,09,1,43,771,29,800
20200322,DC,98,957,,,,,,,,,6cd7f2b5c81f8b714e6564b8bcd9309604c9d92e,2020-03-22T20:00:00Z,1,,1055,1055,1055,11,0,0,451,21,472
20200322,DE,56,36,,,,,,,,,853edea9e9aa87a30f9e8d40e2f4a73735f35606,2020-03-22T20:00:00Z,0,,92,92,92,10,0,0,0,11,11
20200322,FL,830,7990,963,,185,,,,,,4e90c613758e8eb9c13d69d3d68c462bba4cb68f,2020-03-22T20:00:00Z,13,185,9783,8820,8820,12,1,27,1411,172,1583
20200322,GA,600,3420,,,,,,,,,69702dd23d01e4995145ae809b89338c1dd848e2,2020-03-22T20:00:00Z,23,,4020,4020,4020,13,9,0,863,93,956
20200322,GU,27,126,,,,,,,,,760562a7cce7809e06d7d66233f2168e78f3ae9f,2020-03-22T20:00:00Z,1,,153,153,153,66,1,0,18,12,30
20200322,HI,48,263,,,,,,,,,6daf3b6060a3ba24489bc466e6e5c190b15955c4,2020-03-22T20:00:00Z,,,311,311,311,15,0,0,139,11,150
20200322,IA,90,1215,,,,,,,,,0d5c8c0464af1d50dab5ca09cb810e469781a539,2020-03-22T20:00:00Z,,,1305,1305,1305,19,0,0,166,22,188
20200322,ID,42,1175,,,,,,,,,f79d41155ce5dde0d4087aceff09c30b8b2f5ad9,2020-03-22T20:00:00Z,0,,1217,1217,1217,16,0,0,295,11,306
20200322,IL,1049,7271,,,,,,,,,54f72764f10b61ac90bf334158a12c9193e78805,2020-03-22T20:00:00Z,9,,8320,8320,8320,17,3,0,1783,296,2079
20200322,IN,201,1293,,,1,,,,,,753c16b219930207a817b10f2ad60504a7a5762d,2020-03-22T20:00:00Z,6,1,1494,1494,1494,18,2,0,586,75,661
20200322,KS,64,417,,,,,,,,,699f1a58fbe837f26dfaa7bf2bb51d82ce9c6928,2020-03-22T20:00:00Z,2,,481,481,481,20,0,0,0,9,9
20200322,KY,99,1472,,,,,,,,,a9002192cd7888064a4a40cd704e6b6f19933dc9,2020-03-22T20:00:00Z,3,,1571,1571,1571,21,1,0,758,45,803
20200322,LA,837,2661,,,,,,,,,c89220ae4e2b0931fb785ec35f44887bf5a5355b,2020-03-22T20:00:00Z,20,,3498,3498,3498,22,4,0,481,252,733
20200322,MA,646,5459,,,71,,,,,,80dbca40ed272bb21a8cb8dc36290f39876b1ad2,2020-03-22T20:00:00Z,5,71,6105,6105,6105,25,4,10,707,121,828
20200322,MD,244,94,,,,,,,,,d9cf183ca3af60eaff0e839e6542a4ae56000e2d,2020-03-22T20:00:00Z,3,,338,338,338,24,1,0,0,54,54
20200322,ME,89,2264,,,,,,,,,75a9c5c5d650bb96972accb662c7a1498fc48e10,2020-03-22T20:00:00Z,,,2353,2353,2353,23,0,0,0,16,16
20200322,MI,1035,2069,,,,,,,,,60a521d83d9795ed2c10c5acd73ac27f04430f53,2020-03-22T20:00:00Z,8,,3104,3104,3104,26,3,0,0,248,248
20200322,MN,169,4511,,,12,,,,,,eca43d6a5a1e21aef9b115cbf6c37684dfe5daff,2020-03-22T20:00:00Z,1,12,4680,4680,4680,27,0,12,559,31,590
20200322,MO,90,369,,,,,,,,,4ccad6d58d6ff133d8f62d55cdee11096e9c76c3,2020-03-22T20:00:00Z,3,,459,459,459,29,0,0,0,17,17
20200322,MP,0,,,,,,,,,,47a1f8351b146d34fc8eca53b5de76e4487e7dcc,2020-03-22T20:00:00Z,0,,0,0,0,69,0,0,0,0,0
20200322,MS,207,1114,,,33,,,,,,894b62e8c387654b1a0363daf8a6664d1ec4f1a3,2020-03-22T20:00:00Z,1,33,1321,1321,1321,28,0,33,419,67,486
20200322,MT,31,1146,,,,,,,,,b2c90f7ae286607e49a984824d71835787a69bf8,2020-03-22T20:00:00Z,,,1177,1177,1177,30,0,0,0,11,11
20200322,NC,255,6183,,,,,,,,,f7ae5da72d04953c92dbeded88d4532bcc0e7cf5,2020-03-22T20:00:00Z,0,,6438,6438,6438,37,0,0,1091,71,1162
20200322,ND,28,1260,,,3,,,,,,7549a624b49809d6eac8a3c40e3b6617c40ff00a,2020-03-22T20:00:00Z,0,3,1288,1288,1288,38,0,0,119,0,119
20200322,NE,48,356,,,,,,,,,7689257b7671d64bc5dc19ab900cc8be6d724b4a,2020-03-22T20:00:00Z,0,,404,404,404,31,0,0,0,10,10
20200322,NH,65,1188,959,,,,,,,,0b7e1e183feb671d98bc630201bb3f4af7bf1187,2020-03-22T20:00:00Z,,,2212,1253,1253,33,0,0,215,10,225
20200322,NJ,1914,327,49,,,,,,,,facc3296d95ab4cdeff98dca4f6628c0c6c8a193,2020-03-22T20:00:00Z,20,,2290,2241,2241,34,4,0,33,587,620
20200322,NM,57,4722,,,,,,,,,41571c753abe314b81f1a7a40a28672e2d5620c0,2020-03-22T20:00:00Z,,,4779,4779,4779,35,0,0,951,0,951
20200322,NV,190,2448,,,,,,,,,0dc69efb9cfc8c62e6017e048e94bd390c94d17a,2020-03-22T20:00:00Z,2,,2638,2638,2638,32,0,0,64,66,130
20200322,NY,15168,46233,,,1974,,,,,,0df3f76e6407f511b0c5bf4f5647cce8f407250e,2020-03-22T20:00:00Z,114,1974,61401,61401,61401,36,70,371,11152,4812,15964
20200322,OH,351,140,,,83,,,,,,39a31d5f0d426b43011e943369aa758634b79c97,2020-03-22T20:00:00Z,3,83,491,491,491,39,0,25,0,104,104
20200322,OK,67,669,102,,11,,,,,,9ffd88f2064177c641dd3d488b2e05f323b81e67,2020-03-22T20:00:00Z,2,11,838,736,736,40,1,1,109,14,123
20200322,OR,161,2864,,,43,,,,,,ce0d62ce9e64793f5c0c0061df7f500c056f1f94,2020-03-22T20:00:00Z,4,43,3025,3025,3025,41,1,43,861,47,908
20200322,PA,479,4964,,,,,,,,,e55025d414359bd8039b3a89935560cdf0759885,2020-03-22T20:00:00Z,2,,5443,5443,5443,42,0,0,1198,108,1306
20200322,PR,23,183,69,,,,,,,,0687c7ff3672264c3265a35d79b30261de725d94,2020-03-22T20:00:00Z,,,275,206,206,72,0,0,40,2,42
20200322,RI,83,932,216,,,,,,,,336ba62e784bf62845374085980f220843d7ec7a,2020-03-22T20:00:00Z,,,1231,1015,1015,44,0,0,70,17,87
20200322,SC,195,1466,,,,,,,,,f3e5741d5023be2ca84d4a5214e6358c0c04ceeb,2020-03-22T20:00:00Z,3,,1661,1661,1661,45,2,0,211,43,254
20200322,SD,21,740,277,,,,,,,,941d3d4dd057bb31c2e6d38e1b899825feffd220,2020-03-22T20:00:00Z,1,,1038,761,761,46,0,0,49,7,56
20200322,TN,505,3272,,,,,,,,,fd0f694ad2179b8cf66684537a9072b0649eed59,2020-03-22T20:00:00Z,,,3777,3777,3777,47,0,0,0,134,134
20200322,TX,334,8422,,,,,,,,,b4cdb42d93deee8dd849c6c76a750d6cf2bcc16d,2020-03-22T20:00:00Z,5,,8756,8756,8756,48,0,0,2204,30,2234
20200322,UT,181,3508,,,,,,,,,3de2bbed886da550ffa13c9dc65e5535094d41bc,2020-03-22T20:00:00Z,1,,3689,3689,3689,49,1,0,1084,45,1129
20200322,VA,219,3118,,,32,,,,,,47ee4fa81f1a7aa2fadcb7ad212b0f2a82b88b1f,2020-03-22T20:00:00Z,3,32,3337,3337,3337,51,1,7,480,67,547
20200322,VI,6,,,,,,,,,,7db5ee09d85325a1d55c2b4e2f931cabc46bc4a0,2020-03-22T20:00:00Z,0,,6,6,6,78,0,0,0,0,0
20200322,VT,52,1106,,,,,,,,,a0b8449a701d2d442dc5b5fadad80a005d26261b,2020-03-22T20:00:00Z,2,,1158,1158,1158,50,0,0,327,23,350
20200322,WA,1793,25328,,,,,,,,,072f5a891339bd1334dfd2ef0458210d55271483,2020-03-22T20:00:00Z,94,,27121,27121,27121,53,11,0,3609,269,3878
20200322,WI,385,6230,,,,,,,,,5c152a9b70d088a432901c770430f27845f16456,2020-03-22T20:00:00Z,4,,6615,6615,6615,55,0,0,1602,104,1706
20200322,WV,12,385,1,,1,,,,,,0d111a66e470107a431de577c6d88b5504353ada,2020-03-22T20:00:00Z,0,1,398,397,397,54,0,0,55,1,56
20200322,WY,24,438,,,,,,,,,750fd7dc66060691c7f4a95b90a3f9f941c5222b,2020-03-22T20:00:00Z,,,462,462,462,56,0,0,0,1,1
20200321,AK,14,758,,,0,,,,,,b050951c91b95024044c0e9cd3260ade47c193bd,2020-03-21T20:00:00Z,,0,772,772,772,02,0,0,72,2,74
20200321,AL,124,28,,,,,,,,,de15c7bdfb3b72e13399f1aaa8d69612f69f0837,2020-03-21T20:00:00Z,0,,152,152,152,01,0,0,0,43,43
20200321,AR,118,567,154,,,,,,,,be7b0d560d9725c09fd5b6c5c63b15bb489164e8,2020-03-21T20:00:00Z,,,839,685,685,05,0,0,216,22,238
20200321,AS,,,,,,,,,,,33990faa3753488ca4df5d2b72fd1f6afe43e9bf,2020-03-21T20:00:00Z,0,,0,0,0,60,0,0,0,0,0
20200321,AZ,104,240,122,,,,,,,,c4d69ffe430a0b9d8e0af64e25058aedfdcac703,2020-03-21T20:00:00Z,1,,466,344,344,04,1,0,29,39,68
20200321,CA,1279,11249,,,,,,,,,49c4e45a8661e84906ca87575ab8d30e7c494b6c,2020-03-21T20:00:00Z,24,,12528,12528,12528,06,4,0,825,216,1041
20200321,CO,363,3317,,,44,,,,,,167a0c3ceb00a06a5b8dc5ed629b4e1e38ec9ea1,2020-03-21T20:00:00Z,4,44,3680,3680,3680,08,1,44,642,86,728
20200321,CT,194,2106,,,,,,,,,7366c98d6eeab0fb8ef1f185d59d99cbd4c2a6b8,2020-03-21T20:00:00Z,4,,2300,2300,2300,09,1,0,1502,0,1502
20200321,DC,77,506,0,,,,,,,,aec17bd719975bbec3f0d91dd96a3eb1b1aaef3e,2020-03-21T20:00:00Z,1,,583,583,583,11,0,0,5,6,11
20200321,DE,45,36,,,,,,,,,9df04d2ff8e944c3501daa02149467845c6fad89,2020-03-21T20:00:00Z,0,,81,81,81,10,0,0,0,7,7
20200321,FL,658,6579,1002,,158,,,,,,9fcedaea4a2b5e2daad7c2ef3cae3d7c4a66d46c,2020-03-21T20:00:00Z,12,158,8239,7237,7237,12,2,158,4709,138,4847
20200321,GA,507,2557,,,,,,,,,fa63ec9c063c79b907568e755be9a52e3851b5e5,2020-03-21T20:00:00Z,14,,3064,3064,3064,13,1,0,591,87,678
20200321,GU,15,108,,,,,,,,,bcf4bfbdb666a8125546ac9fa1bde5a40314887c,2020-03-21T20:00:00Z,,,123,123,123,66,0,0,22,1,23
20200321,HI,37,124,9,,,,,,,,29d59e995900078c30286e988f7731b63a8147d5,2020-03-21T20:00:00Z,,,170,161,161,15,0,0,0,11,11
20200321,IA,68,1049,,,,,,,,,b528ea4ecdc29227ff49d0ab40010fdb7bf04aea,2020-03-21T20:00:00Z,,,1117,1117,1117,19,0,0,407,23,430
20200321,ID,31,880,,,,,,,,,1268984bb40128971dfbbbdf403635e18e6f7435,2020-03-21T20:00:00Z,,,911,911,911,16,0,0,290,8,298
20200321,IL,753,5488,,,,,,,,,dfaf7e4b5931f46806fd364b0e61a3dbe2fe4550,2020-03-21T20:00:00Z,6,,6241,6241,6241,17,1,0,1792,168,1960
20200321,IN,126,707,,,1,,,,,,13d8880065d2c2f4c3379631774752a809f99330,2020-03-21T20:00:00Z,4,1,833,833,833,18,2,1,232,47,279
20200321,KS,55,417,,,,,,,,,0d27ae2aac0674330f6e9556a34def2a48ade762,2020-03-21T20:00:00Z,2,,472,472,472,20,1,0,0,11,11
20200321,KY,54,714,,,,,,,,,e6bdc1623c24ec023b4fea42690fb3d28619b944,2020-03-21T20:00:00Z,2,,768,768,768,21,1,0,122,7,129
20200321,LA,585,2180,,,,,,,,,f7c6c177e7b1f643227b1bc755f63bbb75468835,2020-03-21T20:00:00Z,16,,2765,2765,2765,22,4,0,1612,106,1718
20200321,MA,525,4752,,,61,,,,,,9434ecc82e2e7e8a85d8a027a082389be42e290a,2020-03-21T20:00:00Z,1,61,5277,5277,5277,25,0,61,1074,112,1186
20200321,MD,190,94,,,,,,,,,4cac298bc1adaf891591b29d4b8eb0cd3ffef248,2020-03-21T20:00:00Z,2,,284,284,284,24,1,0,0,41,41
20200321,ME,73,2264,,,,,,,,,dd280f45b75f2790185aabea6a93f1539dcd6c4a,2020-03-21T20:00:00Z,,,2337,2337,2337,23,0,0,0,16,16
20200321,MI,787,2069,,,,,,,,,4bbc307860335d00f5fc599de63d3be3b261a288,2020-03-21T20:00:00Z,5,,2856,2856,2856,26,2,0,0,238,238
20200321,MN,138,3952,,,,,,,,,c8e20e13bb45ac57df76285e119c0769f67c89ea,2020-03-21T20:00:00Z,1,,4090,4090,4090,27,1,0,211,23,234
20200321,MO,73,369,,,,,,,,,4c5ecaada5fac9b16c463e5e42cff715b3ad3efb,2020-03-21T20:00:00Z,3,,442,442,442,29,2,0,0,26,26
20200321,MP,0,,,,,,,,,,97c8946fa6d5bb252c7aa2f2ee65129cf5fd9dde,2020-03-21T20:00:00Z,0,,0,0,0,69,0,0,0,0,0
20200321,MS,140,695,,,,,,,,,05eb75b1e562b9e17f37c33e0678a91de01249c7,2020-03-21T20:00:00Z,1,,835,835,835,28,0,0,0,60,60
20200321,MT,20,1146,,,,,,,,,21bc115fe9533e51dfac6d8defee24a86919d9a3,2020-03-21T20:00:00Z,,,1166,1166,1166,30,0,0,215,4,219
20200321,NC,184,5092,,,,,,,,,bc8438b4be03c06d8b21bb306fa8bcade8848a98,2020-03-21T20:00:00Z,0,,5276,5276,5276,37,0,0,1996,47,2043
20200321,ND,28,1141,,,3,,,,,,e9d65a0e24737712855433e9427b090d5d58befa,2020-03-21T20:00:00Z,0,3,1169,1169,1169,38,0,3,341,8,349
20200321,NE,38,356,,,,,,,,,5ba9131cf10b134a34623b70bf8983dbc48c9272,2020-03-21T20:00:00Z,0,,394,394,394,31,0,0,116,6,122
20200321,NH,55,973,942,,,,,,,,71e8c55d1c62bedffae8403188aa39dedc642ba9,2020-03-21T20:00:00Z,,,1970,1028,1028,33,0,0,228,11,239
20200321,NJ,1327,294,40,,,,,,,,619c8150d5592b43e0b0c8a542f3ce57862c85b9,2020-03-21T20:00:00Z,16,,1661,1621,1621,34,5,0,30,437,467
20200321,NM,57,3771,,,,,,,,,5b0fa970db849e97ab1b9c07d675a9ac7ace9f7c,2020-03-21T20:00:00Z,,,3828,3828,3828,35,0,0,0,14,14
20200321,NV,124,2384,,,,,,,,,c0c98568c4165cc83bc5ee07b50589fdfb35f7e4,2020-03-21T20:00:00Z,2,,2508,2508,2508,32,1,0,392,15,407
20200321,NY,10356,35081,,,1603,,,,,,eb983c3fb4fc2d7f3c2c1250578379f502787c29,2020-03-21T20:00:00Z,44,1603,45437,45437,45437,36,9,1603,9756,3254,13010
20200321,OH,247,140,,,58,,,,,,dd1dfcf33ceacdd2502013ab34d3156f97223334,2020-03-21T20:00:00Z,3,58,387,387,387,39,2,58,0,78,78
20200321,OK,53,560,144,,10,,,,,,1503e792121ec9bc0aa951a7efe032de95f66efd,2020-03-21T20:00:00Z,1,10,757,613,613,40,0,10,22,4,26
20200321,OR,114,2003,433,,,,,,,,10b3171e833e613dedf31c1ac227cc4a45ef6ea0,2020-03-21T20:00:00Z,3,,2550,2117,2117,41,0,0,0,0,0
20200321,PA,371,3766,,,,,,,,,18df8e2622a5b9fc6b266124af168742b75d3bae,2020-03-21T20:00:00Z,2,,4137,4137,4137,42,1,0,1192,103,1295
20200321,PR,21,143,71,,,,,,,,da8e3b5ccde7f2d73b65a882224183f80e407fb8,2020-03-21T20:00:00Z,,,235,164,164,72,0,0,29,7,36
20200321,RI,66,862,290,,,,,,,,00d75088744e90ea4359ef44da37b2c1048d4897,2020-03-21T20:00:00Z,,,1218,928,928,44,0,0,208,12,220
20200321,SC,152,1255,,,,,,,,,4e3f5cbdfb98432f0e6cc8c36ace53a52b5fd93a,2020-03-21T20:00:00Z,1,,1407,1407,1407,45,0,0,422,71,493
20200321,SD,14,691,268,,,,,,,,faf893694ef24b3ff6f7e4f3332d1cf892dc1326,2020-03-21T20:00:00Z,1,,973,705,705,46,0,0,28,0,28
20200321,TN,371,3272,,,,,,,,,9944d4fad172ece09a78536be10dcc0a6baac09c,2020-03-21T20:00:00Z,,,3643,3643,3643,47,0,0,2709,143,2852
20200321,TX,304,6218,,,,,,,,,54267227a81424058326d8ead3199e15f96b8d75,2020-03-21T20:00:00Z,5,,6522,6522,6522,48,0,0,1135,110,1245
20200321,UT,136,2424,,,,,,,,,1612a05ae5f2350863da87addf0e11159a1c4d0c,2020-03-21T20:00:00Z,0,,2560,2560,2560,49,0,0,389,24,413
20200321,VA,152,2638,,,25,,,,,,d3642dd2689ddb450f271a5e4940f134feb53a28,2020-03-21T20:00:00Z,2,25,2790,2790,2790,51,0,25,427,38,465
20200321,VI,6,,,,,,,,,,4b386f8f5918cff4e0ce5af84ed83a6ed2f76b82,2020-03-21T20:00:00Z,0,,6,6,6,78,0,0,0,3,3
20200321,VT,29,779,,,,,,,,,3f90c35f316a9595018f2748e50ff309811694ef,2020-03-21T20:00:00Z,2,,808,808,808,50,0,0,0,0,0
20200321,WA,1524,21719,,,,,,,,,e89ca534af406d512dad526cfc1b5a1e64f75f0c,2020-03-21T20:00:00Z,83,,23243,23243,23243,53,9,0,2383,148,2531
20200321,WI,281,4628,,,,,,,,,ba16b5db1cba4db66a6ee6542b106fe8c6241158,2020-03-21T20:00:00Z,4,,4909,4909,4909,55,1,0,1173,75,1248
20200321,WV,11,330,2,,1,,,,,,f3880f455a42ec088a063f9603e227fe8aa81d3f,2020-03-21T20:00:00Z,0,1,343,341,341,54,0,1,111,4,115
20200321,WY,23,438,,,,,,,,,063d5a2701dc617e21c78eacebf5071aca0390d6,2020-03-21T20:00:00Z,,,461,461,461,56,0,0,107,4,111
20200320,AK,12,686,,,,,,,,,19aa2fa5c05198d53bfc983c6a895fd277ac1170,2020-03-20T20:00:00Z,,,698,698,698,02,0,0,254,6,260
20200320,AL,81,28,,,,,,,,,6bbe154eecf958487c0256f6d6b95eae55c038d8,2020-03-20T20:00:00Z,0,,109,109,109,01,0,0,0,13,13
20200320,AR,96,351,203,,,,,,,,a85b5e8267c40317cdb4da0571e60d619c4f1275,2020-03-20T20:00:00Z,,,650,447,447,05,0,0,41,50,91
20200320,AS,0,,,,,,,,,,276be2ed155883c05dff83cb4c0a33601b670eaf,2020-03-20T20:00:00Z,0,,0,0,0,60,0,0,0,0,0
20200320,AZ,65,211,101,,,,,,,,4727c3fdde576abf2bb11deceeacd79954e5fc0e,2020-03-20T20:00:00Z,0,,377,276,276,04,0,0,36,21,57
20200320,CA,1063,10424,,,,,,,,,22cfcbb820f66309386b4bdfdf47a806dd894a62,2020-03-20T20:00:00Z,20,,11487,11487,11487,06,2,0,1637,139,1776
20200320,CO,277,2675,,,,,,,,,3cc3cb3b8ada93585da9e20600cd49332188e95c,2020-03-20T20:00:00Z,3,,2952,2952,2952,08,1,0,563,61,624
20200320,CT,194,604,,,,,,,,,8844ec1c291f1730400384b6236407c5eec4e772,2020-03-20T20:00:00Z,3,,798,798,798,09,2,0,0,98,98
20200320,DC,71,501,1,,,,,,,,555b285ce297b0e04969515fe501ec133644cabc,2020-03-20T20:00:00Z,1,,573,572,572,11,1,0,348,32,380
20200320,DE,38,36,,,,,,,,,b846106acafb3617a2651cecc862737a4e0595b3,2020-03-20T20:00:00Z,0,,74,74,74,10,0,0,0,8,8
20200320,FL,520,1870,1026,,,,,,,,18f30f4aef61df1aa3a4a339482c5ad20ea478ed,2020-03-20T20:00:00Z,10,,3416,2390,2390,12,2,0,337,130,467
20200320,GA,420,1966,,,,,,,,,c1099b472676eb4813360be325975832eeeecc23,2020-03-20T20:00:00Z,13,,2386,2386,2386,13,3,0,422,133,555
20200320,GU,14,86,,,,,,,,,159284c0d374c774364f46fa9817010818ece653,2020-03-20T20:00:00Z,,,100,100,100,66,0,0,17,2,19
20200320,HI,26,124,9,,,,,,,,e886465028f4880076f3a519827f5eca88184a2e,2020-03-20T20:00:00Z,,,159,150,150,15,0,0,31,10,41
20200320,IA,45,642,,,,,,,,,8931d868707d9cfae19d1d0bec4836030df44395,2020-03-20T20:00:00Z,,,687,687,687,19,0,0,559,7,566
20200320,ID,23,590,,,,,,,,,427bcf104280535a976cf8932de54622b12d896d,2020-03-20T20:00:00Z,,,613,613,613,16,0,0,133,12,145
20200320,IL,585,3696,,,,,,,,,e61e30bd87a3af08bb2a5424cf6eaaca3cfc48ca,2020-03-20T20:00:00Z,5,,4281,4281,4281,17,1,0,971,163,1134
20200320,IN,79,475,,,,,,,,,69bc9f151729b2c730f70ef1ed38d7b9b733d1c1,2020-03-20T20:00:00Z,2,,554,554,554,18,0,0,151,23,174
20200320,KS,44,417,,,,,,,,,a57d1e044d0fa2a45332c1043bab418d82737990,2020-03-20T20:00:00Z,1,,461,461,461,20,0,0,0,10,10
20200320,KY,47,592,,,,,,,,,5132aa1c50a7fc4af7f8ea55558e133917653621,2020-03-20T20:00:00Z,1,,639,639,639,21,0,0,138,12,150
20200320,LA,479,568,,,,,,,,,e67536ea67b77d8ca65be412882b0f4d055238f5,2020-03-20T20:00:00Z,12,,1047,1047,1047,22,4,0,110,132,242
20200320,MA,413,3678,,,,,,,,,e4fa70dd5807dff8381750edb438c3d8fb03335d,2020-03-20T20:00:00Z,1,,4091,4091,4091,25,1,0,874,85,959
20200320,MD,149,94,,,,,,,,,9f5bf564b168c100be9bfa7869e3237c0307d9f2,2020-03-20T20:00:00Z,1,,243,243,243,24,0,0,0,42,42
20200320,ME,57,2264,,,,,,,,,0bbfa7a74e3391acd5aab61690ae8098d0a14554,2020-03-20T20:00:00Z,,,2321,2321,2321,23,0,0,260,4,264
20200320,MI,549,2069,,,,,,,,,160de9ccf87b8b01892f79dbcd086c12843e5896,2020-03-20T20:00:00Z,3,,2618,2618,2618,26,0,0,-44,213,169
20200320,MN,115,3741,,,,,,,,,4614bb4e80402ac12d217edcebc7fb8c0307722f,2020-03-20T20:00:00Z,,,3856,3856,3856,27,0,0,792,26,818
20200320,MO,47,369,,,,,,,,,4b0f45177c6372badaf3fc3cd21353d7cc037f86,2020-03-20T20:00:00Z,1,,416,416,416,29,0,0,61,23,84
20200320,MP,0,,,,,,,,,,082f47c47804486f21616c38aa13205a3fb6fbfb,2020-03-20T20:00:00Z,0,,0,0,0,69,0,0,0,0,0
20200320,MS,80,695,,,,,,,,,115279517e0a0ee05e43c6d5aed122d5b39b2670,2020-03-20T20:00:00Z,1,,775,775,775,28,1,0,143,30,173
20200320,MT,16,931,,,,,,,,,d05a98622d0fdf01680375131d34a96a6dabffe7,2020-03-20T20:00:00Z,,,947,947,947,30,0,0,170,4,174
20200320,NC,137,3096,,,,,,,,,7fb95d6505c8d7fe53b1f0b7dbe50120d88bb6c6,2020-03-20T20:00:00Z,0,,3233,3233,3233,37,0,0,688,40,728
20200320,ND,20,800,,,,,,,,,9163e5a9b67865ff295efd3f8a96912154727929,2020-03-20T20:00:00Z,0,,820,820,820,38,0,0,307,5,312
20200320,NE,32,240,,,,,,,,,4cda7034604f490921d79617c0010a5d350c0a41,2020-03-20T20:00:00Z,0,,272,272,272,31,0,0,0,5,5
20200320,NH,44,745,631,,,,,,,,17fa3bca875f292ca2284eb20eedeb139dfbfcdc,2020-03-20T20:00:00Z,,,1420,789,789,33,0,0,124,5,129
20200320,NJ,890,264,86,,,,,,,,42bf8537b56da3791417f26b573d6c19e37af697,2020-03-20T20:00:00Z,11,,1240,1154,1154,34,2,0,54,148,202
20200320,NM,43,3771,,,,,,,,,6d6b00ecb91b88b1a8eb243c140909f79393e03c,2020-03-20T20:00:00Z,,,3814,3814,3814,35,0,0,1009,8,1017
20200320,NV,109,1992,-3,,,,,,,,733cfe29c859178a886f5eb2a74805197f4f44dc,2020-03-20T20:00:00Z,1,,2098,2101,2101,32,0,0,366,14,380
20200320,NY,7102,25325,,,,,,,,,5293b5c5920709d4f3cf66b901621a61a47d0d23,2020-03-20T20:00:00Z,35,,32427,32427,32427,36,23,0,7193,2950,10143
20200320,OH,169,140,,,,,,,,,def0867b0c16cbafd9afe098983af7d8e0badd4c,2020-03-20T20:00:00Z,1,,309,309,309,39,1,0,0,50,50
20200320,OK,49,538,374,,,,,,,,e7f3b58b28391e52c4ba63eebe765a8da88bce50,2020-03-20T20:00:00Z,1,,961,587,587,40,0,0,72,5,77
20200320,OR,114,2003,433,,,,,,,,ce87d86e6068b6b11bf179616acd49af43d92ab8,2020-03-20T20:00:00Z,3,,2550,2117,2117,41,0,0,674,26,700
20200320,PA,268,2574,,,,,,,,,d618791d5664fb84a0a633890bae484ad6390590,2020-03-20T20:00:00Z,1,,2842,2842,2842,42,0,0,966,83,1049
20200320,PR,14,114,52,,,,,,,,045b02a40ddf42ca4604f3d36ace4f27f9fa9dd8,2020-03-20T20:00:00Z,,,180,128,128,72,0,0,58,9,67
20200320,RI,54,654,140,,,,,,,,c4058c6d563fd89cae96ec2556365a032b67e1b0,2020-03-20T20:00:00Z,,,848,708,708,44,0,0,114,21,135
20200320,SC,81,833,,,,,,,,,2b41a9dadec8fa07045ea3a0d9c92834ba77094f,2020-03-20T20:00:00Z,1,,914,914,914,45,0,0,250,21,271
20200320,SD,14,663,270,,,,,,,,0ff86be98a82aa41e2d3c093dcb848a516d082ed,2020-03-20T20:00:00Z,1,,947,677,677,46,0,0,112,3,115
20200320,TN,228,563,,,,,,,,,c30ab203ca516277f9337100529cc875d2cae47a,2020-03-20T20:00:00Z,,,791,791,791,47,0,0,214,74,288
20200320,TX,194,5083,,,,,,,,,41c1f53ffba2657e7fbd2eee03f09bebab402ec5,2020-03-20T20:00:00Z,5,,5277,5277,5277,48,2,0,2871,51,2922
20200320,UT,112,2035,,,,,,,,,df33dd66d88c6b1eddc25ca3aa7321769032d783,2020-03-20T20:00:00Z,0,,2147,2147,2147,49,0,0,587,34,621
20200320,VA,114,2211,,,,,,,,,998c78195dd294b9150ccec8e02a47681cc444d2,2020-03-20T20:00:00Z,2,,2325,2325,2325,51,0,0,382,20,402
20200320,VI,3,,,,,,,,,,cbe3e26ef7cf1304fe0ac3303da8dadb50416c38,2020-03-20T20:00:00Z,0,,3,3,3,78,0,0,0,0,0
20200320,VT,29,779,,,,,,,,,d08680597184a748ed263fab7f7a6137668d5566,2020-03-20T20:00:00Z,2,,808,808,808,50,2,0,134,7,141
20200320,WA,1376,19336,,,,,,,,,c45d0ccbda5510b5e0067fa6d12226f9debfec0e,2020-03-20T20:00:00Z,74,,20712,20712,20712,53,8,0,3418,189,3607
20200320,WI,206,3455,,,,,,,,,93fb2a48a14e3d7dc1b46f9735b75d4f211b378b,2020-03-20T20:00:00Z,3,,3661,3661,3661,55,3,0,1263,51,1314
20200320,WV,7,219,13,,,,,,,,c12a447783ded752c0d37b29337ca4aa055bafab,2020-03-20T20:00:00Z,0,,239,226,226,54,0,0,76,5,81
20200320,WY,19,331,,,,,,,,,d557b1046d1d80ef9d04b645dd96406c2a94a0e6,2020-03-20T20:00:00Z,,,350,350,350,56,0,0,60,1,61
20200319,AK,6,432,,,,,,,,,5cc91902e24fad7f218a89c4d57c03ceaf0546ed,2020-03-19T20:00:00Z,,,438,438,438,02,0,0,26,0,26
20200319,AL,68,28,,,,,,,,,cab25ff0e7f7b888b8cba2df5c54273cad43f3ca,2020-03-19T20:00:00Z,0,,96,96,96,01,0,0,0,22,22
20200319,AR,46,310,113,,,,,,,,6c34774d075752263526df4bbad724959f80931e,2020-03-19T20:00:00Z,,,469,356,356,05,0,0,74,13,87
20200319,AS,0,,,,,,,,,,d6eb9671a664cf91a5f6c4303e401a22f2205479,2020-03-19T20:00:00Z,0,,0,0,0,60,0,0,0,0,0
20200319,AZ,44,175,130,,,,,,,,76b253966cb27ac180f2a1954c05be32f66ffd3b,2020-03-19T20:00:00Z,0,,349,219,219,04,0,0,27,16,43
20200319,CA,924,8787,,,,,,,,,b9c67f8fde621d5bb8895c6a6fcbdcf8440ccf2a,2020-03-19T20:00:00Z,18,,9711,9711,9711,06,5,0,806,313,1119
20200319,CO,216,2112,,,,,,,,,f2e6f5775814d9e0574abd2a0b622a4e7b5f5c03,2020-03-19T20:00:00Z,2,,2328,2328,2328,08,0,0,495,33,528
20200319,CT,96,604,,,,,,,,,f38c4a8409f0daf8ca7de49fdae935367da520a6,2020-03-19T20:00:00Z,1,,700,700,700,09,1,0,479,28,507
20200319,DC,39,153,11,,,,,,,,a98070bbd5e9860b07b7c604f0716edae507472f,2020-03-19T20:00:00Z,0,,203,192,192,11,0,0,15,8,23
20200319,DE,30,36,,,,,,,,,468ef62e496e36ade5e3e7adf7d1c73520a9e1ec,2020-03-19T20:00:00Z,0,,66,66,66,10,0,0,0,5,5
20200319,FL,390,1533,1019,,,,,,,,502282f690274385776692ae0cd2f7cbc7af763b,2020-03-19T20:00:00Z,8,,2942,1923,1923,12,1,0,308,76,384
20200319,GA,287,1544,,,,,,,,,5b54c8e2862e3541c6cb2a4a0a6d3fc93891f218,2020-03-19T20:00:00Z,10,,1831,1831,1831,13,9,0,233,90,323
20200319,GU,12,69,,,,,,,,,f6054fe44404e56150824cf1c3bdd5b0a499e142,2020-03-19T20:00:00Z,,,81,81,81,66,0,0,12,4,16
20200319,HI,16,93,9,,,,,,,,fd2278b041edde82462b543a4bad4008f0450f15,2020-03-19T20:00:00Z,,,118,109,109,15,0,0,0,2,2
20200319,IA,38,83,,,,,,,,,8f211ef3f3731062fd68bfefd2a83a9813cb34d6,2020-03-19T20:00:00Z,,,121,121,121,19,0,0,0,9,9
20200319,ID,11,457,,,,,,,,,a6c7593375412de8a9781b46578187681a5b9a4b,2020-03-19T20:00:00Z,,,468,468,468,16,0,0,-2,2,0
20200319,IL,422,2725,,,,,,,,,8d1c449e83525fc3b5de5d1f65ad5bca7b1a14a1,2020-03-19T20:00:00Z,4,,3147,3147,3147,17,3,0,962,134,1096
20200319,IN,56,324,,,,,,,,,549ee6ea79c57957f4fa53219e3c2d6a0c287f16,2020-03-19T20:00:00Z,2,,380,380,380,18,0,0,170,17,187
20200319,KS,34,417,,,,,,,,,5f85df8ea07968d65259f84d333fdaa370cd30da,2020-03-19T20:00:00Z,1,,451,451,451,20,0,0,0,18,18
20200319,KY,35,454,,,,,,,,,4177f3c5f93abf2fa17632e734de6f33ce50ffb8,2020-03-19T20:00:00Z,1,,489,489,489,21,0,0,100,9,109
20200319,LA,347,458,,,,,,,,,5027dafbbd45c690b0ccd4fab11851328b078d81,2020-03-19T20:00:00Z,8,,805,805,805,22,2,0,123,107,230
20200319,MA,328,2804,,,,,,,,,78f476ff93f6ab6ceea2e20dccb8478637895c94,2020-03-19T20:00:00Z,,,3132,3132,3132,25,0,0,789,72,861
20200319,MD,107,94,,,,,,,,,395ef22c4ab583e1674bf164aa38aa261b48edc8,2020-03-19T20:00:00Z,1,,201,201,201,24,1,0,0,22,22
20200319,ME,53,2004,,,,,,,,,dfcaae4b9738530fc8e4ddf0a4f04b7fa6615971,2020-03-19T20:00:00Z,,,2057,2057,2057,23,0,0,334,10,344
20200319,MI,336,2113,,,,,,,,,89c231fb7de85a45540bdfbee90c04eec0a7c83c,2020-03-19T20:00:00Z,3,,2449,2449,2449,26,3,0,1841,256,2097
20200319,MN,89,2949,,,,,,,,,15ba42c01ac18dca2b983dc834307fabf0ddee3d,2020-03-19T20:00:00Z,,,3038,3038,3038,27,0,0,264,12,276
20200319,MO,24,308,,,,,,,,,cfedb6ca7d4cf450995815dfbcb4faa2d8786564,2020-03-19T20:00:00Z,1,,332,332,332,29,1,0,55,11,66
20200319,MP,0,,,,,,,,,,961b453a4be423f3a4011ff1980a42db7a8340bd,2020-03-19T20:00:00Z,0,,0,0,0,69,0,0,0,0,0
20200319,MS,50,552,,,,,,,,,dae6b6c859147288aa564d8f7bc329019a566105,2020-03-19T20:00:00Z,,,602,602,602,28,0,0,73,16,89
20200319,MT,12,761,0,,,,,,,,e19bcbdc4c4727178ac345cbd0d3e15cb9e8c378,2020-03-19T20:00:00Z,,,773,773,773,30,0,0,262,2,264
20200319,NC,97,2408,,,,,,,,,c38bf0911f7d0887fec0c237fd024b7c65965c1d,2020-03-19T20:00:00Z,0,,2505,2505,2505,37,0,0,621,34,655
20200319,ND,15,493,,,,,,,,,d3478e7e297de62112f0c14e326c630dd4f1a304,2020-03-19T20:00:00Z,0,,508,508,508,38,0,0,225,9,234
20200319,NE,27,240,,,,,,,,,4e4708969869d61b06e4fb88260cc8e193593984,2020-03-19T20:00:00Z,0,,267,267,267,31,0,0,34,3,37
20200319,NH,39,621,231,,,,,,,,6a5e7d979626aa494679faa93ea4660bdb959e56,2020-03-19T20:00:00Z,,,891,660,660,33,0,0,108,13,121
20200319,NJ,742,210,74,,,,,,,,15bfbbb8a65d6a6c68720f955ec0c0cbbc4e133f,2020-03-19T20:00:00Z,9,,1026,952,952,34,4,0,20,315,335
20200319,NM,35,2762,,,,,,,,,4de22e24a9577d6c8e4ded64bacfc2cab31257ea,2020-03-19T20:00:00Z,,,2797,2797,2797,35,0,0,436,7,443
20200319,NV,95,1626,,,,,,,,,2083071a1b29de96ebbd99cd42fc6d1393cdcd03,2020-03-19T20:00:00Z,1,,1721,1721,1721,32,0,0,1458,40,1498
20200319,NY,4152,18132,,,,,,,,,2eabc9b73139066e3613021b1e9c9deaf8af733c,2020-03-19T20:00:00Z,12,,22284,22284,22284,36,0,0,5917,1770,7687
20200319,OH,119,140,,,,,,,,,d5861e1be38df98f3ebf32584dad71eed414cc1a,2020-03-19T20:00:00Z,,,259,259,259,39,0,0,0,31,31
20200319,OK,44,466,250,,,,,,,,47631b0fa53981cf4d35fb5e03bc92da1d876375,2020-03-19T20:00:00Z,1,,760,510,510,40,1,0,88,15,103
20200319,OR,88,1329,437,,,,,,,,94d69640761fa3b2766f0ab482a1e62e4f77550e,2020-03-19T20:00:00Z,3,,1854,1417,1417,41,0,0,211,13,224
20200319,PA,185,1608,,,,,,,,,a87671ef28a0d908f73c46b699f698799347b071,2020-03-19T20:00:00Z,1,,1793,1793,1793,42,1,0,421,52,473
20200319,PR,5,56,29,,,,,,,,aa15323ebfa43315d7dbf51bcabc710f6b5beeeb,2020-03-19T20:00:00Z,,,90,61,61,72,0,0,25,0,25
20200319,RI,33,540,334,,,,,,,,8738444ef63fc193fdf0653567cc271895346a39,2020-03-19T20:00:00Z,,,907,573,573,44,0,0,0,0,0
20200319,SC,60,583,,,,,,,,,c77461930fa9d479778eb04f8d31984d2a83951e,2020-03-19T20:00:00Z,1,,643,643,643,45,0,0,0,0,0
20200319,SD,11,551,385,,,,,,,,528b99ca6d1a66773889f83a40c35991c7e8c8f7,2020-03-19T20:00:00Z,1,,947,562,562,46,0,0,0,0,0
20200319,TN,154,349,,,,,,,,,c2e339b7624135eb23a1174d4bd161349012b165,2020-03-19T20:00:00Z,,,503,503,503,47,0,0,0,56,56
20200319,TX,143,2212,,,,,,,,,cde417be86facde0b4cc168d73b067ee838a6131,2020-03-19T20:00:00Z,3,,2355,2355,2355,48,1,0,388,60,448
20200319,UT,78,1448,,,,,,,,,14c2a5b7bb32c8085b1e5f993e554fd89e37af52,2020-03-19T20:00:00Z,0,,1526,1526,1526,49,0,0,1317,15,1332
20200319,VA,94,1829,,,,,,,,,db038d6305387b5dff8657cfd63a0637f4ebeae4,2020-03-19T20:00:00Z,2,,1923,1923,1923,51,1,0,628,17,645
20200319,VI,3,,,,,,,,,,394f20993c6574901cdfe09c09db007be03bd63f,2020-03-19T20:00:00Z,0,,3,3,3,78,0,0,0,1,1
20200319,VT,22,645,,,,,,,,,d34ef0b0b994165133a21fa0a4c2329b5131e162,2020-03-19T20:00:00Z,,,667,667,667,50,0,0,53,3,56
20200319,WA,1187,15918,,,,,,,,,535a5769677827d78d2939c5f8f9e44eef508975,2020-03-19T20:00:00Z,66,,17105,17105,17105,53,14,0,2801,175,2976
20200319,WI,155,2192,,,,,,,,,04cf4cb3009a0ce03e8c1a25c0fab069f3b6e5bc,2020-03-19T20:00:00Z,,,2347,2347,2347,55,0,0,615,49,664
20200319,WV,2,143,3,,,,,,,,c23463a2d10fb3bc76b7e446714b77ece8a03d77,2020-03-19T20:00:00Z,0,,148,145,145,54,0,0,21,1,22
20200319,WY,18,271,,,,,,,,,9a473d25d0a19ff6338eb5f0dde81887ec30bef5,2020-03-19T20:00:00Z,,,289,289,289,56,0,0,93,3,96
20200318,AK,6,406,,,,,,,,,9a4073089834406984fd876567aa45194de3d9d7,2020-03-18T20:00:00Z,,,412,412,412,02,0,0,72,3,75
20200318,AL,46,28,,,,,,,,,45a12e7b90dfc3888e7a67b4f579327e80d6dee0,2020-03-18T20:00:00Z,0,,74,74,74,01,0,0,0,10,10
20200318,AR,33,236,50,,,,,,,,ded89e51af058017c83cf8859504494a02b8e23a,2020-03-18T20:00:00Z,,,319,269,269,05,0,0,39,11,50
20200318,AS,0,,,,,,,,,,bd7997742452d211bbf8fa4fc3bbaf44dc843f92,2020-03-18T20:00:00Z,0,,0,0,0,60,0,0,0,0,0
20200318,AZ,28,148,102,,,,,,,,290a6fabe096478efca8ac5c81bbd38ac2d36bbe,2020-03-18T20:00:00Z,0,,278,176,176,04,0,0,6,8,14
20200318,CA,611,7981,,,,,,,,,646da42647f99037e2c2b31faf21a04c5b5ff197,2020-03-18T20:00:00Z,13,,8592,8592,8592,06,2,0,0,128,128
20200318,CO,183,1617,,,,,,,,,3f3bba2f3fd791c0e1d4324bc8ff2a6f62de7ec7,2020-03-18T20:00:00Z,2,,1800,1800,1800,08,1,0,561,23,584
20200318,CT,68,125,,,,,,,,,bad4eb54adc44121dd8d251113c0f8ba0473fec5,2020-03-18T20:00:00Z,,,193,193,193,09,0,0,0,27,27
20200318,DC,31,138,1,,,,,,,,c19840607398e049b6c94859e2e5488bb8fd65cc,2020-03-18T20:00:00Z,,,170,169,169,11,0,0,34,9,43
20200318,DE,25,36,,,,,,,,,200085798af7e505bcb7c4edfc0813a35aceaed6,2020-03-18T20:00:00Z,,,61,61,61,10,0,0,0,9,9
20200318,FL,314,1225,954,,,,,,,,780fc846fbf000c950f78cc64d78b6224aba330a,2020-03-18T20:00:00Z,7,,2493,1539,1539,12,1,0,285,128,413
20200318,GA,197,1311,,,,,,,,,7c4abc91d1b496bb4b6e90a2b568750290d62c25,2020-03-18T20:00:00Z,1,,1508,1508,1508,13,0,0,1311,51,1362
20200318,GU,8,57,,,,,,,,,488b4b65842850fef461324d0a98fcc0653805c8,2020-03-18T20:00:00Z,,,65,65,65,66,0,0,16,3,19
20200318,HI,14,93,12,,,,,,,,973232e5ec3b7728db4db70dda252a6e69b8421a,2020-03-18T20:00:00Z,,,119,107,107,15,0,0,93,4,97
20200318,IA,29,83,,,,,,,,,744296249158ada7fe673054c1d488a847a13e78,2020-03-18T20:00:00Z,,,112,112,112,19,0,0,0,6,6
20200318,ID,9,459,,,,,,,,,b7e35d1fce1508552a80b1509dd6dc1789ecc16e,2020-03-18T20:00:00Z,,,468,468,468,16,0,0,113,2,115
20200318,IL,288,1763,,,,,,,,,5a530936a08eac49cd05347cded3d2e47e4e7bbf,2020-03-18T20:00:00Z,1,,2051,2051,2051,17,0,0,423,129,552
20200318,IN,39,154,,,,,,,,,df609a8d40db459b3c9d18cb5a964ff9b160c4f0,2020-03-18T20:00:00Z,2,,193,193,193,18,0,0,25,9,34
20200318,KS,16,417,,,,,,,,,45de05a2adf705367c4fdaff13311bb37da1073a,2020-03-18T20:00:00Z,1,,433,433,433,20,0,0,35,1,36
20200318,KY,26,354,,,,,,,,,4226afce757dadaf205f1611a61e21839adef8bf,2020-03-18T20:00:00Z,1,,380,380,380,21,0,0,59,4,63
20200318,LA,240,335,,,,,,,,,dad1c0a1eff89b6afadb6c2403054966c897f0e2,2020-03-18T20:00:00Z,6,,575,575,575,22,2,0,49,69,118
20200318,MA,256,2015,,,,,,,,,f33af005453944a9da0ca3a04bb26228e086da9e,2020-03-18T20:00:00Z,,,2271,2271,2271,25,0,0,474,38,512
20200318,MD,85,94,,,,,,,,,1f4768a9dad6648329e433e8ef1c1dfd4b40e53c,2020-03-18T20:00:00Z,,,179,179,179,24,0,0,0,28,28
20200318,ME,43,1670,,,,,,,,,6b89b002933569c5cdf827aed8b17d83a64131e4,2020-03-18T20:00:00Z,,,1713,1713,1713,23,0,0,367,11,378
20200318,MI,80,272,,,,,,,,,ad80fffc2ad2a9c1056a1088bb94b6602f7d570a,2020-03-18T20:00:00Z,,,352,352,352,26,0,0,0,15,15
20200318,MN,77,2685,,,,,,,,,2778d416bab07054feed2ec1321f3c1a9d3ccb19,2020-03-18T20:00:00Z,,,2762,2762,2762,27,0,0,409,17,426
20200318,MO,13,253,,,,,,,,,494c3a4a7f0b3d056f0796c5451a94a65db87f24,2020-03-18T20:00:00Z,0,,266,266,266,29,0,0,46,5,51
20200318,MP,0,,,,,,,,,,5473ea484274ea891441c085e860db0a828a9441,2020-03-18T20:00:00Z,0,,0,0,0,69,0,0,0,0,0
20200318,MS,34,479,,,,,,,,,d9aef306232106ab3338341222f0fc21ee44f555,2020-03-18T20:00:00Z,,,513,513,513,28,0,0,111,13,124
20200318,MT,10,499,0,,,,,,,,63f0f4e12b20b4b75d913f24c4e9292b8ed4cce0,2020-03-18T20:00:00Z,,,509,509,509,30,0,0,196,2,198
20200318,NC,63,1787,,,,,,,,,bc1bbd225ef32227a7efee396646e6930f31637a,2020-03-18T20:00:00Z,0,,1850,1850,1850,37,0,0,1313,23,1336
20200318,ND,6,268,,,,,,,,,3fb86878e20e5d7952aa8b8e58e8f8e3db35e0f6,2020-03-18T20:00:00Z,0,,274,274,274,38,0,0,48,3,51
20200318,NE,24,206,,,,,,,,,fa4b37682bc4e4c9977832d28b6bee342ad73bfc,2020-03-18T20:00:00Z,,,230,230,230,31,0,0,0,3,3
20200318,NH,26,513,208,,,,,,,,379d9ffea7e7ca663fa8076e64b67a0abdff891c,2020-03-18T20:00:00Z,,,747,539,539,33,0,0,158,9,167
20200318,NJ,427,190,21,,,,,,,,cd982339aab35ead35248c6c7d3f97f69aedc106,2020-03-18T20:00:00Z,5,,638,617,617,34,2,0,27,160,187
20200318,NM,28,2326,,,,,,,,,9d7631bd34bff01009e3691eaf8a89a9020f1a60,2020-03-18T20:00:00Z,,,2354,2354,2354,35,0,0,1077,5,1082
20200318,NV,55,168,,,,,,,,,143e93252ed96f1da9e57b213aabbffc9a94e028,2020-03-18T20:00:00Z,1,,223,223,223,32,0,0,0,0,0
20200318,NY,2382,12215,,,,,,,,,65a08e6a0f81bd2c4bbc9988a17f0892d2ec4d35,2020-03-18T20:00:00Z,12,,14597,14597,14597,36,5,0,6709,682,7391
20200318,OH,88,140,,,,,,,,,9e018d5062cb6300ba638be07cb64b0e75faf66f,2020-03-18T20:00:00Z,,,228,228,228,39,0,0,0,21,21
20200318,OK,29,378,110,,,,,,,,0d0abb08b10d42019c2c2193f46d2fdc388fc740,2020-03-18T20:00:00Z,,,517,407,407,40,0,0,131,12,143
20200318,OR,75,1118,361,,,,,,,,417e054b02ae4a5d4a0a2a5870a419a30ae285db,2020-03-18T20:00:00Z,3,,1554,1193,1193,41,3,0,429,28,457
20200318,PA,133,1187,,,,,,,,,53f74823d5e0c5cde103d57683986efe781fb763,2020-03-18T20:00:00Z,,,1320,1320,1320,42,0,0,308,37,345
20200318,PR,5,31,21,,,,,,,,2d5405cfdbd83c8717f23b7ebc2f454316248e7c,2020-03-18T20:00:00Z,,,57,36,36,72,0,0,18,0,18
20200318,RI,33,540,334,,,,,,,,d30ec58cfb6debb199f0a3dab56dea6d8b658293,2020-03-18T20:00:00Z,,,907,573,573,44,0,0,232,12,244
20200318,SC,60,583,,,,,,,,,1b0a7b83efeb9ea6127ac5e0dbd268700c8b7ffd,2020-03-18T20:00:00Z,1,,643,643,643,45,0,0,272,27,299
20200318,SD,11,551,350,,,,,,,,517b7759b69709dc0bbfc3a4795c6257a3d8695a,2020-03-18T20:00:00Z,1,,912,562,562,46,1,0,0,0,0
20200318,TN,98,349,,,,,,,,,ef95fc12bc281034aad01fc4c18c9518ad68fc18,2020-03-18T20:00:00Z,,,447,447,447,47,0,0,19,25,44
20200318,TX,83,1824,,,,,,,,,2467c07184fc5405454f97f8f267669095674a74,2020-03-18T20:00:00Z,2,,1907,1907,1907,48,1,0,620,19,639
20200318,UT,63,131,,,,,,,,,9966240ca7479f6c30465b22f5b5250bc4e46f44,2020-03-18T20:00:00Z,0,,194,194,194,49,0,0,0,12,12
20200318,VA,77,1201,,,,,,,,,ce7119e82540f46da33ce3ad8566b387de75c4c2,2020-03-18T20:00:00Z,1,,1278,1278,1278,51,0,0,240,10,250
20200318,VI,2,,,,,,,,,,536be919042938c8de484134acc1703fb4e292d6,2020-03-18T20:00:00Z,0,,2,2,2,78,0,0,0,0,0
20200318,VT,19,592,,,,,,,,,adc018bdef2b12d859e026881ce104495a7a3736,2020-03-18T20:00:00Z,,,611,611,611,50,0,0,97,9,106
20200318,WA,1012,13117,,,,,,,,,eb230fa9aea0b5fd1026102c5bd5775579092452,2020-03-18T20:00:00Z,52,,14129,14129,14129,53,4,0,1535,108,1643
20200318,WI,106,1577,,,,,,,,,c6687fa3edbbc8d56cf9953ddbf05a0988642570,2020-03-18T20:00:00Z,,,1683,1683,1683,55,0,0,539,34,573
20200318,WV,1,122,14,,,,,,,,59817e48b32e3f860eed291a8785c1af5c5fc047,2020-03-18T20:00:00Z,0,,137,123,123,54,0,0,42,1,43
20200318,WY,15,178,,,,,,,,,326e4562919b82e68eb5cf65710387eef18815f2,2020-03-18T20:00:00Z,,,193,193,193,56,0,0,83,5,88
20200317,AK,3,334,,,,,,,,,c1859e4b0fcf9f53476595916f4e354d9cdddd40,2020-03-17T20:00:00Z,,,337,337,337,02,0,0,191,2,193
20200317,AL,36,28,,,,,,,,,27d195514d6511642ecafb4148f51bd1cf06894d,2020-03-17T20:00:00Z,0,,64,64,64,01,0,0,0,8,8
20200317,AR,22,197,41,,,,,,,,411518ea767313995c4b1d3dcc31cdf917851e0e,2020-03-17T20:00:00Z,,,260,219,219,05,0,0,65,0,65
20200317,AS,0,,,,,,,,,,9dc42ad652bdcfbc99d72de52183c8d073f1023d,2020-03-17T20:00:00Z,,,0,0,0,60,0,0,0,0,0
20200317,AZ,20,142,66,,,,,,,,89437a1c0aef047c82cd8a566761763bae43c5bf,2020-03-17T20:00:00Z,0,,228,162,162,04,0,0,17,2,19
20200317,CA,483,7981,,,,,,,,,3a5a29b79b4583de68455525d065127db6a3e97b,2020-03-17T20:00:00Z,11,,8464,8464,8464,06,5,0,0,148,148
20200317,CO,160,1056,,,,,,,,,cd89a731d2b24e3f2b854af3811047aa4dc58515,2020-03-17T20:00:00Z,1,,1216,1216,1216,08,0,0,429,29,458
20200317,CT,41,125,,,,,,,,,6da5216bce6b0623b87352f8e83a1825342475e8,2020-03-17T20:00:00Z,,,166,166,166,09,0,0,0,15,15
20200317,DC,22,104,0,,,,,,,,920a77b7fb3c7caea23a46e351f576caf34d15d5,2020-03-17T20:00:00Z,,,126,126,126,11,0,0,8,5,13
20200317,DE,16,36,,,,,,,,,cda3d06e346fadcb4155d46e80ed29de996cb64b,2020-03-17T20:00:00Z,,,52,52,52,10,0,0,0,8,8
20200317,FL,186,940,872,,,,,,,,326863b36e37f814b53ae8a8ac35ff314dba227c,2020-03-17T20:00:00Z,6,,1998,1126,1126,12,2,0,256,45,301
20200317,GA,146,,,,,,,,,,6d29d5d7a269b24f93abacce353e78bdd6d779e5,2020-03-17T20:00:00Z,1,,146,146,146,13,0,0,0,25,25
20200317,GU,5,41,,,,,,,,,0e4694acd5fc6e905760489233fa2e4adb3fe162,2020-03-17T20:00:00Z,,,46,46,46,66,0,0,18,2,20
20200317,HI,10,,,,,,,,,,0fad73741929efc5016cc6898bf79a04f3b32541,2020-03-17T20:00:00Z,,,10,10,10,15,0,0,0,3,3
20200317,IA,23,83,,,,,,,,,39b42e43a67060a6680cc19a597e43f758ae9c4b,2020-03-17T20:00:00Z,,,106,106,106,19,0,0,0,1,1
20200317,ID,7,346,,,,,,,,,da76cc722dd92af48de842b866731dd5feecedf5,2020-03-17T20:00:00Z,,,353,353,353,16,0,0,81,2,83
20200317,IL,159,1340,,,,,,,,,ac5f0af8ee2b49bbec18da6a8780ae3e6fccbaa4,2020-03-17T20:00:00Z,1,,1499,1499,1499,17,1,0,408,66,474
20200317,IN,30,129,,,,,,,,,9116db98bc9050e3933e80a7afcf74ef82d7e826,2020-03-17T20:00:00Z,2,,159,159,159,18,1,0,14,6,20
20200317,KS,15,382,,,,,,,,,44e5c9df55fec7dfe79bcd4ecb086fe131bb3782,2020-03-17T20:00:00Z,1,,397,397,397,20,0,0,216,4,220
20200317,KY,22,295,,,,,,,,,15eb2cbe48fa8cbaa6eefad032de090f954964cd,2020-03-17T20:00:00Z,1,,317,317,317,21,0,0,61,1,62
20200317,LA,171,286,,,,,,,,,50610ebbdeaa7907b12726f42106e71733e456f5,2020-03-17T20:00:00Z,4,,457,457,457,22,2,0,98,57,155
20200317,MA,218,1541,,,,,,,,,f2b9d7f0d874da810bfb4b57fa42cb6ad8d320f9,2020-03-17T20:00:00Z,,,1759,1759,1759,25,0,0,1189,54,1243
20200317,MD,57,94,,,,,,,,,3b1218c8eb03fb526e4527aee06fb0fd45fb84d6,2020-03-17T20:00:00Z,,,151,151,151,24,0,0,0,20,20
20200317,ME,32,1303,,,,,,,,,a0e2d3e219d03ae226d39b22f6fb58f3a7962d68,2020-03-17T20:00:00Z,,,1335,1335,1335,23,0,0,539,15,554
20200317,MI,65,272,,,,,,,,,c90997dfee064a1bd78a444c456cb1d77b5f5d4b,2020-03-17T20:00:00Z,,,337,337,337,26,0,0,0,12,12
20200317,MN,60,2276,,,,,,,,,300095ac1a8a4816dc84236f74f9b294078551f2,2020-03-17T20:00:00Z,,,2336,2336,2336,27,0,0,437,6,443
20200317,MO,8,207,,,,,,,,,54626aca3649c044d3040c7e2016a1ad31c9785e,2020-03-17T20:00:00Z,0,,215,215,215,29,0,0,43,2,45
20200317,MP,0,,,,,,,,,,6adf0f2f9d5d342ee6f48691e7c933cfbb9ee4ab,2020-03-17T20:00:00Z,,,0,0,0,69,0,0,0,0,0
20200317,MS,21,368,,,,,,,,,6d8126cab2847762c6c6ae011f9e1a4490be20f6,2020-03-17T20:00:00Z,,,389,389,389,28,0,0,91,9,100
20200317,MT,8,303,0,,,,,,,,9740f39c2f655d51923229b2a724893e37defcac,2020-03-17T20:00:00Z,,,311,311,311,30,0,0,105,1,106
20200317,NC,40,474,,,,,,,,,68df9675138cd54797b057149f2b83186228ba6a,2020-03-17T20:00:00Z,0,,514,514,514,37,0,0,178,7,185
20200317,ND,3,220,0,,,,,,,,44da03edf8d7792eb57915c2b50406c83c0000f2,2020-03-17T20:00:00Z,0,,223,223,223,38,0,0,97,2,99
20200317,NE,21,206,,,,,,,,,8ee48fa5b23a524e017e3402f8a5ffcd74e18e7e,2020-03-17T20:00:00Z,,,227,227,227,31,0,0,36,3,39
20200317,NH,17,355,195,,,,,,,,3d90b42fa44eb1f26bc9dad858c0b267b6bb8320,2020-03-17T20:00:00Z,,,567,372,372,33,0,0,84,4,88
20200317,NJ,267,163,55,,,,,,,,245514c59d21a39ce3fcce7909de2f2aea8521fd,2020-03-17T20:00:00Z,3,,485,430,430,34,1,0,43,89,132
20200317,NM,23,1249,,,,,,,,,dc445586a909cec38c6b3ddd4d313d3933909382,2020-03-17T20:00:00Z,,,1272,1272,1272,35,0,0,683,6,689
20200317,NV,55,168,,,,,,,,,5b582da8f08144c39d99e58a22bd3542fa42bcfb,2020-03-17T20:00:00Z,1,,223,223,223,32,0,0,0,10,10
20200317,NY,1700,5506,,,,,,,,,a2d96e7a962926fa3165aef038360c097b6be4ce,2020-03-17T20:00:00Z,7,,7206,7206,7206,36,0,0,963,750,1713
20200317,OH,67,140,,,,,,,,,97daf301defc7356d1af9ba55e9397bb8155fe7c,2020-03-17T20:00:00Z,,,207,207,207,39,0,0,0,17,17
20200317,OK,17,247,82,,,,,,,,e1c323cb75eb122e2b034a5370eaad9e5a86d4fa,2020-03-17T20:00:00Z,,,346,264,264,40,0,0,73,7,80
20200317,OR,47,689,184,,,,,,,,898565e2b6b936a739713bd0e523449fdf478069,2020-03-17T20:00:00Z,,,920,736,736,41,0,0,110,8,118
20200317,PA,96,879,,,,,,,,,9a374eb05235860321c532550f87da84d649fcfd,2020-03-17T20:00:00Z,,,975,975,975,42,0,0,209,20,229
20200317,PR,5,13,4,,,,,,,,62bea2a6c0d3c6ef1d1578056f4e0bbc64ebf66a,2020-03-17T20:00:00Z,,,22,18,18,72,0,0,4,0,4
20200317,RI,21,308,149,,,,,,,,dbec566f3551ab20f9f264e17776a0bf98a6fa92,2020-03-17T20:00:00Z,,,478,329,329,44,0,0,0,0,0
20200317,SC,33,311,,,,,,,,,b5f1adfc0baaf72f68c6ac1ac0ed09497346cca7,2020-03-17T20:00:00Z,1,,344,344,344,45,0,0,76,5,81
20200317,SD,11,551,35,,,,,,,,4f349aafd2814d07c34bcd70c3df3e11ebdce938,2020-03-17T20:00:00Z,,,597,562,562,46,0,0,57,1,58
20200317,TN,73,330,,,,,,,,,87b5c6f12a10d9e22646015aa7f6ff734f74a432,2020-03-17T20:00:00Z,,,403,403,403,47,0,0,60,21,81
20200317,TX,64,1204,,,,,,,,,70f6533b6999b27f73a6c5b316d3d22b8ef5519b,2020-03-17T20:00:00Z,1,,1268,1268,1268,48,1,0,1204,7,1211
20200317,UT,51,131,,,,,,,,,a54698d3d8c9e6d9e9d82f50535716a7107b8ab7,2020-03-17T20:00:00Z,0,,182,182,182,49,0,0,0,12,12
20200317,VA,67,961,,,,,,,,,fc691ef55223c03d5038f969b84154d360731887,2020-03-17T20:00:00Z,1,,1028,1028,1028,51,0,0,523,16,539
20200317,VI,2,,,,,,,,,,e1264b6e170d5381e6ba419101f02c93331ff4f3,2020-03-17T20:00:00Z,,,2,2,2,78,0,0,0,1,1
20200317,VT,10,495,,,,,,,,,7ed042b1658ff87b1bc58e97924f28365b3a934d,2020-03-17T20:00:00Z,,,505,505,505,50,0,0,74,2,76
20200317,WA,904,11582,,,,,,,,,a36581696a7488a065d62717a6bcb90bcb0e0893,2020-03-17T20:00:00Z,48,,12486,12486,12486,53,6,0,2131,135,2266
20200317,WI,72,1038,,,,,,,,,8c430e85d8bacf4fcd9637ea1fc9d554eac52d2c,2020-03-17T20:00:00Z,,,1110,1110,1110,55,0,0,534,25,559
20200317,WV,0,80,4,,,,,,,,f2463136e4acc78a08320ea32d916ae7a9a305e8,2020-03-17T20:00:00Z,0,,84,80,80,54,0,0,0,0,0
20200317,WY,10,95,,,,,,,,,bc3cae6af97386e715211063c8994c0a9d1c031f,2020-03-17T20:00:00Z,,,105,105,105,56,0,0,95,7,102
20200316,AK,1,143,,,,,,,,,55b0b029eac24362c03262d39c1daf9fd34c4e6d,2020-03-16T20:00:00Z,,,144,144,144,02,0,0,0,0,0
20200316,AL,28,28,40,,,,,,,,3efe0ea61bb6932f1d608f9e24d38fcafaa2c04c,2020-03-16T20:00:00Z,0,,96,56,56,01,0,0,0,16,16
20200316,AR,22,132,14,,,,,,,,78bd45495c24cce3ba85c7f24609a179c43478eb,2020-03-16T20:00:00Z,,,168,154,154,05,0,0,29,6,35
20200316,AS,0,,,,,,,,,,dd805eafc110c2532252fc4813170d80fb589084,2020-03-16T20:00:00Z,,,0,0,0,60,,,,,
20200316,AZ,18,125,63,,,,,,,,a2961931f5c5f76a42773e7477d509b59b5cd133,2020-03-16T20:00:00Z,0,,206,143,143,04,0,0,4,6,10
20200316,CA,335,7981,,,,,,,,,ae22555d7ccc020a6fc6268f759c981a681af584,2020-03-16T20:00:00Z,6,,8316,8316,8316,06,1,0,7065,42,7107
20200316,CO,131,627,,,,,,,,,dda059810b70b49f0451aef63be8a4ae6d3af3f2,2020-03-16T20:00:00Z,1,,758,758,758,08,0,0,0,0,0
20200316,CT,26,125,,,,,,,,,4d722259eb940d98fdcc976b9bc97308a3e902c0,2020-03-16T20:00:00Z,,,151,151,151,09,0,0,0,6,6
20200316,DC,17,96,7,,,,,,,,8997b7eeb6bd9be4fb4ad8a4094301be4add08b0,2020-03-16T20:00:00Z,,,120,113,113,11,0,0,17,1,18
20200316,DE,8,36,32,,,,,,,,d04addb5ab1cce5bea6da60bd864abdaf9f40c33,2020-03-16T20:00:00Z,,,76,44,44,10,0,0,0,2,2
20200316,FL,141,684,514,,,,,,,,e53cf48d45ec818ea2d56d271277e6ec5a5b49bd,2020-03-16T20:00:00Z,4,,1339,825,825,12,0,0,6,25,31
20200316,GA,121,,,,,,,,,,c6fa2c88408c5bb21156b21e12fac3816f255ea9,2020-03-16T20:00:00Z,1,,121,121,121,13,0,0,0,22,22
20200316,GU,3,23,,,,,,,,,f7bbc72cc2925b0cf37ca0d2a707d2dd196619ba,2020-03-16T20:00:00Z,,,26,26,26,66,,,,,
20200316,HI,7,,,,,,,,,,6379c60c70b54b8df2bfed1f9beac3fbfe2117f5,2020-03-16T20:00:00Z,,,7,7,7,15,0,0,0,5,5
20200316,IA,22,83,,,,,,,,,abdd281192ae660bb7cf448cc358f37058a4e726,2020-03-16T20:00:00Z,,,105,105,105,19,0,0,0,4,4
20200316,ID,5,265,,,,,,,,,cbadc8d7244f7abc2f70ffd4efcbd3930be6c7c3,2020-03-16T20:00:00Z,,,270,270,270,16,0,0,91,0,91
20200316,IL,93,932,,,,,,,,,f03443451f7889148543ffce5c6fb97993c13d33,2020-03-16T20:00:00Z,,,1025,1025,1025,17,0,0,483,29,512
20200316,IN,24,115,,,,,,,,,5476decd48ecb1589f9d22a297cf69d1bc5e0355,2020-03-16T20:00:00Z,1,,139,139,139,18,1,0,13,5,18
20200316,KS,11,166,,,,,,,,,2871e7c581aba789a9a80042471dbd062cd8b05a,2020-03-16T20:00:00Z,1,,177,177,177,20,0,0,31,3,34
20200316,KY,21,234,,,,,,,,,9faf39847096593b80a7c2410e9e5bc7f8ae66f2,2020-03-16T20:00:00Z,1,,255,255,255,21,1,0,95,5,100
20200316,LA,114,188,,,,,,,,,3f35dae7522ba88d8e79d20093816c3614734dcb,2020-03-16T20:00:00Z,2,,302,302,302,22,0,0,32,23,55
20200316,MA,164,352,,,,,,,,,8b6244ab6b03eb42a217d3342377e82b0051ad3c,2020-03-16T20:00:00Z,,,516,516,516,25,0,0,0,26,26
20200316,MD,37,94,,,,,,,,,8148e20f78522f18bb64c3736befeed3747a96b2,2020-03-16T20:00:00Z,,,131,131,131,24,0,0,0,6,6
20200316,ME,17,764,,,,,,,,,a6b88539313f6c2cd8136b76c0c53475b3b0dd34,2020-03-16T20:00:00Z,,,781,781,781,23,0,0,673,14,687
20200316,MI,53,272,30,,,,,,,,3ae7d9481db738d9313179f49f1522047c85f51a,2020-03-16T20:00:00Z,,,355,325,325,26,0,0,67,20,87
20200316,MN,54,1839,,,,,,,,,3419334f30420a634b19a07442d629553af687b3,2020-03-16T20:00:00Z,,,1893,1893,1893,27,0,0,452,19,471
20200316,MO,6,164,,,,,,,,,ef353ee3f27c62c9da40b468889b6e5f7873daf2,2020-03-16T20:00:00Z,0,,170,170,170,29,0,0,42,1,43
20200316,MP,0,,,,,,,,,,645c528660cf04b553855f4e4d0ab78f35e60078,2020-03-16T20:00:00Z,,,0,0,0,69,,,,,
20200316,MS,12,277,,,,,,,,,68fb32e431d415106a70ff158d981d8bb680d5ab,2020-03-16T20:00:00Z,,,289,289,289,28,0,0,193,2,195
20200316,MT,7,198,0,,,,,,,,565dd890bcf460175302cf7317cb020955a542e5,2020-03-16T20:00:00Z,,,205,205,205,30,0,0,95,0,95
20200316,NC,33,296,151,,,,,,,,db9b565837a4d41e965e15ccb7b4d5063ae76924,2020-03-16T20:00:00Z,0,,480,329,329,37,0,0,69,1,70
20200316,ND,1,123,0,,,,,,,,41479c4ca4bf1f2bbc321cbe00058d9ca9ed023c,2020-03-16T20:00:00Z,0,,124,124,124,38,0,0,28,0,28
20200316,NE,18,170,,,,,,,,,27f99533a3a45cdfe5408436300f1d84dc36ee38,2020-03-16T20:00:00Z,,,188,188,188,31,0,0,90,1,91
20200316,NH,13,271,95,,,,,,,,6324e7ef14adbe0db61808a796bbc0e9d9373431,2020-03-16T20:00:00Z,,,379,284,284,33,0,0,0,0,0
20200316,NJ,178,120,20,,,,,,,,e3047f52c8b8718510b744979fca9f7ac16351b3,2020-03-16T20:00:00Z,2,,318,298,298,34,0,0,0,80,80
20200316,NM,17,566,,,,,,,,,48d7bfddefd90fde1d6499cc0b200237e976e758,2020-03-16T20:00:00Z,,,583,583,583,35,0,0,84,4,88
20200316,NV,45,168,,,,,,,,,203840ffb87a4baf59f78144da9357ea01a27ac2,2020-03-16T20:00:00Z,1,,213,213,213,32,1,0,0,24,24
20200316,NY,950,4543,,,,,,,,,994a65ba75be3681f76ff4612eb8fde85cff81cd,2020-03-16T20:00:00Z,7,,5493,5493,5493,36,4,0,0,221,221
20200316,OH,50,140,361,,,,,,,,70ad02c336e95158080519cbea8b21e47de47958,2020-03-16T20:00:00Z,,,551,190,190,39,0,0,1,14,15
20200316,OK,10,174,29,,,,,,,,e0d2929770055843abe54cd9ac80c1f407fdfcd3,2020-03-16T20:00:00Z,,,213,184,184,40,0,0,56,1,57
20200316,OR,39,579,182,,,,,,,,962d85e67d8cf64e5ef102b345d18ae50baa0624,2020-03-16T20:00:00Z,,,800,618,618,41,0,0,159,3,162
20200316,PA,76,670,,,,,,,,,96a8a61c47aef3aefddcc68815b03b9de9e6ffa7,2020-03-16T20:00:00Z,,,746,746,746,42,0,0,465,13,478
20200316,PR,5,9,,,,,,,,,be5aca3aa4f7fa2a722127a99ec083fd3b982671,2020-03-16T20:00:00Z,,,14,14,14,72,,,,,
20200316,RI,21,308,149,,,,,,,,e0244de4eb603b25d36700707a95bdb8289a5928,2020-03-16T20:00:00Z,,,478,329,329,44,0,0,110,1,111
20200316,SC,28,235,,,,,,,,,825f415faf293db6c2a614650fd3d37c694e56e8,2020-03-16T20:00:00Z,1,,263,263,263,45,1,0,81,9,90
20200316,SD,10,494,0,,,,,,,,b2a38c6ba820cb1329f93d990e27a8100d7b2fb5,2020-03-16T20:00:00Z,,,504,504,504,46,0,0,167,1,168
20200316,TN,52,270,,,,,,,,,9feabfdc22803b2d1bc85122f421cfcaa6b45cb7,2020-03-16T20:00:00Z,,,322,322,322,47,0,0,113,13,126
20200316,TX,57,,,,,,,,,,1f4d7ef872f54f1f40fe0560f536c9baa94b1637,2020-03-16T20:00:00Z,,,57,57,57,48,0,0,0,1,1
20200316,UT,39,131,,,,,,,,,3cf1e0acd5d5d07d3c45fa784a7e6f11796c467b,2020-03-16T20:00:00Z,0,,170,170,170,49,0,0,0,11,11
20200316,VA,51,438,,,,,,,,,097556061009dcaa83f48a5fbc6b952b751300fe,2020-03-16T20:00:00Z,1,,489,489,489,51,0,0,75,6,81
20200316,VI,1,,,,,,,,,,5af3baba47f6d5e3e1b4090940bb299a160a1c9f,2020-03-16T20:00:00Z,,,1,1,1,78,,,,,
20200316,VT,8,421,,,,,,,,,0bfc2ddcde18514ed799a3832e1136ca8bc745dc,2020-03-16T20:00:00Z,,,429,429,429,50,0,0,73,4,77
20200316,WA,769,9451,,,,,,,,,5de3ba2bf662278c0b9e9a023e91181398269132,2020-03-16T20:00:00Z,42,,10220,10220,10220,53,2,0,2329,127,2456
20200316,WI,47,504,,,,,,,,,a2e7539f5f950647edc9fab483be3672a3ca189e,2020-03-16T20:00:00Z,,,551,551,551,55,0,0,191,14,205
20200316,WV,0,80,4,,,,,,,,24af6da70ac0da2f7126fe3a29931ee7d556ffe6,2020-03-16T20:00:00Z,0,,84,80,80,54,0,0,42,0,42
20200316,WY,3,,,,,,,,,,b67f6088687e03e5ed66f4f27410a2bf8e4032f9,2020-03-16T20:00:00Z,,,3,3,3,56,0,0,0,0,0
20200315,AK,1,143,,,,,,,,,60c27932a683c3682cf48a12a0e94b719a58f853,2020-03-15T20:00:00Z,,,144,144,144,02,0,0,0,0,0
20200315,AL,12,28,46,,,,,,,,bc792edfeb4365aed8c64e6ff682049380018d28,2020-03-15T20:00:00Z,0,,86,40,40,01,0,0,6,6,12
20200315,AR,16,103,30,,,,,,,,35929378624bc11a7dd1d28474862f8edfab3a18,2020-03-15T20:00:00Z,,,149,119,119,05,0,0,38,4,42
20200315,AZ,12,121,50,,,,,,,,7a4427cac62eb283ec726e86ffa9fb6f331bac4a,2020-03-15T20:00:00Z,0,,183,133,133,04,0,0,0,0,0
20200315,CA,293,916,,,,,,,,,5e5e85687553cddbfc767524eedc40d04efeb98a,2020-03-15T20:00:00Z,5,,1209,1209,1209,06,0,0,0,41,41
20200315,CO,131,627,,,,,,,,,0da7e45df3e95846c2ea7d169ec15485902fe3b5,2020-03-15T20:00:00Z,1,,758,758,758,08,0,0,17,30,47
20200315,CT,20,125,,,,,,,,,47afb6e02464043555eaf5e2053829e84eb805be,2020-03-15T20:00:00Z,,,145,145,145,09,0,0,0,9,9
20200315,DC,16,79,20,,,,,,,,46da8be5fe41851c0bb75f94651e557a2f0c6386,2020-03-15T20:00:00Z,,,115,95,95,11,0,0,30,6,36
20200315,DE,6,36,32,,,,,,,,f5b3a2976e58c2202cc5aded47704c39fa65e343,2020-03-15T20:00:00Z,,,74,42,42,10,0,0,0,0,0
20200315,FL,116,678,454,,,,,,,,fbbf82f88fa5a3c2bbdf7f937c2752c5ba3ce6df,2020-03-15T20:00:00Z,4,,1248,794,794,12,1,0,200,39,239
20200315,GA,99,,,,,,,,,,df40a5921f9dfc96b45398288e6075bd6b97fd81,2020-03-15T20:00:00Z,1,,99,99,99,13,0,0,0,33,33
20200315,HI,2,,,,,,,,,,0a69a6018c0bce8b9bfbe6b1dd88a8f031a0a025,2020-03-15T20:00:00Z,,,2,2,2,15,0,0,0,0,0
20200315,IA,18,83,,,,,,,,,fdf73baeeb8118faed38a3ad4be3449414432f07,2020-03-15T20:00:00Z,,,101,101,101,19,0,0,0,1,1
20200315,ID,5,174,,,,,,,,,4472c728ff3ae897133063dc6b945fc03c35c382,2020-03-15T20:00:00Z,,,179,179,179,16,0,0,0,3,3
20200315,IL,64,449,195,,,,,,,,f6c2094de686cbf02f6bb9ac79925336ade7255e,2020-03-15T20:00:00Z,,,708,513,513,17,0,0,133,18,151
20200315,IN,19,102,,,,,,,,,d4516efe0a7e4050cd6326b64b549f9cb1923a61,2020-03-15T20:00:00Z,0,,121,121,121,18,0,0,28,4,32
20200315,KS,8,135,,,,,,,,,868c75937b225e6321886b68d3a125642646a48a,2020-03-15T20:00:00Z,1,,143,143,143,20,0,0,42,2,44
20200315,KY,16,139,,,,,,,,,d0dfc75f33be8db126e19af366618eaa6af0055b,2020-03-15T20:00:00Z,,,155,155,155,21,0,0,0,2,2
20200315,LA,91,156,,,,,,,,,e12d7af383c2482c7845ba7e6403df009076bfde,2020-03-15T20:00:00Z,2,,247,247,247,22,2,0,47,22,69
20200315,MA,138,352,,,,,,,,,c8c2486f9a55549e537cfa05abc2e5e2fe749397,2020-03-15T20:00:00Z,,,490,490,490,25,0,0,0,0,0
20200315,MD,31,94,,,,,,,,,12fc1449714a30e3dece18babc0d6f18a249ec11,2020-03-15T20:00:00Z,,,125,125,125,24,0,0,0,5,5
20200315,ME,3,91,17,,,,,,,,b9373f5ff8eecc4882df5e99ca65029c7ab54a5e,2020-03-15T20:00:00Z,,,111,94,94,23,0,0,0,0,0
20200315,MI,33,205,26,,,,,,,,374a7e64ac11cec3d9f816c38e677be25e541e3b,2020-03-15T20:00:00Z,,,264,238,238,26,0,0,0,8,8
20200315,MN,35,1387,,,,,,,,,00afbc28ae28d28e85eb0ca606fac9847ee7eec5,2020-03-15T20:00:00Z,,,1422,1422,1422,27,0,0,540,14,554
20200315,MO,5,122,,,,,,,,,5ad3d82f98f7d9f284ef9895cb6f8e76d23c7f34,2020-03-15T20:00:00Z,0,,127,127,127,29,0,0,32,1,33
20200315,MS,10,84,,,,,,,,,5442e46cc16cedbeeb93a0f0ff9a04740dc62690,2020-03-15T20:00:00Z,,,94,94,94,28,0,0,0,4,4
20200315,MT,7,103,57,,,,,,,,d5c7b708dac192fb53a5453064d7c4fa04726b5d,2020-03-15T20:00:00Z,,,167,110,110,30,0,0,0,2,2
20200315,NC,32,227,151,,,,,,,,403dec9507ef0b9ac81864a597d016782cc2527b,2020-03-15T20:00:00Z,,,410,259,259,37,0,0,90,9,99
20200315,ND,1,95,4,,,,,,,,2745e3ea870fcafa773e34d392d65a6d79da5002,2020-03-15T20:00:00Z,0,,100,96,96,38,0,0,41,0,41
20200315,NE,17,80,33,,,,,,,,558bc35b9327ee76d681d0b1357e4c4f73ef8039,2020-03-15T20:00:00Z,,,130,97,97,31,0,0,0,3,3
20200315,NH,13,271,95,,,,,,,,803b79b258e66f237ca1ebf9a8fcde18477cac13,2020-03-15T20:00:00Z,,,379,284,284,33,0,0,59,6,65
20200315,NJ,98,120,34,,,,,,,,cb6357bcd5b00b85173d23a8bd8f41fdb1b098f0,2020-03-15T20:00:00Z,2,,252,218,218,34,1,0,23,48,71
20200315,NM,13,482,,,,,,,,,b95e350ae2b5693dcb353e7c00b01f855a971762,2020-03-15T20:00:00Z,,,495,495,495,35,0,0,245,3,248
20200315,NV,21,168,164,,,,,,,,5c87854db60a5e7331ad07237ca83ba7ebcf7af0,2020-03-15T20:00:00Z,,,353,189,189,32,0,0,0,1,1
20200315,NY,729,4543,,,,,,,,,963f632b5d1577cd5cf9b6c332a912c2fdebea16,2020-03-15T20:00:00Z,3,,5272,5272,5272,36,3,0,1764,205,1969
20200315,OH,36,139,350,,,,,,,,0f9665fdbfb9c2db97a7b8cca0dd02a8dd3fcd41,2020-03-15T20:00:00Z,,,525,175,175,39,0,0,89,23,112
20200315,OK,9,118,12,,,,,,,,c94b4a8b7a6943e47f2b18b0830094b3b5b847aa,2020-03-15T20:00:00Z,,,139,127,127,40,0,0,82,5,87
20200315,OR,36,420,225,,,,,,,,ee34e334d60acd6c6786608eaf502ef3469b027a,2020-03-15T20:00:00Z,,,681,456,456,41,0,0,83,6,89
20200315,PA,63,205,183,,,,,,,,b456aca3dcfc156e659cf9d83c9b906acb7c5ae5,2020-03-15T20:00:00Z,,,451,268,268,42,0,0,0,16,16
20200315,RI,20,198,57,,,,,,,,6717a57af04d40e5accee96d13fdf798763c84a7,2020-03-15T20:00:00Z,,,275,218,218,44,0,0,0,0,0
20200315,SC,19,154,,,,,,,,,75ba73b3bb3053eb03805d2812d5c2e4395f1b6f,2020-03-15T20:00:00Z,,,173,173,173,45,0,0,44,6,50
20200315,SD,9,327,6,,,,,,,,fa88e329d335599e26ea9fd7b6eea1fb83b0c06a,2020-03-15T20:00:00Z,,,342,336,336,46,0,0,145,0,145
20200315,TN,39,157,,,,,,,,,0d4cfb67c9ea0c68b1210ef9b0a90d12b748672f,2020-03-15T20:00:00Z,,,196,196,196,47,0,0,27,7,34
20200315,TX,56,,,,,,,,,,5703287c6d3b6d2f1e4e3de43cc125edafaa598a,2020-03-15T20:00:00Z,,,56,56,56,48,0,0,0,5,5
20200315,UT,28,131,,,,,,,,,557e214eba87dfaba62c598c539e3a281022e741,2020-03-15T20:00:00Z,0,,159,159,159,49,0,0,0,22,22
20200315,VA,45,363,,,,,,,,,8cb2bceeeb5e766ece4e5e0141e5c46174a1c784,2020-03-15T20:00:00Z,1,,408,408,408,51,1,0,246,15,261
20200315,VT,4,348,,,,,,,,,c240b0b7e625d08e14362a93fac37a9cb859d539,2020-03-15T20:00:00Z,,,352,352,352,50,0,0,121,0,121
20200315,WA,642,7122,,,,,,,,,1c7e7a0baa721892bbf89e899b597d921e807fce,2020-03-15T20:00:00Z,40,,7764,7764,7764,53,3,0,1121,74,1195
20200315,WI,33,313,,,,,,,,,76f9cefe3cbfb28b81648f15bcc59d6507801772,2020-03-15T20:00:00Z,,,346,346,346,55,0,0,144,14,158
20200315,WV,0,38,1,,,,,,,,36d80d812a5ba34def01d46af9f6a7760b182f43,2020-03-15T20:00:00Z,0,,39,38,38,54,0,0,12,0,12
20200315,WY,3,,,,,,,,,,74566767a2c99e0bdfd11a6e545fd9ed02e9e716,2020-03-15T20:00:00Z,,,3,3,3,56,0,0,0,1,1
20200314,AK,1,143,,,,,,,,,d6e6e61fb8c0d1c2340d7df1983d63227e4dfe0d,2020-03-14T20:00:00Z,,,144,144,144,02,0,0,84,0,84
20200314,AL,6,22,46,,,,,,,,5c89c1e4d5be4e39281e7629e2d8969f9d54bb00,2020-03-14T20:00:00Z,,,74,28,28,01,0,0,11,5,16
20200314,AR,12,65,26,,,,,,,,551428a90628981e98f1a49df229dc8e2a8a6bfe,2020-03-14T20:00:00Z,,,103,77,77,05,0,0,35,3,38
20200314,AZ,12,121,50,,,,,,,,c40ab8d2dcf6deaeecfa0bab73a691ec90124122,2020-03-14T20:00:00Z,0,,183,133,133,04,0,0,27,3,30
20200314,CA,252,916,,,,,,,,,bfe38009fc5e230d310f823f106a0947b1a2bce3,2020-03-14T20:00:00Z,5,,1168,1168,1168,06,1,0,0,50,50
20200314,CO,101,610,,,,,,,,,8247505b13764c1e92a341ef32b62d362e995ca1,2020-03-14T20:00:00Z,1,,711,711,711,08,1,0,86,29,115
20200314,CT,11,125,,,,,,,,,149bffa1dda5d74304599eb67e85167eb9cc7940,2020-03-14T20:00:00Z,,,136,136,136,09,0,0,26,5,31
20200314,DC,10,49,10,,,,,,,,8da2326fcb3ada2f8eb58b168fa3cfd71a21ad34,2020-03-14T20:00:00Z,,,69,59,59,11,0,0,29,0,29
20200314,DE,6,36,32,,,,,,,,ddc0cc501e0b9f023ee1294fe142fcf25fd092b9,2020-03-14T20:00:00Z,,,74,42,42,10,0,0,6,2,8
20200314,FL,77,478,221,,,,,,,,96d30f3427bff70e4f87d99ae5c42be36a0034ac,2020-03-14T20:00:00Z,3,,776,555,555,12,1,0,0,27,27
20200314,GA,66,,,,,,,,,,97be6babd64500d6ebd30859d68fc26fff2e4848,2020-03-14T20:00:00Z,1,,66,66,66,13,0,0,0,24,24
20200314,HI,2,,,,,,,,,,b958c9810a3946b62408f0111a12c70f54049101,2020-03-14T20:00:00Z,,,2,2,2,15,0,0,0,0,0
20200314,IA,17,83,,,,,,,,,e4c108405861a595205e19c9154417a48c5aae91,2020-03-14T20:00:00Z,,,100,100,100,19,0,0,0,1,1
20200314,ID,2,174,,,,,,,,,952932b75b80cd3991df8a8c7db4f64acce89d58,2020-03-14T20:00:00Z,,,176,176,176,16,0,0,43,2,45
20200314,IL,46,316,82,,,,,,,,9ce71ff3b9101f5ced145411c578a9b370c032a8,2020-03-14T20:00:00Z,,,444,362,362,17,0,0,22,14,36
20200314,IN,15,74,,,,,,,,,14f3f66fde7e3e752f7f5e81e40cb946e7bca3af,2020-03-14T20:00:00Z,0,,89,89,89,18,0,0,13,3,16
20200314,KS,6,93,,,,,,,,,278e3c9e3e9f10641ced32dcb4caaa1d4a3b141d,2020-03-14T20:00:00Z,1,,99,99,99,20,1,0,0,0,0
20200314,KY,14,139,,,,,,,,,53ea76cd7050bee2da9a57fca2b4538d1926af6d,2020-03-14T20:00:00Z,,,153,153,153,21,0,0,32,3,35
20200314,LA,69,109,,,,,,,,,c80c2be31c70d2b05d47fb0b55f9297f827690f7,2020-03-14T20:00:00Z,,,178,178,178,22,0,0,72,33,105
20200314,MA,138,352,,,,,,,,,bdba6fc0046699f5419368f4eb93e84eb0f025c5,2020-03-14T20:00:00Z,,,490,490,490,25,0,0,260,15,275
20200314,MD,26,94,,,,,,,,,8fefdbf242c49256c9711173cc7a195bdfeaf897,2020-03-14T20:00:00Z,,,120,120,120,24,0,0,0,9,9
20200314,ME,3,91,17,,,,,,,,f8e0701ef750fd7833940e085f356967698a709e,2020-03-14T20:00:00Z,,,111,94,94,23,0,0,0,0,0
20200314,MI,25,205,26,,,,,,,,1ef0c5ec35b9fb7fbce11af20dc3982433b1ae1c,2020-03-14T20:00:00Z,,,256,230,230,26,0,0,72,9,81
20200314,MN,21,847,,,,,,,,,43db9c125581cdb0eaed4688c2bcc3692d524ccd,2020-03-14T20:00:00Z,,,868,868,868,27,0,0,306,7,313
20200314,MO,4,90,,,,,,,,,5220c08925c1338bbc1ababb24afaf6558a68b9c,2020-03-14T20:00:00Z,0,,94,94,94,29,0,0,19,2,21
20200314,MS,6,84,,,,,,,,,262146bdcf966d7bd2b95df77b8c19d904242248,2020-03-14T20:00:00Z,,,90,90,90,28,0,0,43,2,45
20200314,MT,5,103,,,,,,,,,3b3767d29a7f2c8246d957b64ab51b460e66230c,2020-03-14T20:00:00Z,,,108,108,108,30,0,0,48,4,52
20200314,NC,23,137,,,,,,,,,1097b4e88ff28fd47bd79effc50736bcc4f98d4d,2020-03-14T20:00:00Z,,,160,160,160,37,0,0,51,8,59
20200314,ND,1,54,14,,,,,,,,a52a443da4b61469c6be7d12ad2fe848c421dd0f,2020-03-14T20:00:00Z,0,,69,55,55,38,0,0,15,0,15
20200314,NE,14,80,33,,,,,,,,936f44463ab4c62d7cf30fc400ef265c45f8b3f5,2020-03-14T20:00:00Z,,,127,94,94,31,0,0,0,1,1
20200314,NH,7,212,31,,,,,,,,8df5e37a5d8dabbb6fb2821a99d3d0d90b27fc85,2020-03-14T20:00:00Z,,,250,219,219,33,0,0,118,1,119
20200314,NJ,50,97,80,,,,,,,,0b8634c5fd4e1160dde841c792bf7c6fc9315232,2020-03-14T20:00:00Z,1,,227,147,147,34,0,0,0,0,0
20200314,NM,10,237,,,,,,,,,0085a52176e881bb6ad037e0c30af4f74d9489f9,2020-03-14T20:00:00Z,,,247,247,247,35,0,0,47,0,47
20200314,NV,20,168,,,,,,,,,2e60e44122a1faf4a4351249cef4569aeb6b4a89,2020-03-14T20:00:00Z,,,188,188,188,32,0,0,0,9,9
20200314,NY,524,2779,,,,,,,,,f28c39ca671c26d022ff2556494ad8767765eb93,2020-03-14T20:00:00Z,,,3303,3303,3303,36,0,0,0,103,103
20200314,OH,13,50,159,,,,,,,,fc63d6218734893ad458fb97af8018f3a1ec1ad5,2020-03-14T20:00:00Z,,,222,63,63,39,0,0,0,0,0
20200314,OK,4,36,37,,,,,,,,c73b103132566a7e2d3c71510adc6def73b88940,2020-03-14T20:00:00Z,,,77,40,40,40,0,0,0,1,1
20200314,OR,30,337,157,,,,,,,,1400911ca9d80be2f8e342c113a1df4d70338602,2020-03-14T20:00:00Z,,,524,367,367,41,0,0,0,0,0
20200314,PA,47,205,150,,,,,,,,d18f94522023cea299270dcc1602530f2ddc0dc4,2020-03-14T20:00:00Z,,,402,252,252,42,0,0,65,14,79
20200314,RI,20,198,57,,,,,,,,398dbebda7a13f625f8978b5e493f80fa0c06bc4,2020-03-14T20:00:00Z,,,275,218,218,44,0,0,56,6,62
20200314,SC,13,110,,,,,,,,,f59023a910249b3d8b3511ae10d8f11517a1c519,2020-03-14T20:00:00Z,,,123,123,123,45,0,0,35,1,36
20200314,SD,9,182,3,,,,,,,,df4f632f3d3f47fd86232363e123ffd6096af646,2020-03-14T20:00:00Z,,,194,191,191,46,0,0,109,0,109
20200314,TN,32,130,,,,,,,,,6becf2091344bee8d3a7f0a0a437ccf76ed9dd53,2020-03-14T20:00:00Z,,,162,162,162,47,0,0,14,6,20
20200314,TX,51,,,,,,,,,,8a47a6e610ae58718993de453b89aa3908c67fbd,2020-03-14T20:00:00Z,,,51,51,51,48,0,0,0,12,12
20200314,UT,6,131,,,,,,,,,577b43eb324c0ae69322cc15f477ca37d5daf36b,2020-03-14T20:00:00Z,,,137,137,137,49,0,0,0,0,0
20200314,VA,30,117,,,,,,,,,33f505467e5a143bd0ecda4d5622091a48ad3d2e,2020-03-14T20:00:00Z,,,147,147,147,51,0,0,0,0,0
20200314,VT,4,227,,,,,,,,,570d73d25152c4e93987f89a83b40ff5480a7682,2020-03-14T20:00:00Z,,,231,231,231,50,0,0,85,2,87
20200314,WA,568,6001,,,,,,,,,d0c542a7903d9d53eee47064cd36f4618727252d,2020-03-14T20:00:00Z,37,,6569,6569,6569,53,6,0,1651,111,1762
20200314,WI,19,169,,,,,,,,,8f1ed69b1d5723cbd5b18d1ec332fa4f83bde08a,2020-03-14T20:00:00Z,,,188,188,188,55,0,0,0,0,0
20200314,WV,0,26,5,,,,,,,,7e27957cf04398b64db2982ccd580fd5455ffebb,2020-03-14T20:00:00Z,,,31,26,26,54,0,0,9,0,9
20200314,WY,2,,,,,,,,,,00d1959cf22a0162be10edb9d849b320e1db37e7,2020-03-14T20:00:00Z,,,2,2,2,56,0,0,0,1,1
20200313,AK,1,59,,,,,,,,,f912dbdc1e4737b9efd9715f5c60bc397601b547,2020-03-13T20:00:00Z,,,60,60,60,02,0,0,13,1,14
20200313,AL,1,11,,,,,,,,,b9e856f0b5f6b1893dbe080ee99cbebd5723f4f8,2020-03-13T20:00:00Z,,,12,12,12,01,0,0,1,1,2
20200313,AR,9,30,22,,,,,,,,a6aff5e9908d4f1a167655d035338e838ba8cdba,2020-03-13T20:00:00Z,,,61,39,39,05,0,0,6,3,9
20200313,AZ,9,94,40,,,,,,,,68c52c41afcca5a93045251c1a7e05b086b85767,2020-03-13T20:00:00Z,0,,143,103,103,04,0,0,12,0,12
20200313,CA,202,916,,,,,,,,,bb817225b0e56a4c1051b2e6550b5ae85e06487c,2020-03-13T20:00:00Z,4,,1118,1118,1118,06,0,0,0,0,0
20200313,CO,72,524,,,,,,,,,f081206fdd232801c4719c7b15f928e95e16c0a4,2020-03-13T20:00:00Z,,,596,596,596,08,0,0,226,27,253
20200313,CT,6,99,,,,,,,,,682c544537c9fb686f945084a154361a3c8a386f,2020-03-13T20:00:00Z,,,105,105,105,09,0,0,10,0,10
20200313,DC,10,20,,,,,,,,,47405f5c12651491f7aaeeadcf98a21f5290298e,2020-03-13T20:00:00Z,,,30,30,30,11,0,0,0,0,0
20200313,DE,4,30,10,,,,,,,,01a39bf98baae6616556fc98432b0eab5ec19d21,2020-03-13T20:00:00Z,,,44,34,34,10,0,0,7,0,7
20200313,FL,50,478,221,,,,,,,,e2f015841b99a9056a83e88b541e2f27fe57bdea,2020-03-13T20:00:00Z,2,,749,528,528,12,0,0,177,18,195
20200313,GA,42,,,,,,,,,,a1b71ddadb4a8d03aab0ae5ee76889c2cdefe5bf,2020-03-13T20:00:00Z,1,,42,42,42,13,1,0,0,11,11
20200313,HI,2,,,,,,,,,,d517fed5e44222b8e9ec35423adff6841571d310,2020-03-13T20:00:00Z,,,2,2,2,15,0,0,0,0,0
20200313,IA,16,83,29,,,,,,,,9a4dc657b7cf736b9c1a23162cb7bd246891b602,2020-03-13T20:00:00Z,,,128,99,99,19,0,0,16,2,18
20200313,ID,0,131,,,,,,,,,b1671d598b98d1510491784f4c280a368ba8c39e,2020-03-13T20:00:00Z,,,131,131,131,16,0,0,38,0,38
20200313,IL,32,294,92,,,,,,,,3a4c6b2710e412f845b0c387c44def3dba4d011b,2020-03-13T20:00:00Z,,,418,326,326,17,0,0,28,7,35
20200313,IN,12,61,,,,,,,,,6a95bce7fff18ca959c83513dc8e4b4b8458d719,2020-03-13T20:00:00Z,,,73,73,73,18,0,0,9,0,9
20200313,KS,6,93,,,,,,,,,8633a26e1f484f8d6832c17efdb6e638ffb3515e,2020-03-13T20:00:00Z,,,99,99,99,20,0,0,52,2,54
20200313,KY,11,107,,,,,,,,,4d515c6fe8ed706c415382ef87cfa9236ac4e09c,2020-03-13T20:00:00Z,,,118,118,118,21,0,0,51,3,54
20200313,LA,36,37,,,,,,,,,78393fa814aa0caf1ae4f6056e80e21adf672bf2,2020-03-13T20:00:00Z,,,73,73,73,22,0,0,0,22,22
20200313,MA,123,92,,,,,,,,,020263557685d33ade8e1849eeb35c2a8a12843a,2020-03-13T20:00:00Z,,,215,215,215,25,0,0,92,28,120
20200313,MD,17,94,,,,,,,,,32d329849128913476d4a0773fea76a4b3e2b083,2020-03-13T20:00:00Z,,,111,111,111,24,0,0,0,5,5
20200313,ME,3,91,17,,,,,,,,8ecdd4f1eb3ad0874071c97b48e3bc8ae16edf37,2020-03-13T20:00:00Z,,,111,94,94,23,0,0,26,2,28
20200313,MI,16,133,26,,,,,,,,05ddad838bceb9565041de5f1488467bbf56489a,2020-03-13T20:00:00Z,,,175,149,149,26,0,0,42,14,56
20200313,MN,14,541,,,,,,,,,094cc2b8f1b021d450e7d7fa08596000fc7f4e05,2020-03-13T20:00:00Z,,,555,555,555,27,0,0,234,5,239
20200313,MO,2,71,,,,,,,,,4d53392cae812d4039af40a07e38bc5fe77212fb,2020-03-13T20:00:00Z,,,73,73,73,29,0,0,7,1,8
20200313,MS,4,41,,,,,,,,,9fc8f265d6c9e8b4883399e23c0b0190c2686599,2020-03-13T20:00:00Z,,,45,45,45,28,0,0,0,3,3
20200313,MT,1,55,,,,,,,,,3190b3a30f1124eebbb4e9bccd677cf22f2ae6c0,2020-03-13T20:00:00Z,,,56,56,56,30,0,0,21,0,21
20200313,NC,15,86,,,,,,,,,9b22973bdb1a321a3b9cc273f6250675bf95124b,2020-03-13T20:00:00Z,,,101,101,101,37,0,0,26,3,29
20200313,ND,1,39,12,,,,,,,,16823997d9c4db1ae19dccaba18481746cfe85cf,2020-03-13T20:00:00Z,0,,52,40,40,38,0,0,27,0,27
20200313,NE,13,80,33,,,,,,,,72bf9214dd1c1c24ce38fd46893604d18cc124f7,2020-03-13T20:00:00Z,,,126,93,93,31,0,0,0,3,3
20200313,NH,6,94,21,,,,,,,,ce083d3bb0b226ff0599d533768ad2b62f892b40,2020-03-13T20:00:00Z,,,121,100,100,33,0,0,0,0,0
20200313,NJ,50,97,80,,,,,,,,dd9375b158d3020716fe7e1d759d510332c818e3,2020-03-13T20:00:00Z,1,,227,147,147,34,0,0,23,20,43
20200313,NM,10,190,,,,,,,,,5e21e22aacd1a08b396a2c457c553776e3c8bedf,2020-03-13T20:00:00Z,,,200,200,200,35,0,0,35,5,40
20200313,NV,11,168,,,,,,,,,5c86c34f504be7bf2a593223447a7f2d5f18877a,2020-03-13T20:00:00Z,,,179,179,179,32,0,0,0,4,4
20200313,NY,421,2779,,,,,,,,,a0a0e2997c411014ef2cd98b9502387730f585c7,2020-03-13T20:00:00Z,,,3200,3200,3200,36,0,0,2687,205,2892
20200313,OH,13,50,159,,,,,,,,fe5ed1e40f012163a6510cabdea90e044e5e56ab,2020-03-13T20:00:00Z,,,222,63,63,39,0,0,20,8,28
20200313,OK,3,36,37,,,,,,,,41b22c1ee50041708e574581687a0c4155caa8aa,2020-03-13T20:00:00Z,,,76,39,39,40,0,0,0,0,0
20200313,OR,30,337,157,,,,,,,,ee29420a1ee3ce2e33cdf966ecbdfc575d26206b,2020-03-13T20:00:00Z,,,524,367,367,41,0,0,51,11,62
20200313,PA,33,140,130,,,,,,,,c020c5effee33b3ec0b5d8208913e1d43bb469cc,2020-03-13T20:00:00Z,,,303,173,173,42,0,0,24,11,35
20200313,RI,14,142,29,,,,,,,,3b21b07952531010abf6628fe837a9f97fd33797,2020-03-13T20:00:00Z,,,185,156,156,44,0,0,48,9,57
20200313,SC,12,75,,,,,,,,,89ac68f7349872023eb4ba7e8d49e17e3221b4cc,2020-03-13T20:00:00Z,,,87,87,87,45,0,0,27,2,29
20200313,SD,9,73,11,,,,,,,,9a7c944cb0774212146d5eecb0aa11b12de52eb6,2020-03-13T20:00:00Z,,,93,82,82,46,0,0,46,1,47
20200313,TN,26,116,,,,,,,,,5dd412ea26ef8d20d55a6410d59726087883cd99,2020-03-13T20:00:00Z,,,142,142,142,47,0,0,37,8,45
20200313,TX,39,,,,,,,,,,3964195c15cc0e37c244f112bcbae5789a5c6489,2020-03-13T20:00:00Z,,,39,39,39,48,0,0,0,16,16
20200313,UT,6,131,,,,,,,,,610050cffa209508ec65a9bf756ef16d617d69c5,2020-03-13T20:00:00Z,,,137,137,137,49,0,0,0,2,2
20200313,VA,30,117,,,,,,,,,d2ecd673874966076229036999033a3993ffed2b,2020-03-13T20:00:00Z,,,147,147,147,51,0,0,0,13,13
20200313,VT,2,142,,,,,,,,,a02dcfb55e5f9ed028f6328c61b41408533038c1,2020-03-13T20:00:00Z,,,144,144,144,50,0,0,45,0,45
20200313,WA,457,4350,,,,,,,,,c99bf19d3a7a6a5973c1b9b48d8cf526bc91647e,2020-03-13T20:00:00Z,31,,4807,4807,4807,53,2,0,1313,120,1433
20200313,WI,19,169,,,,,,,,,3936ef13cd65e7b15ac22d0d981357b9f6dcce8d,2020-03-13T20:00:00Z,,,188,188,188,55,0,0,85,11,96
20200313,WV,0,17,4,,,,,,,,10eb8c5e07049f2c299d03ef30ceb60a49142335,2020-03-13T20:00:00Z,,,21,17,17,54,0,0,10,0,10
20200313,WY,1,,,,,,,,,,610cc4a0b9c9015f6214bfe928f0acf116f8b75c,2020-03-13T20:00:00Z,,,1,1,1,56,0,0,0,0,0
20200312,AK,0,46,14,,,,,,,,e6a2e85fdf548043d8e908d506c334dfa37b0982,2020-03-12T20:00:00Z,,,60,46,46,02,0,0,0,0,0
20200312,AL,0,10,,,,,,,,,34204c36040e342af491e5329aca50e88f2cbaba,2020-03-12T20:00:00Z,,,10,10,10,01,0,0,0,0,0
20200312,AR,6,24,20,,,,,,,,fe5ece5453dac3d08b87f1ab7a10e00bf7cfdfc9,2020-03-12T20:00:00Z,,,50,30,30,05,0,0,12,6,18
20200312,AZ,9,82,24,,,,,,,,542a30820399e2d4ec7a2787e6760577326f402d,2020-03-12T20:00:00Z,,,115,91,91,04,0,0,23,0,23
20200312,CA,202,916,,,,,,,,,8dd3541eb41a6171cc6bbf05632f8d9bb4570490,2020-03-12T20:00:00Z,4,,1118,1118,1118,06,4,0,0,45,45
20200312,CO,45,298,,,,,,,,,fef01602b9d42355347ffd39fc33776f6d251c7e,2020-03-12T20:00:00Z,,,343,343,343,08,0,0,47,17,64
20200312,CT,6,89,,,,,,,,,438f9707c60dbf6c5042c0686dfa479170d3471a,2020-03-12T20:00:00Z,,,95,95,95,09,0,0,18,3,21
20200312,DC,10,20,,,,,,,,,2afd9cde94fa8693b5eb2da4552eecf9452ad2c0,2020-03-12T20:00:00Z,,,30,30,30,11,0,0,0,5,5
20200312,DE,4,23,14,,,,,,,,0cfca14a0bd4e74cc01ef2a9030f65643237496d,2020-03-12T20:00:00Z,,,41,27,27,10,0,0,6,3,9
20200312,FL,32,301,147,,,,,,,,e30f5e735d56d705f8ed9768797ed07fc2d8173a,2020-03-12T20:00:00Z,2,,480,333,333,12,0,0,0,4,4
20200312,GA,31,,,,,,,,,,b54e3a842da88ee7e2685e1625d6b47466982662,2020-03-12T20:00:00Z,,,31,31,31,13,0,0,0,9,9
20200312,HI,2,,,,,,,,,,448f4f6242f8f4d56b53911f8f41f857fea624ad,2020-03-12T20:00:00Z,,,2,2,2,15,0,0,0,0,0
20200312,IA,14,67,24,,,,,,,,c66bca36e23ed4238801da6edce433a068219c83,2020-03-12T20:00:00Z,,,105,81,81,19,0,0,21,1,22
20200312,ID,0,93,,,,,,,,,ea688b0e32219776fd27b38e03bee45e42111379,2020-03-12T20:00:00Z,,,93,93,93,16,0,0,26,0,26
20200312,IL,25,266,76,,,,,,,,f521fa0222b25b297e082e1285cb6efc89a5b552,2020-03-12T20:00:00Z,,,367,291,291,17,0,0,22,6,28
20200312,IN,12,52,,,,,,,,,dcfcf297a028962a948869e94197bbe14be0bd93,2020-03-12T20:00:00Z,,,64,64,64,18,0,0,19,2,21
20200312,KS,4,41,,,,,,,,,332ee3bb9b5f431704d8cd139631096cf6e7551b,2020-03-12T20:00:00Z,,,45,45,45,20,0,0,0,3,3
20200312,KY,8,56,,,,,,,,,cebe01b90cd5896a2bdea84cba4ee4b563f24ee9,2020-03-12T20:00:00Z,,,64,64,64,21,0,0,10,0,10
20200312,LA,14,37,,,,,,,,,90d5fc83d9f4c831c653f38b96e49251057d9cb7,2020-03-12T20:00:00Z,,,51,51,51,22,0,0,0,8,8
20200312,MA,95,,,,,,,,,,2b11362fc52b477bca21e635eb9f2b88e8a5d61f,2020-03-12T20:00:00Z,,,95,95,95,25,0,0,0,3,3
20200312,MD,12,94,,,,,,,,,08b84f6b613a011507c9190271ec545191ee68bb,2020-03-12T20:00:00Z,,,106,106,106,24,0,0,0,3,3
20200312,ME,1,65,20,,,,,,,,b39c56076bac0a4ddd2e88d3f04d0c785d75732d,2020-03-12T20:00:00Z,,,86,66,66,23,0,0,23,1,24
20200312,MI,2,91,27,,,,,,,,8cfab74100163f38791ab9091ae8ffbbded28b9d,2020-03-12T20:00:00Z,,,120,93,93,26,0,0,34,0,34
20200312,MN,9,307,,,,,,,,,523bdda158c8db3de757d18a38756ffe1ce9b21b,2020-03-12T20:00:00Z,,,316,316,316,27,0,0,90,4,94
20200312,MO,1,64,,,,,,,,,5b415b8bf401db354d5f6a778e699e7eb170976d,2020-03-12T20:00:00Z,,,65,65,65,29,0,0,64,0,64
20200312,MS,1,41,,,,,,,,,6aad8ec86cdaa93329eeda6aa46670dd6ca609b1,2020-03-12T20:00:00Z,,,42,42,42,28,0,0,21,1,22
20200312,MT,1,34,,,,,,,,,4b8bef9b3d9fa1079cbd7be5288076fb401598c1,2020-03-12T20:00:00Z,,,35,35,35,30,0,0,13,1,14
20200312,NC,12,60,,,,,,,,,7442624a12322777c7110f0101d61d097da12ade,2020-03-12T20:00:00Z,,,72,72,72,37,0,0,60,5,65
20200312,ND,1,12,14,,,,,,,,101ef2bb022ea0209aaa020d3e2852b8964d9134,2020-03-12T20:00:00Z,,,27,13,13,38,0,0,5,1,6
20200312,NE,10,80,33,,,,,,,,a4238a2a6795e1cd4e971a336c36e526d59e25d7,2020-03-12T20:00:00Z,,,123,90,90,31,0,0,33,5,38
20200312,NH,6,94,21,,,,,,,,7e575bc7e2ffdb783ca744e42ac10956980b5aba,2020-03-12T20:00:00Z,,,121,100,100,33,0,0,56,2,58
20200312,NJ,30,74,20,,,,,,,,5f40e6cdda7648d658eedd3a5e5bf0f027c9b374,2020-03-12T20:00:00Z,1,,124,104,104,34,0,0,17,6,23
20200312,NM,5,155,,,,,,,,,d358c1f38d0d81a3f4719e9a593a533ccee69a30,2020-03-12T20:00:00Z,,,160,160,160,35,0,0,68,2,70
20200312,NV,7,168,,,,,,,,,8328b62027a10326d300d9fbe07f651846ae2f52,2020-03-12T20:00:00Z,,,175,175,175,32,0,0,0,2,2
20200312,NY,216,92,,,,,,,,,78ea2217b81c0eba25ec04b1196199ad81793ead,2020-03-12T20:00:00Z,,,308,308,308,36,0,0,0,0,0
20200312,OH,5,30,52,,,,,,,,e53fb02834680a20508e2d3bf535470016d3407a,2020-03-12T20:00:00Z,,,87,35,35,39,0,0,9,1,10
20200312,OK,3,36,4,,,,,,,,0695ce1aed2deb9062e4a75ce05c7d5fbb2b3975,2020-03-12T20:00:00Z,,,43,39,39,40,0,0,21,1,22
20200312,OR,19,286,62,,,,,,,,842079fddc7a5740cd7252af4ef8f126bb9784d9,2020-03-12T20:00:00Z,,,367,305,305,41,0,0,0,0,0
20200312,PA,22,116,81,,,,,,,,bb985e06b75f251244341704b20d6b0c3daa27c1,2020-03-12T20:00:00Z,,,219,138,138,42,0,0,28,7,35
20200312,RI,5,94,8,,,,,,,,ddc07b8ec93f55583d98d5fff9c8d922808f6f98,2020-03-12T20:00:00Z,,,107,99,99,44,0,0,36,0,36
20200312,SC,10,48,,,,,,,,,691f174c432862e793e830327356b4d500cea11b,2020-03-12T20:00:00Z,,,58,58,58,45,0,0,16,1,17
20200312,SD,8,27,11,,,,,,,,47b6b8df0ade463177dd058de543bf80295b9b74,2020-03-12T20:00:00Z,,,46,35,35,46,0,0,14,3,17
20200312,TN,18,79,,,,,,,,,6e03cc4e5261258b7a5b8901327389775888ec5f,2020-03-12T20:00:00Z,,,97,97,97,47,0,0,29,11,40
20200312,TX,23,,,,,,,,,,35761868039ccd3294dc3e7e548781c129b39185,2020-03-12T20:00:00Z,,,23,23,23,48,0,0,0,2,2
20200312,UT,4,131,,,,,,,,,f2f3cbbd89fcfd9045a7ece563a5d84bc969009a,2020-03-12T20:00:00Z,,,135,135,135,49,0,0,131,2,133
20200312,VA,17,117,,,,,,,,,4d7e98639658d0746cb09b19b3fe2285f875af3b,2020-03-12T20:00:00Z,,,134,134,134,51,0,0,57,8,65
20200312,VT,2,97,,,,,,,,,7279c174377b4d61c1a6e3f40530ad2505b9a9a8,2020-03-12T20:00:00Z,,,99,99,99,50,0,0,35,1,36
20200312,WA,337,3037,,,,,,,,,b346d7b6e661fa57b707151beb7062178a311a51,2020-03-12T20:00:00Z,29,,3374,3374,3374,53,5,0,862,70,932
20200312,WI,8,84,,,,,,,,,95e71f1997094b8460d58d94f2899a4b774e8a1d,2020-03-12T20:00:00Z,,,92,92,92,55,0,0,41,5,46
20200312,WV,0,7,1,,,,,,,,f0363560bc99a7f3bb66a17c11ced07c055ec423,2020-03-12T20:00:00Z,,,8,7,7,54,0,0,4,0,4
20200312,WY,1,,,,,,,,,,c8b2e0e377fc5c379d3775630a3ae430fb21861b,2020-03-12T20:00:00Z,,,1,1,1,56,0,0,0,1,1
20200311,AK,0,46,14,,,,,,,,e25f7bc0f21f762541d825d606787c8b6be7b406,2020-03-11T20:00:00Z,,,60,46,46,02,0,0,23,0,23
20200311,AL,0,10,,,,,,,,,e4593577708b6182b9126434908df283def67838,2020-03-11T20:00:00Z,,,10,10,10,01,0,0,10,0,10
20200311,AR,0,12,14,,,,,,,,655d51e087ae7e668a3932904fd2764bc1fe3a9a,2020-03-11T20:00:00Z,,,26,12,12,05,0,0,0,0,0
20200311,AZ,9,59,32,,,,,,,,fc3cab43e403773ab7bee5f42d8dd1ccc405c3d5,2020-03-11T20:00:00Z,,,100,68,68,04,0,0,8,3,11
20200311,CA,157,916,,,,,,,,,5b964b8b4ae1c9c7ef6daba3357363e3abc15fc2,2020-03-11T20:00:00Z,,,1073,1073,1073,06,0,0,226,24,250
20200311,CO,28,251,,,,,,,,,9b7a26b306bf3d4ed340b3decc9409cfd98c94a7,2020-03-11T20:00:00Z,,,279,279,279,08,0,0,109,16,125
20200311,CT,3,71,,,,,,,,,c99636f2a99205c741fd1f78c991a31f4b2c23d5,2020-03-11T20:00:00Z,,,74,74,74,09,0,0,17,1,18
20200311,DC,5,20,15,,,,,,,,71b585cf49baefd551d06676e7954dc71f2a64e8,2020-03-11T20:00:00Z,,,40,25,25,11,0,0,3,0,3
20200311,DE,1,17,2,,,,,,,,9bc125877399e695097bfde306db2dc3cf015ec3,2020-03-11T20:00:00Z,,,20,18,18,10,0,0,0,1,1
20200311,FL,28,301,147,,,,,,,,3fdf9b7b837d64d12ac78cb3c27b3e075e5b91d0,2020-03-11T20:00:00Z,2,,476,329,329,12,2,0,79,9,88
20200311,GA,22,,,,,,,,,,11817b5a695d27b1ffda2ebe492653bca8075308,2020-03-11T20:00:00Z,,,22,22,22,13,0,0,0,5,5
20200311,HI,2,,,,,,,,,,ff1bcb7f451b4534cf4cb3660cd288cb0aecd55e,2020-03-11T20:00:00Z,,,2,2,2,15,0,0,0,0,0
20200311,IA,13,46,27,,,,,,,,77b0abb25053b84dfa901e4bc749840c4d626415,2020-03-11T20:00:00Z,,,86,59,59,19,0,0,14,5,19
20200311,ID,0,67,,,,,,,,,25d42d5a1f05b6d80d04134977322867c07531b1,2020-03-11T20:00:00Z,,,67,67,67,16,0,0,26,0,26
20200311,IL,19,244,63,,,,,,,,1f62279f30c95b7b5b306bd94b9172a3f9a3b94c,2020-03-11T20:00:00Z,,,326,263,263,17,0,0,0,0,0
20200311,IN,10,33,,,,,,,,,5733cad52da8fd692ae6386e05e95fa3faf2c337,2020-03-11T20:00:00Z,,,43,43,43,18,0,0,3,4,7
20200311,KS,1,41,,,,,,,,,1b65c26cb311dbfa7aa49f1aab7df29d4100afd6,2020-03-11T20:00:00Z,,,42,42,42,20,0,0,24,0,24
20200311,KY,8,46,,,,,,,,,fc0fc1ddfd9df01dee163a7f07ef68f158f1dcc7,2020-03-11T20:00:00Z,,,54,54,54,21,0,0,18,2,20
20200311,LA,6,37,,,,,,,,,4923914a2b53558e2c4f3c3e417339a9c725cee5,2020-03-11T20:00:00Z,,,43,43,43,22,0,0,26,5,31
20200311,MA,92,,,,,,,,,,cd9166102dba61e473c3f2e49f4ad84e9876c8ad,2020-03-11T20:00:00Z,,,92,92,92,25,0,0,0,0,0
20200311,MD,9,94,,,,,,,,,d63a695f033bd1727a5d48dc63cfc733e465f19f,2020-03-11T20:00:00Z,,,103,103,103,24,0,0,5,3,8
20200311,ME,0,42,5,,,,,,,,56ac39adce93990d2bea6abfff4e3e0c2fac2886,2020-03-11T20:00:00Z,,,47,42,42,23,0,0,22,0,22
20200311,MI,2,57,18,,,,,,,,95ae7164073fcfd468ba246651ee85c33017c140,2020-03-11T20:00:00Z,,,77,59,59,26,0,0,18,2,20
20200311,MN,5,217,,,,,,,,,6ffc74c710267d31359ae6c99715670db75e09e5,2020-03-11T20:00:00Z,,,222,222,222,27,0,0,85,2,87
20200311,MO,1,,,,,,,,,,f38403847cc3922fa5b7b5f616f4398deb2e6827,2020-03-11T20:00:00Z,,,1,1,1,29,0,0,0,0,0
20200311,MS,0,20,,,,,,,,,74f4ed2b75d893f6f2e2a8c45254056db6fe2eec,2020-03-11T20:00:00Z,,,20,20,20,28,0,0,20,0,20
20200311,MT,0,21,,,,,,,,,7f8109a13dd2e5346e22790e352899f32ce51387,2020-03-11T20:00:00Z,,,21,21,21,30,0,0,6,0,6
20200311,NC,7,,,,,,,,,,a47c27a5eb23e60bf9953697c72ea9eea9bf12fc,2020-03-11T20:00:00Z,,,7,7,7,37,0,0,0,0,0
20200311,ND,0,7,6,,,,,,,,f611bed2dbd16399f91bc8000106ae8aaf8cebe3,2020-03-11T20:00:00Z,,,13,7,7,38,0,0,1,0,1
20200311,NE,5,47,16,,,,,,,,fe99e1327ca6570995bfa945ae61ff53a32b57c1,2020-03-11T20:00:00Z,,,68,52,52,31,0,0,0,2,2
20200311,NH,4,38,5,,,,,,,,04ca9fceda7e94b04987880c53564cf1816ad713,2020-03-11T20:00:00Z,,,47,42,42,33,0,0,0,0,0
20200311,NJ,24,57,20,,,,,,,,22b493a9273eb0fcbef1d9438567b97aca475b07,2020-03-11T20:00:00Z,1,,101,81,81,34,1,0,13,9,22
20200311,NM,3,87,,,,,,,,,31d78422b55f96cea7974b12f74b206caea012fc,2020-03-11T20:00:00Z,,,90,90,90,35,0,0,18,3,21
20200311,NV,5,168,,,,,,,,,2cf372124199b53471bb78cd3c8b32fa8b2c89c6,2020-03-11T20:00:00Z,,,173,173,173,32,0,0,154,5,159
20200311,NY,216,92,,,,,,,,,6fbded3854324c39522ab7fdb01d2087f60e2d2b,2020-03-11T20:00:00Z,,,308,308,308,36,0,0,0,43,43
20200311,OH,4,21,24,,,,,,,,7def7afdab71c143358b5a2f7e6043abe2b1a58c,2020-03-11T20:00:00Z,,,49,25,25,39,0,0,7,1,8
20200311,OK,2,15,11,,,,,,,,5ec52c041a7fed2461a75cd7d7b69c16408ed016,2020-03-11T20:00:00Z,,,28,17,17,40,0,0,0,0,0
20200311,OR,19,286,62,,,,,,,,a0862d7ffbd817d0c1174d1060d000628f3e2d56,2020-03-11T20:00:00Z,,,367,305,305,41,0,0,73,4,77
20200311,PA,15,88,54,,,,,,,,3f9230ce75934636a27dc9de09446739ae3d7435,2020-03-11T20:00:00Z,,,157,103,103,42,0,0,88,3,91
20200311,RI,5,58,24,,,,,,,,7d9cd1b97d61d5371a498f749caef0a0561e889b,2020-03-11T20:00:00Z,,,87,63,63,44,0,0,5,2,7
20200311,SC,9,32,,,,,,,,,9f0ba59beda560436e4c7086a310d705a164a73f,2020-03-11T20:00:00Z,,,41,41,41,45,0,0,8,2,10
20200311,SD,5,13,2,,,,,,,,e7ff0dfa7e6bd84d5f7633f98e650bd9fef932b6,2020-03-11T20:00:00Z,,,20,18,18,46,0,0,2,5,7
20200311,TN,7,50,,,,,,,,,0531f9d13df3db8ea79200191ddd853777674c53,2020-03-11T20:00:00Z,,,57,57,57,47,0,0,50,0,50
20200311,TX,21,,,,,,,,,,091b385894d0ae05bb6ea5bb6a7272ba6340a7c9,2020-03-11T20:00:00Z,,,21,21,21,48,0,0,0,8,8
20200311,UT,2,,,,,,,,,,76c94894d50c365d4846731e5cecb0f05021007f,2020-03-11T20:00:00Z,,,2,2,2,49,0,0,0,0,0
20200311,VA,9,60,,,,,,,,,a815f0d7942b6f1baa509e533e21d81829a3028d,2020-03-11T20:00:00Z,,,69,69,69,51,0,0,7,1,8
20200311,VT,1,62,,,,,,,,,c8f0f13f72669b1a4b6bde7505772ae78d229919,2020-03-11T20:00:00Z,,,63,63,63,50,0,0,22,0,22
20200311,WA,267,2175,,,,,,,,,f3865367145deea2d1be9a82dd6bd3d055ac2c85,2020-03-11T20:00:00Z,24,,2442,2442,2442,53,0,0,1065,105,1170
20200311,WI,3,43,,,,,,,,,cd76c7d7754176cb52177b3b9327eeeb6752d492,2020-03-11T20:00:00Z,,,46,46,46,55,0,0,7,1,8
20200311,WV,0,3,2,,,,,,,,d4710e9f30d17c17211938eeec385ecf4bc5b2f0,2020-03-11T20:00:00Z,,,5,3,3,54,0,0,1,0,1
20200311,WY,0,,,,,,,,,,b2a970a45b39b2c7ec078c35757610c22241c0f6,2020-03-11T20:00:00Z,,,0,0,0,56,0,0,0,0,0
20200310,AK,0,23,9,,,,,,,,6561feac0f53ef762911b4995038df195c62b2cb,2020-03-10T20:00:00Z,,,32,23,23,02,0,0,0,0,0
20200310,AL,0,0,0,,,,,,,,d77d1bec988a8d98086652dbe2ec43647b585934,2020-03-10T20:00:00Z,,,0,0,0,01,0,0,0,0,0
20200310,AR,0,12,3,,,,,,,,76ed6d1dfa326d78b8fc7277b42229fbfb98b6a8,2020-03-10T20:00:00Z,,,15,12,12,05,0,0,0,0,0
20200310,AZ,6,51,27,,,,,,,,5dcc8301933ff5a560e3f87228a47f11150d6833,2020-03-10T20:00:00Z,,,84,57,57,04,0,0,7,1,8
20200310,CA,133,690,,,,,,,,,0d0ac26ba210e002c4cef8b50e8305df0d25daea,2020-03-10T20:00:00Z,,,823,823,823,06,0,0,0,19,19
20200310,CO,12,142,1,,,,,,,,69761082125ab448f7ae1bd685e412afa79151b6,2020-03-10T20:00:00Z,,,155,154,154,08,0,0,9,3,12
20200310,CT,2,54,,,,,,,,,75db1306a0c3b31835dc1c30f84f59c0a1029937,2020-03-10T20:00:00Z,,,56,56,56,09,0,0,8,1,9
20200310,DC,5,17,2,,,,,,,,5ba08a29ba9ee29378b41ef76d6d3d0c369f679c,2020-03-10T20:00:00Z,,,24,22,22,11,0,0,3,4,7
20200310,DE,0,17,3,,,,,,,,a31ea8cf78fa49489859b210157dc22e5260bb01,2020-03-10T20:00:00Z,,,20,17,17,10,0,0,2,0,2
20200310,FL,19,222,155,,,,,,,,28a9eb3913e7fc74070cec1d31d47aaac19e37fe,2020-03-10T20:00:00Z,,,396,241,241,12,0,0,82,1,83
20200310,GA,17,,,,,,,,,,a132882a6ceb7fe633651eb8a444d54b2abf057d,2020-03-10T20:00:00Z,,,17,17,17,13,0,0,0,5,5
20200310,HI,2,,,,,,,,,,2200379e92b872f68070789c24b448f9e633a242,2020-03-10T20:00:00Z,,,2,2,2,15,0,0,0,0,0
20200310,IA,8,32,11,,,,,,,,0339432703c45d77e65b4663ab034cdef1ba1231,2020-03-10T20:00:00Z,,,51,40,40,19,0,0,6,5,11
20200310,ID,0,41,,,,,,,,,3398df61adeea88796c0151991e91767f23fc23b,2020-03-10T20:00:00Z,,,41,41,41,16,0,0,0,0,0
20200310,IL,19,244,63,,,,,,,,61d4b2c48b0bcc01290ae69bcaf6239f7addecee,2020-03-10T20:00:00Z,,,326,263,263,17,0,0,53,12,65
20200310,IN,6,30,,,,,,,,,4fbecba581f9cdd1d759e98a8d4bc184c0f49b18,2020-03-10T20:00:00Z,,,36,36,36,18,0,0,30,4,34
20200310,KS,1,17,21,,,,,,,,d0b4ac6984434e6749c3bb46fc10b7693b8078df,2020-03-10T20:00:00Z,,,39,18,18,20,0,0,6,0,6
20200310,KY,6,28,,,,,,,,,fb7dfcd14029c819e924cd14118e37cc9ea2a536,2020-03-10T20:00:00Z,,,34,34,34,21,0,0,11,2,13
20200310,LA,1,11,,,,,,,,,0cbd4af0d2d6d254ceee5f1d76f6f82e4a2c11d4,2020-03-10T20:00:00Z,,,12,12,12,22,0,0,6,0,6
20200310,MA,92,,,,,,,,,,5b2241741b78dcad0513de205c9dba09feae3b20,2020-03-10T20:00:00Z,,,92,92,92,25,0,0,0,51,51
20200310,MD,6,89,,,,,,,,,8f118d594d196858544dc7c24bc999d3c9843b04,2020-03-10T20:00:00Z,,,95,95,95,24,0,0,16,1,17
20200310,ME,0,20,5,,,,,,,,6d6c02b7fd92ae263c4abcb613d6f26636decd1f,2020-03-10T20:00:00Z,,,25,20,20,23,0,0,19,0,19
20200310,MI,0,39,24,,,,,,,,d96435cd0fb4e7a6e840afa424ac09f3d2214b68,2020-03-10T20:00:00Z,,,63,39,39,26,0,0,3,0,3
20200310,MN,3,132,,,,,,,,,a8bd7312aff6c319969c4284aea579180470d47b,2020-03-10T20:00:00Z,,,135,135,135,27,0,0,52,1,53
20200310,MO,1,,,,,,,,,,1c34a0d3912ffb4d44146d0a8411b013fe7248fc,2020-03-10T20:00:00Z,,,1,1,1,29,0,0,0,0,0
20200310,MS,0,,,,,,,,,,32252d133f8ee8b943fd708c3090d079ce45f7f2,2020-03-10T20:00:00Z,,,0,0,0,28,0,0,0,0,0
20200310,MT,0,15,,,,,,,,,f250ac19e94bd81dd095fe875f429e4570af3286,2020-03-10T20:00:00Z,,,15,15,15,30,0,0,4,0,4
20200310,NC,7,,,,,,,,,,7820bb5206372383942ee45994aaac2274420d5f,2020-03-10T20:00:00Z,,,7,7,7,37,0,0,0,5,5
20200310,ND,0,6,2,,,,,,,,e0805fa5b5182659ea70ca569733d8ba876ad01d,2020-03-10T20:00:00Z,,,8,6,6,38,0,0,6,0,6
20200310,NE,3,47,16,,,,,,,,2eceb89898abf1c18dc8d4e151aa6a9b7f24bd44,2020-03-10T20:00:00Z,,,66,50,50,31,0,0,11,0,11
20200310,NH,4,38,5,,,,,,,,db5511251d15682916c0b2c7d18c8e042946c86c,2020-03-10T20:00:00Z,,,47,42,42,33,0,0,0,0,0
20200310,NJ,15,44,20,,,,,,,,894e37aeac26176f2ecbaeae4a2a73ec49d66177,2020-03-10T20:00:00Z,,,79,59,59,34,0,0,9,4,13
20200310,NM,0,69,,,,,,,,,9c36987288c350a2183bb8af37efa35702813c0d,2020-03-10T20:00:00Z,,,69,69,69,35,0,0,12,0,12
20200310,NV,0,14,,,,,,,,,a5d9d14c3ee29edf8b175c5a5795e9211fc36c8f,2020-03-10T20:00:00Z,,,14,14,14,32,0,0,0,0,-1
20200310,NY,173,92,,,,,,,,,193f85893cecb99d063a03060bc4802d2d6458f1,2020-03-10T20:00:00Z,,,265,265,265,36,0,0,0,31,31
20200310,OH,3,14,15,,,,,,,,c226bdb43a781003d1620baf6ee7b55ad00c8b50,2020-03-10T20:00:00Z,,,32,17,17,39,0,0,3,0,3
20200310,OK,2,15,11,,,,,,,,fe6cb3ee7ed6b8df044b4274f1235f2c35195542,2020-03-10T20:00:00Z,,,28,17,17,40,0,0,7,1,8
20200310,OR,15,213,67,,,,,,,,b124f2b2f232984d5c0185a54ad7f85bb988a90a,2020-03-10T20:00:00Z,,,295,228,228,41,0,0,48,1,49
20200310,PA,12,,,,,,,,,,7dd8e8b438f07cd82021188efd5b91468b8ce15e,2020-03-10T20:00:00Z,,,12,12,12,42,0,0,0,5,5
20200310,RI,3,53,6,,,,,,,,48ebb442da8e231a9e0addfbc20f9760df7fc686,2020-03-10T20:00:00Z,,,62,56,56,44,0,0,0,0,0
20200310,SC,7,24,,,,,,,,,dd5f3a1e885292f8e8c6d3160128a1c49b84da8c,2020-03-10T20:00:00Z,,,31,31,31,45,0,0,0,0,0
20200310,SD,0,11,0,,,,,,,,f2608368ec96bfd0baf5e23ac0640cb2cb6fba1c,2020-03-10T20:00:00Z,,,11,11,11,46,0,0,6,0,6
20200310,TN,7,,,,,,,,,,51d7454f0a63341e7d33e9bc17ec4203c1d7b5eb,2020-03-10T20:00:00Z,,,7,7,7,47,0,0,0,4,4
20200310,TX,13,,,,,,,,,,eea92c2654f734808ae61461bd187a8ae737ede5,2020-03-10T20:00:00Z,,,13,13,13,48,0,0,0,1,1
20200310,UT,2,,,,,,,,,,466b66d0cbac6da0ff5069cee893a6e5774b3809,2020-03-10T20:00:00Z,,,2,2,2,49,0,0,0,1,1
20200310,VA,8,53,,,,,,,,,50c5f90ad518306f2aa6cfa2d4aa8f9c6b89f6eb,2020-03-10T20:00:00Z,,,61,61,61,51,0,0,15,5,20
20200310,VT,1,40,,,,,,,,,1ef4d4eeca815cb3358eed86bfdd2b22a7faacc9,2020-03-10T20:00:00Z,,,41,41,41,50,0,0,6,0,6
20200310,WA,162,1110,,,,,,,,,06768336fc25d73cd5c617780d60df98257b9efc,2020-03-10T20:00:00Z,24,,1272,1272,1272,53,2,0,0,26,26
20200310,WI,2,36,,,,,,,,,6547fab519037da58609fee7229c4673423a5614,2020-03-10T20:00:00Z,,,38,38,38,55,0,0,0,1,1
20200310,WV,0,2,3,,,,,,,,a0f64043e0dbb8a0390316af34e6ae60a7913160,2020-03-10T20:00:00Z,,,5,2,2,54,0,0,0,0,0
20200310,WY,0,0,0,,,,,,,,7386ca913797703a8f0738ff599605f36db6d06b,2020-03-10T20:00:00Z,,,0,0,0,56,0,0,0,0,0
20200309,AK,0,23,9,,,,,,,,b5cbe627dd51a6e70136134185391030f93ffcb5,2020-03-09T20:00:00Z,,,32,23,23,02,0,0,9,0,9
20200309,AL,0,,,,,,,,,,3c15dbef6838aa05f46554b8f49c5d96677df531,2020-03-09T20:00:00Z,,,0,0,0,01,0,0,0,0,0
20200309,AR,0,12,0,,,,,,,,5ef70cfa2d033bc17949f85ed40a9a63e9ea95df,2020-03-09T20:00:00Z,,,12,12,12,05,0,0,6,0,6
20200309,AZ,5,44,7,,,,,,,,34a29bfcfa1a71c92fe460039d78f6bb8bf65e60,2020-03-09T20:00:00Z,,,56,49,49,04,0,0,0,0,0
20200309,CA,114,690,,,,,,,,,6af63e3581f76d44b6446c5c221d5a2dd96f5a24,2020-03-09T20:00:00Z,,,804,804,804,06,0,0,228,26,254
20200309,CO,9,133,,,,,,,,,b23d501869c0a98edd0eedb4d3393fa413a2532b,2020-03-09T20:00:00Z,,,142,142,142,08,0,0,29,1,30
20200309,CT,1,46,,,,,,,,,77af98908db8db59c3733c28b2b979a5dfbd11d7,2020-03-09T20:00:00Z,,,47,47,47,09,0,0,17,0,17
20200309,DC,1,14,3,,,,,,,,01c063fd1289fc23b3b7be3d4aea3307b50f5040,2020-03-09T20:00:00Z,,,18,15,15,11,0,0,4,0,4
20200309,DE,0,15,3,,,,,,,,966cd7a363b1718847965e750f4e76527e4f3d3f,2020-03-09T20:00:00Z,,,18,15,15,10,0,0,5,0,5
20200309,FL,18,140,115,,,,,,,,318b0f35925b3b172b90b2faa9823d23882636b6,2020-03-09T20:00:00Z,,,273,158,158,12,0,0,22,1,23
20200309,GA,12,,,,,,,,,,279f6e8110f21f2cb9b2d1ff1e6841afa1c0af40,2020-03-09T20:00:00Z,,,12,12,12,13,0,0,0,5,5
20200309,HI,2,,,,,,,,,,e8c71d4ebcb3a9aed28d52d363088faa8aa067e2,2020-03-09T20:00:00Z,,,2,2,2,15,0,0,0,1,1
20200309,IA,3,26,8,,,,,,,,2d4f00730c4f5721f4da3d4ba82eebff77c5e4e2,2020-03-09T20:00:00Z,,,37,29,29,19,0,0,11,3,14
20200309,ID,0,41,,,,,,,,,cebad76e979c6b393b559632dcfef8e1cb9ccd0c,2020-03-09T20:00:00Z,,,41,41,41,16,0,0,14,0,14
20200309,IL,7,191,44,,,,,,,,3fe26606e274da04428ec1f3e932c98cf64e5b49,2020-03-09T20:00:00Z,,,242,198,198,17,0,0,0,1,1
20200309,IN,2,,,,,,,,,,d82e74b7662ac9fc6dcad52693089393fd73c192,2020-03-09T20:00:00Z,,,2,2,2,18,0,0,0,0,0
20200309,KS,1,11,0,,,,,,,,ce8f496b64774484ba055b88fe463cfea2c4ecaf,2020-03-09T20:00:00Z,,,12,12,12,20,0,0,0,0,0
20200309,KY,4,17,,,,,,,,,ea273e790c71c42e501ffeb854c765c4ed3d91e0,2020-03-09T20:00:00Z,,,21,21,21,21,0,0,4,3,7
20200309,LA,1,5,,,,,,,,,34ed705a6d35331063fd0d6d7867baca1fefe36c,2020-03-09T20:00:00Z,,,6,6,6,22,0,0,0,1,1
20200309,MA,41,,,,,,,,,,bcf1ffcd7a8be3ab88adca44ae7ca0012a0b6cb7,2020-03-09T20:00:00Z,,,41,41,41,25,0,0,0,28,28
20200309,MD,5,73,,,,,,,,,21d797080b2facbf18276350a712ba702c1db616,2020-03-09T20:00:00Z,,,78,78,78,24,0,0,21,2,23
20200309,ME,0,1,,,,,,,,,fc7ef15fa0bc2846fd0a361a454006c43ff5a50c,2020-03-09T20:00:00Z,,,1,1,1,23,0,0,0,0,0
20200309,MI,0,36,11,,,,,,,,f452a2612cbdaff083c56ba537b2f8dfaf163299,2020-03-09T20:00:00Z,,,47,36,36,26,0,0,10,0,10
20200309,MN,2,80,,,,,,,,,2fe8a8c39e6d7656c053b0ddc487d11d014d7968,2020-03-09T20:00:00Z,,,82,82,82,27,0,0,32,1,33
20200309,MO,1,,,,,,,,,,2ae8fc33a8f32d0393f6509589e5aa2db017a1a7,2020-03-09T20:00:00Z,,,1,1,1,29,0,0,0,0,0
20200309,MS,0,,,,,,,,,,2b1e959c40e1d97cbd4fdb3af6d146176cb72a7a,2020-03-09T20:00:00Z,,,0,0,0,28,0,0,0,0,0
20200309,MT,0,11,0,,,,,,,,7caadf3f2f41b65095fcabca5007b1fe934dd6c4,2020-03-09T20:00:00Z,,,11,11,11,30,0,0,0,0,0
20200309,NC,2,,,,,,,,,,36a7efc53186e6278555d0eb1f7f7780868cfc03,2020-03-09T20:00:00Z,,,2,2,2,37,0,0,0,0,0
20200309,ND,0,0,,,,,,,,,59a9fe03c914e9211dd5546b982a478f5b7e46d8,2020-03-09T20:00:00Z,,,0,0,0,38,0,0,0,0,0
20200309,NE,3,36,9,,,,,,,,aacea49d265183a389da9f54170298fc8d6a486e,2020-03-09T20:00:00Z,,,48,39,39,31,0,0,19,2,21
20200309,NH,4,38,5,,,,,,,,95d9f3370e5979350a25379b65c7f98b077c7213,2020-03-09T20:00:00Z,,,47,42,42,33,0,0,0,0,0
20200309,NJ,11,35,14,,,,,,,,e0df6d08dc91c5afd18e9f35f22aa322b4b0f0ce,2020-03-09T20:00:00Z,,,60,46,46,34,0,0,4,5,9
20200309,NM,0,57,0,,,,,,,,a766e1775bcbafa6817f7b2f15a9292652caba5c,2020-03-09T20:00:00Z,,,57,57,57,35,0,0,9,0,9
20200309,NV,1,14,,,,,,,,,83d025cf17543e497cd5063608e45dc9cfa44fb8,2020-03-09T20:00:00Z,,,15,15,15,32,0,0,0,0,0
20200309,NY,142,92,,,,,,,,,260a070d28ed40a35e8b31aca5f4ab3352dc9ba8,2020-03-09T20:00:00Z,,,234,234,234,36,0,0,0,37,37
20200309,OH,3,11,5,,,,,,,,40edb3ac44427394a2fb18a1b4cd4064b7e67672,2020-03-09T20:00:00Z,,,19,14,14,39,0,0,1,3,4
20200309,OK,1,8,10,,,,,,,,8b689e9e2ad67a6b028c2431bedd2cec040154e0,2020-03-09T20:00:00Z,,,19,9,9,40,0,0,0,0,0
20200309,OR,14,165,52,,,,,,,,f5a1974166b2872d9568b45083f043611e5c5652,2020-03-09T20:00:00Z,,,231,179,179,41,0,0,65,0,65
20200309,PA,7,,,,,,,,,,5a788f1e0625421bec669ccb76c0128dab73bdb5,2020-03-09T20:00:00Z,,,7,7,7,42,0,0,0,3,3
20200309,RI,3,53,6,,,,,,,,defc05cea1df807806611dea638c1ff8ee24a726,2020-03-09T20:00:00Z,,,62,56,56,44,0,0,23,0,23
20200309,SC,7,24,,,,,,,,,230947ecf1cd935a64d923210a6ffb285ea513bd,2020-03-09T20:00:00Z,,,31,31,31,45,0,0,16,5,21
20200309,SD,0,5,0,,,,,,,,207d9a28c6c82c49caa4472678725e844f8a1836,2020-03-09T20:00:00Z,,,5,5,5,46,0,0,0,0,0
20200309,TN,3,,,,,,,,,,2ca1b9768f605daaa7c62ae41b8b6f94c63d1a80,2020-03-09T20:00:00Z,,,3,3,3,47,0,0,0,0,0
20200309,TX,12,,,,,,,,,,c3bedfa0a6b278f333e5bdb9fde59e674715bfb1,2020-03-09T20:00:00Z,,,12,12,12,48,0,0,0,4,4
20200309,UT,1,,,,,,,,,,fa208666968a4489a5cde79e40c08bdddece1361,2020-03-09T20:00:00Z,,,1,1,1,49,0,0,0,0,0
20200309,VA,3,38,9,,,,,,,,de39b29dd1a1a173788fc7a0f22b44ccb7899f1c,2020-03-09T20:00:00Z,,,50,41,41,51,0,0,2,1,3
20200309,VT,1,34,,,,,,,,,26c656cc1971e9a2bde7f9614ffe7ef51900c432,2020-03-09T20:00:00Z,,,35,35,35,50,0,0,6,0,6
20200309,WA,136,1110,,,,,,,,,d72514f02a70119a149f4bc9d6ec6cb789a7e255,2020-03-09T20:00:00Z,22,,1246,1246,1246,53,4,0,470,34,504
20200309,WI,1,36,,,,,,,,,e29cff75f4e2deeb5547eee65bcb33cdc75c2fd8,2020-03-09T20:00:00Z,,,37,37,37,55,0,0,5,0,5
20200309,WV,0,2,3,,,,,,,,8e4b9a84bdbba65581c2287854f03105e8e97149,2020-03-09T20:00:00Z,,,5,2,2,54,0,0,0,0,0
20200309,WY,0,,,,,,,,,,c052da9af9257ed5150197a38c4d1cf9cb5992b0,2020-03-09T20:00:00Z,,,0,0,0,56,0,0,0,0,0
20200308,AK,0,14,6,,,,,,,,844624448b0ee3ff7dd240e0d3f4258de1563064,2020-03-08T20:00:00Z,,,20,14,14,02,0,0,2,0,2
20200308,AL,0,,,,,,,,,,dc8486565b986e301a3cb52dda7d6014007253e4,2020-03-08T20:00:00Z,,,0,0,0,01,0,0,0,0,0
20200308,AR,0,6,0,,,,,,,,6263c0cd4836c8418421de9e16b86212a90ea53f,2020-03-08T20:00:00Z,,,6,6,6,05,0,0,0,0,0
20200308,AZ,5,44,7,,,,,,,,7fab3faf304af2d21cf805b897dbe16c6cf1a5c6,2020-03-08T20:00:00Z,,,56,49,49,04,0,0,0,0,0
20200308,CA,88,462,,,,,,,,,39ba303e6c33d759f657dfaa835f2714a49ecc37,2020-03-08T20:00:00Z,,,550,550,550,06,0,0,0,19,19
20200308,CO,8,104,,,,,,,,,999728a960c0e35c7bfce426d19eef24c7fd3e64,2020-03-08T20:00:00Z,,,112,112,112,08,0,0,49,0,49
20200308,CT,1,29,8,,,,,,,,9af238ecf88478ebbe90c92437c721d9fd8e6d17,2020-03-08T20:00:00Z,,,38,30,30,09,0,0,29,1,30
20200308,DC,1,10,0,,,,,,,,49cc05969337862100d6dac922ca02efcccd9c37,2020-03-08T20:00:00Z,,,11,11,11,11,0,0,2,1,3
20200308,DE,0,10,0,,,,,,,,55e0c22b683f94999c6a852f5432d86ffe73ebae,2020-03-08T20:00:00Z,,,10,10,10,10,0,0,0,0,0
20200308,FL,17,118,108,,,,,,,,58118fa0e29d8d1a2b018270736aa4e15f658ed0,2020-03-08T20:00:00Z,,,243,135,135,12,0,0,18,3,21
20200308,GA,7,,,,,,,,,,e234f04216762da88bc69c82ae358ca0e126a20e,2020-03-08T20:00:00Z,,,7,7,7,13,0,0,0,1,1
20200308,HI,1,,,,,,,,,,94350220775a3b6e5fda814910579f1b46265ab8,2020-03-08T20:00:00Z,,,1,1,1,15,0,0,0,0,0
20200308,IA,0,15,2,,,,,,,,ed9e73a744bebf0b1f7f5bda0383d3fe3134e20c,2020-03-08T20:00:00Z,,,17,15,15,19,0,0,0,0,0
20200308,ID,0,27,,,,,,,,,9445d66db16882680e8502f339ebcea0f5762ccd,2020-03-08T20:00:00Z,,,27,27,27,16,0,0,0,0,0
20200308,IL,6,191,44,,,,,,,,6c7bf5170846973ebb63a9ac680596f733cf5a5d,2020-03-08T20:00:00Z,,,241,197,197,17,0,0,0,0,0
20200308,IN,2,,,,,,,,,,ba3578ffa6ce7f594b1afdeb97b4e26c421cf59f,2020-03-08T20:00:00Z,,,2,2,2,18,0,0,0,1,1
20200308,KS,1,11,0,,,,,,,,d7a2adf7af3c56e40d1a75f02da8878c2e934ccd,2020-03-08T20:00:00Z,,,12,12,12,20,0,0,0,1,1
20200308,KY,1,13,,,,,,,,,1930ced9af77c060162cc04abf6f9d53d28c39ac,2020-03-08T20:00:00Z,,,14,14,14,21,0,0,4,0,4
20200308,LA,0,5,,,,,,,,,f0cd89bf8cfc3f22372a64bbf45ae165e5845bb1,2020-03-08T20:00:00Z,,,5,5,5,22,0,0,5,0,5
20200308,MA,13,,,,,,,,,,db7ba78165b69c05b53151fbdc1d322c2e5a1688,2020-03-08T20:00:00Z,,,13,13,13,25,0,0,0,0,0
20200308,MD,3,52,,,,,,,,,cbac8d376b30d5d5e04172efbb77aa9f9d49942b,2020-03-08T20:00:00Z,,,55,55,55,24,0,0,11,0,11
20200308,ME,0,1,,,,,,,,,a44c270bd2fd674f7bf3ffcf3b9042baa0c7d8b2,2020-03-08T20:00:00Z,,,1,1,1,23,0,0,0,0,0
20200308,MI,0,26,10,,,,,,,,b18fde63e3631e8b23f67150b7f29f68f23f26d2,2020-03-08T20:00:00Z,,,36,26,26,26,0,0,8,0,8
20200308,MN,1,48,,,,,,,,,3bb2cdf04d3b3fa3eaea091fd099d444818650e2,2020-03-08T20:00:00Z,,,49,49,49,27,0,0,0,0,0
20200308,MO,1,,,,,,,,,,61c8364771bfe55687a47ce4650d8614e697d7ca,2020-03-08T20:00:00Z,,,1,1,1,29,0,0,0,1,1
20200308,MS,0,,,,,,,,,,2d0d4688d015247af02eab6b55ae72e221d8ac7c,2020-03-08T20:00:00Z,,,0,0,0,28,0,0,0,0,0
20200308,MT,0,11,,,,,,,,,cdb6980828a9f676bf55fdd84394dfd3d2619c80,2020-03-08T20:00:00Z,,,11,11,11,30,0,0,0,0,0
20200308,NC,2,,,,,,,,,,550aef8aafb9d182e2c2db40483a3c4030f9fa27,2020-03-08T20:00:00Z,,,2,2,2,37,0,0,0,0,0
20200308,ND,0,0,,,,,,,,,e1b82af26658ba59e5450a632559324dab21d186,2020-03-08T20:00:00Z,,,0,0,0,38,0,0,0,0,0
20200308,NE,1,17,5,,,,,,,,0a814283723e80c081ea9aced87caae627354a77,2020-03-08T20:00:00Z,,,23,18,18,31,0,0,0,0,0
20200308,NH,4,38,5,,,,,,,,ecfe42d37126f9471a8c8176b24545e96c32c1d5,2020-03-08T20:00:00Z,,,47,42,42,33,0,0,18,2,20
20200308,NJ,6,31,0,,,,,,,,1e8aab109a7c26892276d26946a56c0163edcd84,2020-03-08T20:00:00Z,,,37,37,37,34,0,0,31,2,33
20200308,NM,0,48,0,,,,,,,,3ae3b323e6fccff2c838538447fffa389d9e5f4a,2020-03-08T20:00:00Z,,,48,48,48,35,0,0,0,0,0
20200308,NV,1,14,,,,,,,,,def0cb8fc381af9358ec1023f361e556ab9f9ded,2020-03-08T20:00:00Z,,,15,15,15,32,0,0,0,0,0
20200308,NY,105,92,,,,,,,,,f6d3b78f41cadeaf08e72f35692a9619d70aad07,2020-03-08T20:00:00Z,,,197,197,197,36,0,0,0,29,29
20200308,OH,0,10,4,,,,,,,,7e8d292bba63ea4513c06f2051dea6861b470916,2020-03-08T20:00:00Z,,,14,10,10,39,0,0,1,0,1
20200308,OK,1,8,2,,,,,,,,b6018ab69b18e7cd1a1cdabcf009e65d0f07e5ee,2020-03-08T20:00:00Z,,,11,9,9,40,0,0,8,0,8
20200308,OR,14,100,53,,,,,,,,882f37383b337cc29b83d8317156e4a4311f6627,2020-03-08T20:00:00Z,,,167,114,114,41,0,0,23,7,30
20200308,PA,4,,,,,,,,,,a96dc6ae2a6d9f2146ab5b921f29c8c540026143,2020-03-08T20:00:00Z,,,4,4,4,42,0,0,0,2,2
20200308,RI,3,30,12,,,,,,,,1f2994a89f2153e8cbf70397cf042a16351be821,2020-03-08T20:00:00Z,,,45,33,33,44,0,0,30,1,31
20200308,SC,2,8,,,,,,,,,db7aefd437c9ae1600b9c0b62d4f9344d3a99dc7,2020-03-08T20:00:00Z,,,10,10,10,45,0,0,0,0,0
20200308,SD,0,5,0,,,,,,,,a54f67d9f8d3c7647c20085e8d59e40c6290250b,2020-03-08T20:00:00Z,,,5,5,5,46,0,0,0,0,0
20200308,TN,3,,,,,,,,,,55ca27b24b97bbb5f61d3c7d3db93ad7f41f6240,2020-03-08T20:00:00Z,,,3,3,3,47,0,0,0,2,2
20200308,TX,8,,,,,,,,,,be48d5d3143d163568736568b389b7bcae8fe816,2020-03-08T20:00:00Z,,,8,8,8,48,0,0,0,0,0
20200308,UT,1,,,,,,,,,,3687612a6d76e15f8a889cdb629d2dda034d897b,2020-03-08T20:00:00Z,,,1,1,1,49,0,0,0,0,0
20200308,VA,2,36,6,,,,,,,,3e12d0328ad20d41eb4f57a4fd4143d65e263a97,2020-03-08T20:00:00Z,,,44,38,38,51,0,0,5,2,7
20200308,VT,1,28,,,,,,,,,2393fda9fc64b4825ff4d3456139404c6fdeffaa,2020-03-08T20:00:00Z,,,29,29,29,50,0,0,12,1,13
20200308,WA,102,640,60,,,,,,,,ff203f889be06e02d7abbc241bb3327974f62c59,2020-03-08T20:00:00Z,18,,802,742,742,53,2,0,270,0,270
20200308,WI,1,31,12,,,,,,,,b834c9b5c7a55a60692aace16160db4e77576973,2020-03-08T20:00:00Z,,,44,32,32,55,0,0,0,0,0
20200308,WV,0,2,3,,,,,,,,4baf5efaa3462e45c3a086d03ba4bf9376b10202,2020-03-08T20:00:00Z,,,5,2,2,54,0,0,0,0,0
20200308,WY,0,,,,,,,,,,04b812c8dbb7bd7a7c1c24bb7e3b1116fb1cfa96,2020-03-08T20:00:00Z,,,0,0,0,56,0,0,0,0,0
20200307,AK,0,12,2,,,,,,,,71953eb42494f6000afda41cda80b1b3dc836a83,2020-03-07T21:00:00Z,,,14,12,12,02,0,0,4,0,4
20200307,AL,0,,,,,,,,,,1d94a3b00af81e57b35a00c0eeaa339ec76d962a,2020-03-07T21:00:00Z,,,0,0,0,01,,,,,
20200307,AR,0,6,0,,,,,,,,bdba8d05662d7b38e7309c5baa49cd20b63a536b,2020-03-07T21:00:00Z,,,6,6,6,05,0,0,0,0,0
20200307,AZ,5,44,7,,,,,,,,0c334b56af3108711bb907f46599a84bd536ac1d,2020-03-07T21:00:00Z,,,56,49,49,04,0,0,11,2,13
20200307,CA,69,462,,,,,,,,,311a213f5744c6b33147c107519218e8d9f55d23,2020-03-07T21:00:00Z,,,531,531,531,06,0,0,0,9,9
20200307,CO,8,55,69,,,,,,,,b3e767a79aa144a708ff8d26dd77311725722068,2020-03-07T21:00:00Z,,,132,63,63,08,0,0,9,6,15
20200307,CT,0,,,,,,,,,,d9e680a00789072a49cb76e097d4229667366ed7,2020-03-07T21:00:00Z,,,0,0,0,09,,,,,
20200307,DC,0,8,1,,,,,,,,e11c537902c2e50281d5f0474f9627885a7d2687,2020-03-07T21:00:00Z,,,9,8,8,11,0,0,0,0,0
20200307,DE,0,10,0,,,,,,,,7eadaaa0b57573c2bdbc9a8e6cb4491819bdebe3,2020-03-07T21:00:00Z,,,10,10,10,10,0,0,0,0,0
20200307,FL,14,100,88,,,,,,,,8e5302ac32c92ff9ad0d33eac5dbb7fadb2633fc,2020-03-07T21:00:00Z,,,202,114,114,12,0,0,45,5,50
20200307,GA,6,,,,,,,,,,300c65424c0683e4fe3b738ffa83c73e6e166987,2020-03-07T21:00:00Z,,,6,6,6,13,0,0,0,4,4
20200307,HI,1,,,,,,,,,,fdf9b14d1375f62ec31807e17621275a28a68e35,2020-03-07T21:00:00Z,,,1,1,1,15,,,,,
20200307,IA,0,15,2,,,,,,,,57014c410bdcf67c766c3bde093c62bf971bf561,2020-03-07T21:00:00Z,,,17,15,15,19,0,0,0,0,0
20200307,ID,0,27,,,,,,,,,4f4e0071fd17623d671266cb5b4d8f4a998e7635,2020-03-07T21:00:00Z,,,27,27,27,16,,,,,
20200307,IL,6,191,44,,,,,,,,0617c3d41d4b13ac629144876a75a2d391036742,2020-03-07T21:00:00Z,,,241,197,197,17,0,0,11,1,12
20200307,IN,1,,,,,,,,,,341ab30a48c34775d1b7fb9b4a82dea3d4bdff65,2020-03-07T21:00:00Z,,,1,1,1,18,0,0,0,0,0
20200307,KS,0,11,2,,,,,,,,3423d332e782b75c00baf7159c3aa95ea8927439,2020-03-07T21:00:00Z,,,13,11,11,20,0,0,7,0,7
20200307,KY,1,9,,,,,,,,,48c3d48fed83cfd2f32e9dbf06e7e1410d3e0fe6,2020-03-07T21:00:00Z,,,10,10,10,21,0,0,2,1,3
20200307,LA,0,,,,,,,,,,b7526761c843e52a6bd2a5e89719a7ed71cc0b5e,2020-03-07T21:00:00Z,,,0,0,0,22,,,,,
20200307,MA,13,,,,,,,,,,b919208fee55fb337773b232ea6298e5465a717d,2020-03-07T21:00:00Z,,,13,13,13,25,0,0,0,5,5
20200307,MD,3,41,,,,,,,,,b2d7275372012956019c1ac4675a486072ad50c0,2020-03-07T21:00:00Z,,,44,44,44,24,0,0,15,0,15
20200307,ME,0,1,,,,,,,,,78aa7cd66f9ed0076403ca7ace6b9725577d669a,2020-03-07T21:00:00Z,,,1,1,1,23,,,,,
20200307,MI,0,18,9,,,,,,,,3d2c72d07bd5dc6c02a4b44769d5b0e186861cbf,2020-03-07T21:00:00Z,,,27,18,18,26,0,0,10,0,10
20200307,MN,1,48,,,,,,,,,dff67d839a61d912b7f7b0aa8a8eee5450a0add1,2020-03-07T21:00:00Z,,,49,49,49,27,0,0,12,1,13
20200307,MO,0,,,,,,,,,,9a6811180ce7cb71ab44738976d76cc4d0c0367c,2020-03-07T21:00:00Z,,,0,0,0,29,,,,,
20200307,MS,0,,,,,,,,,,8fd30f9053208bfd268115213ef81816a8d68513,2020-03-07T21:00:00Z,,,0,0,0,28,,,,,
20200307,MT,0,11,,,,,,,,,c798a10143524f3b801c3c12385d46f0d5445c45,2020-03-07T21:00:00Z,,,11,11,11,30,,,,,
20200307,NC,2,,,,,,,,,,430c5790ef495a5f85b57fec34083672077f2925,2020-03-07T21:00:00Z,,,2,2,2,37,0,0,0,0,0
20200307,ND,0,0,,,,,,,,,fd7ee9e623951efec04cf75ce2f3bcadec68ab35,2020-03-07T21:00:00Z,,,0,0,0,38,,,,,
20200307,NE,1,17,5,,,,,,,,f005dd04ec69b52d21ffd219b42d10b897d2ddf8,2020-03-07T21:00:00Z,,,23,18,18,31,0,0,0,1,1
20200307,NH,2,20,3,,,,,,,,c3cf83675171ed0cb3ea76ec42d8087ed0549f2a,2020-03-07T21:00:00Z,,,25,22,22,33,0,0,0,0,0
20200307,NJ,4,,1,,,,,,,,baa3a70b588e2de1d71ef9323e1fd51c2ddd7bf2,2020-03-07T21:00:00Z,,,5,4,4,34,0,0,0,3,3
20200307,NM,0,48,0,,,,,,,,d4fe05fba86ad47f27ecc0a2843641fc598e7ee2,2020-03-07T21:00:00Z,,,48,48,48,35,0,0,32,0,32
20200307,NV,1,14,,,,,,,,,ff7e53fb3780e09b6df2422f8b4c69da6e7984d0,2020-03-07T21:00:00Z,,,15,15,15,32,0,0,0,0,0
20200307,NY,76,92,236,,,,,,,,53a82f90b4d4a28a5b06248b1e4c78e9229312dd,2020-03-07T21:00:00Z,,,404,168,168,36,0,0,0,43,43
20200307,OH,0,9,5,,,,,,,,c69dfa83b8288b3843884ff6e720c8496b379d9f,2020-03-07T21:00:00Z,,,14,9,9,39,0,0,1,0,1
20200307,OK,1,,,,,,,,,,a289923d68e5122aaffefddb8b334840537c641f,2020-03-07T21:00:00Z,,,1,1,1,40,,,,,
20200307,OR,7,77,40,,,,,,,,46f67721ac9c9e4bf2223020998c4d83fcc7f249,2020-03-07T21:00:00Z,,,124,84,84,41,0,0,13,4,17
20200307,PA,2,,,,,,,,,,3871d6bc6330da56761811413b00cd4445978206,2020-03-07T21:00:00Z,,,2,2,2,42,0,0,0,0,0
20200307,RI,2,,,,,,,,,,df01975511a3f3cfb1a012db40df627b9227a9ab,2020-03-07T21:00:00Z,,,2,2,2,44,,,,,
20200307,SC,2,8,,,,,,,,,8544336c14b8c734fc20a32a015006d676c30244,2020-03-07T21:00:00Z,,,10,10,10,45,0,0,3,2,5
20200307,SD,0,5,0,,,,,,,,f9c85d0328866ae577e24ba09e3c4be8f679563c,2020-03-07T21:00:00Z,,,5,5,5,46,,,,,
20200307,TN,1,,,,,,,,,,1052cb0a616ff027ac81ae4e021811dfcde09418,2020-03-07T21:00:00Z,,,1,1,1,47,0,0,0,0,0
20200307,TX,8,,,,,,,,,,9442e419a19fb5a72a0c4f5541eb6988e51a4011,2020-03-07T21:00:00Z,,,8,8,8,48,0,0,0,3,3
20200307,UT,1,,,,,,,,,,a85957691ce29b13c25a9fa29751a40218bf593d,2020-03-07T21:00:00Z,,,1,1,1,49,,,,,
20200307,VA,0,31,7,,,,,,,,6e84c7d2e592ebc2a18731e74f79dbd87b2a9867,2020-03-07T21:00:00Z,,,38,31,31,51,0,0,10,0,10
20200307,VT,0,16,,,,,,,,,ff9af8b98a1d797de0df45f07ebcd9cd6f10d588,2020-03-07T21:00:00Z,,,16,16,16,50,0,0,8,0,8
20200307,WA,102,370,66,,,,,,,,bba4f8c850e820bd03b106bdf1e40f53bca745cd,2020-03-07T21:00:00Z,16,,538,472,472,53,2,0,0,23,23
20200307,WI,1,31,12,,,,,,,,6ed08976196b8624bb1e5ae7c5fa420f672cd583,2020-03-07T21:00:00Z,,,44,32,32,55,0,0,0,0,0
20200307,WV,0,2,3,,,,,,,,709d5b8a2116344cd59199a1b319fae5f11d6bca,2020-03-07T21:00:00Z,,,5,2,2,54,0,0,1,0,1
20200307,WY,0,,,,,,,,,,265de6c0d476b4e78ad567a501a52ea9d1846184,2020-03-07T21:00:00Z,,,0,0,0,56,,,,,
20200306,AK,0,8,1,,,,,,,,b95ff00414e9a5542ba2aa08fdfda0b023c7c69c,2020-03-06T21:00:00Z,,,9,8,8,02,,,,,
20200306,AR,0,6,0,,,,,,,,baadb217d3fcf5f4811488adcd8f345a2a29e391,2020-03-06T21:00:00Z,,,6,6,6,05,,,,,
20200306,AZ,3,33,15,,,,,,,,bcfcf56b97c3f10a640d25f6148abbc1f17fa07d,2020-03-06T21:00:00Z,,,51,36,36,04,0,0,5,1,6
20200306,CA,60,462,,,,,,,,,ed5984edee3bf6ee9bc3b89bc15e52f3bdade592,2020-03-06T21:00:00Z,,,522,522,522,06,0,0,0,7,7
20200306,CO,2,46,30,,,,,,,,2affe95a8de9524f8e77344a5a354729331024fa,2020-03-06T21:00:00Z,,,78,48,48,08,0,0,27,2,29
20200306,DC,0,8,1,,,,,,,,0916c062b23fb7dafb1a661e9e93554b146102bc,2020-03-06T21:00:00Z,,,9,8,8,11,0,0,2,0,2
20200306,DE,0,10,0,,,,,,,,ce64a0188bd545e3f624bf5c958ad5a308f7c042,2020-03-06T21:00:00Z,,,10,10,10,10,,,,,
20200306,FL,9,55,51,,,,,,,,ec1d19fd312871b78238dee947a1614eb253b818,2020-03-06T21:00:00Z,,,115,64,64,12,0,0,24,0,24
20200306,GA,2,,,,,,,,,,d6ae73ad152b1a4b8de98e45e77180669400ec85,2020-03-06T21:00:00Z,,,2,2,2,13,0,0,0,0,0
20200306,IA,0,15,2,,,,,,,,73ace108c09e0e8391d16fb4cc771e1dd2107a8a,2020-03-06T21:00:00Z,,,17,15,15,19,,,,,
20200306,IL,5,180,35,,,,,,,,cea4d67d62c223cc0e6e983c16ec4eb1e7e287e7,2020-03-06T21:00:00Z,,,220,185,185,17,0,0,15,0,15
20200306,IN,1,,,,,,,,,,57d3744352ffb9db87fd1bf34f0a80df811443d2,2020-03-06T21:00:00Z,,,1,1,1,18,,,,,
20200306,KS,0,4,0,,,,,,,,69d9379255fba9dc0e12dc3d34568cf662050519,2020-03-06T21:00:00Z,,,4,4,4,20,,,,,
20200306,KY,0,7,3,,,,,,,,d14490bb62ff36a14f6d7d3983dcc37a6213f306,2020-03-06T21:00:00Z,,,10,7,7,21,,,,,
20200306,MA,8,,,,,,,,,,ba07a81180b3f869f4fc9a15473d56c77bda4a58,2020-03-06T21:00:00Z,,,8,8,8,25,0,0,0,6,6
20200306,MD,3,26,12,,,,,,,,1fa11fd8e4ccf23cd88dad0abf8f2ed09692b6f7,2020-03-06T21:00:00Z,,,41,29,29,24,0,0,9,3,12
20200306,MI,0,8,8,,,,,,,,21d52a1d42c23fa0a2597c8982b999e849f6f5ae,2020-03-06T21:00:00Z,,,16,8,8,26,0,0,0,0,0
20200306,MN,0,36,,,,,,,,,e5132c799bd8a985ee5eebaa58cc91fe172d2252,2020-03-06T21:00:00Z,,,36,36,36,27,,,,,
20200306,NC,2,,,,,,,,,,7dc32933c444ad3ead82aae5b70360d952aa26f5,2020-03-06T21:00:00Z,,,2,2,2,37,0,0,0,1,1
20200306,NE,0,17,5,,,,,,,,f6a3dae478e443059d53552df4bcdfcbf1df1562,2020-03-06T21:00:00Z,,,22,17,17,31,0,0,0,0,0
20200306,NH,2,20,3,,,,,,,,cb6d3e65ea48c1b73ea053bd4fff5effe820cd79,2020-03-06T21:00:00Z,,,25,22,22,33,0,0,4,0,4
20200306,NJ,1,,,,,,,,,,c1ebdfb1febe7a106dd31b8742d983a21185c3bf,2020-03-06T21:00:00Z,,,1,1,1,34,0,0,0,0,0
20200306,NM,0,16,0,,,,,,,,a7fdde839cc24edda883ae6eded317516823f0d3,2020-03-06T21:00:00Z,,,16,16,16,35,,,,,
20200306,NV,1,14,,,,,,,,,987c6d506024afbec19c37ec86dbb2f36578a842,2020-03-06T21:00:00Z,,,15,15,15,32,0,0,0,0,0
20200306,NY,33,92,236,,,,,,,,18e7306085561597629e7ffac110572b1aa9f9e5,2020-03-06T21:00:00Z,,,361,125,125,36,0,0,16,11,27
20200306,OH,0,8,2,,,,,,,,053530986545d47250674a6c7891318414ac402d,2020-03-06T21:00:00Z,,,10,8,8,39,0,0,1,0,1
20200306,OR,3,64,28,,,,,,,,8c2cf703264be22af405b67f312c031ee48a2c49,2020-03-06T21:00:00Z,,,95,67,67,41,0,0,19,0,19
20200306,PA,2,,,,,,,,,,3ce04ca60daa0171a4965e6870cd5710345e8669,2020-03-06T21:00:00Z,,,2,2,2,42,,,,,
20200306,SC,0,5,0,,,,,,,,9fa8b0c526fc589b40d7b5af245bc0988d3b9c56,2020-03-06T21:00:00Z,,,5,5,5,45,0,0,0,0,0
20200306,TN,1,,,,,,,,,,c08f2fdfc2a48fde032229c9b4181788db59f9f3,2020-03-06T21:00:00Z,,,1,1,1,47,0,0,0,0,0
20200306,TX,5,,,,,,,,,,cd363e289639a9dfe6b4575b0f64f46900a7901b,2020-03-06T21:00:00Z,,,5,5,5,48,0,0,0,4,4
20200306,VA,0,21,10,,,,,,,,d226abb632c34f9036421499b7f6c7bc248bb483,2020-03-06T21:00:00Z,,,31,21,21,51,0,0,3,0,3
20200306,VT,0,8,,,,,,,,,a4dec17604c465729da7a9dfe9e9ec4426c32672,2020-03-06T21:00:00Z,,,8,8,8,50,,,,,
20200306,WA,79,370,,,,,,,,,acf1e359af09f765bfb51daff2037013e6dcb7ef,2020-03-06T21:00:00Z,14,,449,449,449,53,3,0,370,9,379
20200306,WI,1,31,12,,,,,,,,b96ccd39757d6ceed4a2d639e0095b3d8f8f3434,2020-03-06T21:00:00Z,,,44,32,32,55,0,0,12,0,12
20200306,WV,0,1,4,,,,,,,,68d062b16bb06f20eabeb52ee79544ec7a511018,2020-03-06T21:00:00Z,,,5,1,1,54,,,,,
20200305,AZ,2,28,6,,,,,,,,3e94b739062d1c0306f5279361451cd382171ccf,2020-03-05T21:00:00Z,,,36,30,30,04,0,0,1,0,1
20200305,CA,53,462,,,,,,,,,ce0755ed64d8d97da631569ac60cacb5e301a000,2020-03-05T21:00:00Z,,,515,515,515,06,0,0,0,0,0
20200305,CO,0,19,21,,,,,,,,e45a58fa7b4795ecc217438ff041a6bd2b925fe3,2020-03-05T21:00:00Z,,,40,19,19,08,,,,,
20200305,DC,0,6,2,,,,,,,,86141ea62e1c9a456849cf2f2196a31ac9669154,2020-03-05T21:00:00Z,,,8,6,6,11,,,,,
20200305,FL,9,31,69,,,,,,,,d7d91ffc92fbbfad57ff361b0193d3f7df25b958,2020-03-05T21:00:00Z,,,109,40,40,12,0,0,7,7,14
20200305,GA,2,,,,,,,,,,4247fbf0514b9492027b2328f3f2dc0b2e45f063,2020-03-05T21:00:00Z,,,2,2,2,13,0,0,0,0,0
20200305,IL,5,165,27,,,,,,,,b4c9428d01eee9c65c8053a8cd8af2b28f9d7440,2020-03-05T21:00:00Z,,,197,170,170,17,0,0,41,1,42
20200305,MA,2,,,,,,,,,,ad6e88d352dfa8b8f0dd1bf41a2c506911f25bc0,2020-03-05T21:00:00Z,,,2,2,2,25,0,0,0,0,0
20200305,MD,0,17,14,,,,,,,,0d90494b997e148552cd6034f5f347e1d5afb802,2020-03-05T21:00:00Z,,,31,17,17,24,,,,,
20200305,MI,0,8,0,,,,,,,,dd366e6ea7f02c3c5a0f1f0639f3af9396fd0905,2020-03-05T21:00:00Z,,,8,8,8,26,,,,,
20200305,NC,1,,,,,,,,,,d3f8875e94e71c97de0283327b26f1feca9172e0,2020-03-05T21:00:00Z,,,1,1,1,37,0,0,0,0,0
20200305,NE,0,17,5,,,,,,,,5a0d06bda6fe7a3d859877a222126a595c97fc61,2020-03-05T21:00:00Z,,,22,17,17,31,,,,,
20200305,NH,2,16,4,,,,,,,,7e34f4dacfe1b54e984b2725002f97e08fbae32d,2020-03-05T21:00:00Z,,,22,18,18,33,0,0,6,0,6
20200305,NJ,1,,,,,,,,,,80fa3d5297f9e2b3a46fa82bf816c002d9da0976,2020-03-05T21:00:00Z,,,1,1,1,34,,,,,
20200305,NV,1,14,,,,,,,,,c75ee774e7c6ee7ca098db7e8bdd27109e94471a,2020-03-05T21:00:00Z,,,15,15,15,32,,,,,
20200305,NY,22,76,24,,,,,,,,a5eb1a3c895ee3acd8c87b19363bab6d581b3933,2020-03-05T21:00:00Z,,,122,98,98,36,0,0,28,16,44
20200305,OH,0,7,3,,,,,,,,1bbd3319a4e6db7805828c6b8588392ceb2ad0f0,2020-03-05T21:00:00Z,,,10,7,7,39,,,,,
20200305,OR,3,45,13,,,,,,,,99211bd19ed97ed9d4cf2ff512e5df794b13f3b8,2020-03-05T21:00:00Z,,,61,48,48,41,0,0,16,0,16
20200305,SC,0,5,0,,,,,,,,4ebec78070f45d9a5e6257d3ec1b1c20b6618cb1,2020-03-05T21:00:00Z,,,5,5,5,45,0,0,0,0,0
20200305,TN,1,,,,,,,,,,d6b98cde0f741d1de22a669e2bcbdd2455e12b8a,2020-03-05T21:00:00Z,,,1,1,1,47,,,,,
20200305,TX,1,,,,,,,,,,d7dc50f88fb103b81e0745b9f7824ed7ee6c1738,2020-03-05T21:00:00Z,,,1,1,1,48,0,0,0,0,0
20200305,VA,0,18,3,,,,,,,,c34566b6ec1573923e494c44f1c6b744fed9b3ad,2020-03-05T21:00:00Z,,,21,18,18,51,,,,,
20200305,WA,70,,,,,,,,,,dfe5b036415333cb6e796cd8bde4805a159d6676,2020-03-05T21:00:00Z,11,,70,70,70,53,1,0,0,31,31
20200305,WI,1,19,6,,,,,,,,3620b6a39cef411a89d895ac830c5c954ce63541,2020-03-05T21:00:00Z,,,26,20,20,55,0,0,0,0,0
20200304,AZ,2,27,5,,,,,,,,f9b5336be00388e0549a6e35cfbe7ec911597df2,2020-03-04T21:00:00Z,,,34,29,29,04,,,,,
20200304,CA,53,462,,,,,,,,,e89c69dcaf7f202257af579a58f86c340eee886a,2020-03-04T21:00:00Z,,,515,515,515,06,,,,,
20200304,FL,2,24,16,,,,,,,,827f5f46040136c1b1901fef08f15b03805c57f5,2020-03-04T21:00:00Z,,,42,26,26,12,,,,,
20200304,GA,2,,,,,,,,,,5a4b97663e22df521e97a56f67c3f458eafb2e59,2020-03-04T21:00:00Z,,,2,2,2,13,,,,,
20200304,IL,4,124,27,,,,,,,,c99302904c1de329aeb568cdf92affb6dd5921ad,2020-03-04T21:00:00Z,,,155,128,128,17,,,,,
20200304,MA,2,,,,,,,,,,36d8d4b1b34007477b562a078613309f63e7bd0e,2020-03-04T21:00:00Z,,,2,2,2,25,,,,,
20200304,NC,1,,,,,,,,,,0361de92db7c1867144ce35f0d61e1588f3a13d5,2020-03-04T21:00:00Z,,,1,1,1,37,,,,,
20200304,NH,2,10,7,,,,,,,,57c57bb5f40efbba8ab043701700324b09ac602d,2020-03-04T21:00:00Z,,,19,12,12,33,,,,,
20200304,NY,6,48,24,,,,,,,,0e095e2b3db515b00d892276e6cac6912b1e0111,2020-03-04T21:00:00Z,,,78,54,54,36,,,,,
20200304,OR,3,29,18,,,,,,,,d63f4cf486a6d2f86062b9af1bd46955abd90cb9,2020-03-04T21:00:00Z,,,50,32,32,41,,,,,
20200304,SC,0,5,0,,,,,,,,012fa30a9958580f589eb7d1de5e5a81c327b1a5,2020-03-04T21:00:00Z,,,5,5,5,45,,,,,
20200304,TX,1,,,,,,,,,,d29839e81cae6ba53df2d1a1d7bfeddfd4fc8509,2020-03-04T21:00:00Z,,,1,1,1,48,,,,,
20200304,WA,39,,,,,,,,,,e07bd12171fed21351784c462b0dab23d8cfabbd,2020-03-04T21:00:00Z,10,,39,39,39,53,,,,,
20200304,WI,1,19,6,,,,,,,,c1fede94be9a426dc9c3b5d26d33b9f168fec21c,2020-03-04T21:00:00Z,,,26,20,20,55,,,,,
