date,state,positive,negative,pending,hospitalizedCurrently,hospitalizedCumulative,inIcuCurrently,inIcuCumulative,onVentilatorCurrently,onVentilatorCumulative,recovered,hash,dateChecked,death,hospitalized,total,totalTestResults,posNeg,fips,deathIncrease,hospitalizedIncrease,negativeIncrease,positiveIncrease,totalTestResultsIncrease
20200503,AK,368,21210,,12,,,,,,262,d15bb8087806f8dded75fb6165d7bed1bcface44,2020-05-03T20:00:00Z,9,,21578,21578,21578,02,0,0,176,3,179
20200503,AL,7725,84775,,,1035,,403,,242,,aa4e1102894dd9528461e4d910fab397cc40d31b,2020-05-03T20:00:00Z,290,1035,92500,92500,92500,01,2,12,0,291,291
20200503,AR,3431,49459,,100,427,,,20,88,1999,6b15aab296af49161db3f9fc69eef7c6ca244994,2020-05-03T20:00:00Z,76,427,52890,52890,52890,05,3,13,1249,59,1308
20200503,AS,0,57,,,,,,,,,ccae2e571ac93c5836a22158f57c12313127810d,2020-05-03T20:00:00Z,0,,57,57,57,60,0,0,0,0,0
20200503,AZ,8640,72479,,732,1348,282,,192,,1597,c687661dcf3f892bcc23c38ddcb46fe809b006f1,2020-05-03T20:00:00Z,362,1348,81119,81119,81119,04,14,9,2846,276,3122
20200503,CA,53616,662135,,4734,,1468,,,,,c48cd7f3a2fc14cbcd6027ad29ff314dc9dd66d0,2020-05-03T20:00:00Z,2215,,715751,715751,715751,06,44,0,27529,1419,28948
20200503,CO,16225,63681,,883,2793,,,,,2607,211b7235b427cb61d79d21c2b74c7db00ba1f632,2020-05-03T20:00:00Z,832,2793,79906,79906,79906,08,12,46,2500,457,2957
20200503,CT,29287,73206,,1551,7758,,,,,4346,3800a3df9cf712a1bddb8a0b2e2bcedca1f84965,2020-05-03T20:00:00Z,2436,7758,102493,102493,102493,09,97,0,1713,523,2236
20200503,DC,5016,18086,,,,,,,,666,a957808a1f4431211b5f36cb37fd23812d14ee4a,2020-05-03T20:00:00Z,251,,23102,23102,23102,11,11,0,879,219,1098
20200503,DE,5208,18529,,284,,,,,,1640,091c06f50a876dec3a7caf9dda4e84bd3cd252e8,2020-05-03T20:00:00Z,177,,23737,23737,23737,10,9,0,455,170,625
20200503,FL,36078,392111,1226,,6244,,,,,,0997a62c94edfd6430cf5a434c94e8dd7a5b8dda,2020-05-03T20:00:00Z,1403,6244,429415,428189,428189,12,15,299,11562,615,12177
20200503,GA,28602,146494,,,5393,,1249,,,,777372bee5e5944ecb1adc7f76b0a714adb4846a,2020-05-03T20:00:00Z,1177,5393,175096,175096,175096,13,3,6,0,296,296
20200503,GU,150,3152,,,,,,,,126,30b95889f8675156fd2d1c018c7f0182854b61be,2020-05-03T20:00:00Z,5,,3302,3302,3302,66,0,0,112,2,114
20200503,HI,620,32330,,,72,,,,,541,5111891d5cefc79b879489f9f67935f8fbe9ec6d,2020-05-03T20:00:00Z,16,72,32950,32950,32950,15,0,0,964,1,965
20200503,IA,9169,44017,,378,,133,,93,,3325,ab97ec3db8f39ae41ae0fc2298a0269a49a36a7d,2020-05-03T20:00:00Z,184,,53186,53186,53186,19,9,0,6309,528,6837
20200503,ID,2061,27746,,,200,,83,,,1267,7c61a4f7c93f6c7094bc8c346c6a32a5d0b97cd3,2020-05-03T20:00:00Z,63,200,29807,29807,29807,16,0,22,291,26,317
20200503,IL,61499,257814,,4701,,1232,,759,,,a029a77141da7f336b9535085f081f79079aca96,2020-05-03T20:00:00Z,2618,,319313,319313,319313,17,59,0,16423,2994,19417
20200503,IN,19933,88926,,1398,,476,,242,,,2b45421ee2a67055bea9388ec410ca769cf4e1d0,2020-05-03T20:00:00Z,1246,,108859,108859,108859,18,17,0,4080,638,4718
20200503,KS,5030,31748,,,547,,209,,95,286,76bc626f11816722bfaf9f99b18a8d28efcd4eef,2020-05-03T20:00:00Z,134,547,36778,36778,36778,20,3,6,1552,284,1836
20200503,KY,4879,52770,,334,1411,178,652,,,1752,18dff6431eff75585d8cc30983d0d98cd1f171cb,2020-05-03T20:00:00Z,248,1411,57649,57649,57649,21,0,0,0,0,0
20200503,LA,29340,146820,,1530,,,,213,,17303,5bed468eed255e253b1e9ec757c8e8c6dbbbdc3e,2020-05-03T20:00:00Z,1969,,176160,176160,176160,22,19,0,3102,200,3302
20200503,MA,68087,246559,,3617,6507,904,,,,,096a6fb6940a0a710dbd4f983a996329466e7621,2020-05-03T20:00:00Z,4004,6507,314646,314646,314646,25,158,129,13828,1824,15652
20200503,MD,25462,107332,,1635,5051,565,,,,1666,79e5639796d14f743586499bc9a37e43ce889cfb,2020-05-03T20:00:00Z,1281,5051,132794,132794,132794,24,30,141,6283,989,7272
20200503,ME,1185,19546,,33,183,18,,12,,706,827fa45125ea04c33271df4192e7b568f9be9034,2020-05-03T20:00:00Z,57,183,20731,20731,20731,23,1,2,0,33,33
20200503,MI,43754,168778,,2100,,850,,713,,15659,1fad98e5aa1fcce6c5b18a84fdefda04aef89d89,2020-05-03T20:00:00Z,4049,,212532,212532,212532,26,29,0,10276,547,10823
20200503,MN,6663,75969,,373,1199,155,426,,,3015,b91c8beb580376a4e7570a42a7ab945ea495237e,2020-05-03T20:00:00Z,419,1199,82632,82632,82632,27,24,40,3190,435,3625
20200503,MO,8386,74590,,896,,,,141,,,ed55d3b02ae3d5ab574bc28cde33da16a784430e,2020-05-03T20:00:00Z,352,,82976,82976,82976,29,1,0,0,232,232
20200503,MP,14,1321,,,,,,,,12,73ce9dd05fa5e89c9fa5199caf478f62567e42e9,2020-05-03T20:00:00Z,2,,1335,1335,1335,69,0,0,387,0,387
20200503,MS,7550,70043,,667,1298,143,,73,,3413,6f1b3723940ca6973decfa864d82b5a369570f7e,2020-05-03T20:00:00Z,303,1298,77593,77593,77593,28,12,33,3009,109,3118
20200503,MT,455,14552,,5,61,,,,,404,777659803a4d480b68159bfcc97a8a4eb8597ae0,2020-05-03T20:00:00Z,16,61,15007,15007,15007,30,0,0,372,0,372
20200503,NC,11664,132171,,475,,,,,,,a7499d76a5335929e2e854c57906e029c1744c90,2020-05-03T20:00:00Z,422,,143835,143835,143835,37,2,0,4205,155,4360
20200503,ND,1191,32162,,31,90,,,,,517,d7110dda7cec0e862ede755f0aebfe88d9cda25e,2020-05-03T20:00:00Z,25,90,33353,33353,33353,38,1,0,1768,38,1806
20200503,NE,5326,25936,,,,,,,,,d29081f6b4ce9d80662f0c109a86e0729d4c431b,2020-05-03T20:00:00Z,76,,31262,31262,31262,31,3,0,1426,488,1914
20200503,NH,2429,25964,220,103,277,,,,,1107,91e4eec5f30e084b54423c395d1bb8a4028ecbe4,2020-05-03T20:00:00Z,84,277,28613,28393,28393,33,3,7,3925,119,4044
20200503,NJ,126744,148322,641,5317,,1623,,1198,,15642,bbb28d96a56bf86649f1c544de62977b98c212bb,2020-05-03T20:00:00Z,7871,,275707,275066,275066,34,129,0,9727,3027,12754
20200503,NM,3732,71212,,168,587,,,,,812,4a131c05cf59569cd38deaba752dc86e5705cb5d,2020-05-03T20:00:00Z,139,587,74944,74944,74944,35,8,0,3607,219,3826
20200503,NV,5426,39843,,,,,,,,182,f599d490c2099e10d72b822bf004b794a2e9fcb1,2020-05-03T20:00:00Z,257,,45269,45269,45269,32,3,0,767,115,882
20200503,NY,316415,669496,,9786,68736,,,,,58950,ec3c547c85f0ecd37c161b5888c002b60bbd23aa,2020-05-03T20:00:00Z,19189,68736,985911,985911,985911,36,280,846,23402,3438,26840
20200503,OH,19914,130252,,931,3769,393,1078,255,,,be62eaecc864bff16ddbf00b413eec98d4a4d620,2020-05-03T20:00:00Z,1038,3769,150166,150166,150166,39,17,57,3768,579,4347
20200503,OK,3972,59804,,236,743,92,,,,2635,7eec21e8eefdd1291d6e33e12dd75e0a5b753e1b,2020-05-03T20:00:00Z,238,743,63776,63776,63776,40,0,0,0,121,121
20200503,OR,2680,59374,,205,598,46,,21,,860,0ada7466b613ef4e8abbf8ac8ef76dd58046b055,2020-05-03T20:00:00Z,109,598,62054,62054,62054,41,0,3,1873,45,1918
20200503,PA,49267,191374,,2645,,,,562,,,5111b456b25bcd4a326fa3299298380c4d8094dd,2020-05-03T20:00:00Z,2444,,240641,240641,240641,42,26,0,4303,962,5265
20200503,PR,1808,9313,,,,,,,,,ee02945231fb886f5dfae909f2b58d1a9b41bfaa,2020-05-03T20:00:00Z,97,,11121,11121,11121,72,2,0,0,51,51
20200503,RI,9477,62450,,330,1013,83,,59,,565,d5caac927258a671ede7c57ee4af29c0692a1929,2020-05-03T20:00:00Z,320,1013,71927,71927,71927,44,24,36,1811,188,1999
20200503,SC,6626,57562,,,1110,,,,,3622,2dc5481b837e3ae3e44c52ef529ab37624bd474b,2020-05-03T20:00:00Z,275,1110,64188,64188,64188,45,8,0,2435,137,2572
20200503,SD,2631,15786,,71,197,,,,,1799,b401c38b705fa7cfeabcd76013a8e02baecd0523,2020-05-03T20:00:00Z,21,197,18417,18417,18417,46,0,10,283,43,326
20200503,TN,13177,191430,,,1135,,,,,5814,864f86a081e3bd57579cb573bfbaf02d76a447bf,2020-05-03T20:00:00Z,210,1135,204607,204607,204607,47,1,10,7815,516,8331
20200503,TX,31548,359012,,1540,,,,,,15544,dc130e332bc4cc341b8f8b03f6761a4a5f3dfcec,2020-05-03T20:00:00Z,867,,390560,390560,390560,48,20,0,8886,1026,9912
20200503,UT,5175,116927,,,436,,,,,2238,74212adab19cc3334634f10d7c8144062b81988e,2020-05-03T20:00:00Z,50,436,122102,122102,122102,49,1,18,4104,194,4298
20200503,VA,18671,89331,465,1413,3910,385,,193,,2497,9db4f19705d2220a5214288b29288e9bcbcd1166,2020-05-03T20:00:00Z,660,3910,108467,108002,108002,51,44,172,-6140,940,-5200
20200503,VI,66,951,29,,,,,,,51,b4f681a2afc8e7493bda1eadb71655fadd0c8228,2020-05-03T20:00:00Z,4,,1046,1017,1017,78,0,0,29,0,29
20200503,VT,897,16057,,19,,,,,,,e8209b6e18d5dfe83fdeb0288043212bb8b47812,2020-05-03T20:00:00Z,52,,16954,16954,16954,50,1,0,352,11,363
20200503,WA,15003,192312,,411,,120,,,,,7649033d13f7208c4c040a6645053d5c64f873e7,2020-05-03T20:00:00Z,830,,207315,207315,207315,53,6,0,8225,366,8591
20200503,WI,7964,77997,231,582,1608,118,402,,,3723,a1966f9e9f4b222c652321ec5d16f1274942b30f,2020-05-03T20:00:00Z,339,1608,86192,85961,85961,55,5,17,2427,304,2731
20200503,WV,1191,50447,,73,,28,,15,,611,d49bcbcbe40417152264cd43334a2e4dde7bea0a,2020-05-03T20:00:00Z,50,,51638,51638,51638,54,2,0,2470,22,2492
20200503,WY,579,9640,,13,60,,,,,391,74d760a77a8e6611475c6bcf50d191f717460b83,2020-05-03T20:00:00Z,7,60,10219,10219,10219,56,0,2,177,13,190
20200502,AK,365,21034,,10,,,,,,261,8915b2653b57fc004eaa5369881343ee1f984aa8,2020-05-02T20:00:00Z,9,,21399,21399,21399,02,0,0,1073,1,1074
20200502,AL,7434,84775,,,1023,,335,,195,,884ad5ab757f3861f3c36c9eef2e2c0b64d855f1,2020-05-02T20:00:00Z,288,1023,92209,92209,92209,01,9,15,0,276,276
20200502,AR,3372,48210,,95,414,,,20,85,1987,1899b014ba10b1308db7840e2478b1d9921c10af,2020-05-02T20:00:00Z,73,414,51582,51582,51582,05,9,0,1855,51,1906
20200502,AS,0,57,,,,,,,,,29106909f7aae107663c3942d63c79cd882acc89,2020-05-02T20:00:00Z,0,,57,57,57,60,0,0,0,0,0
20200502,AZ,8364,69633,,718,1339,291,,198,,1565,0eed79b0025a0cc44b30dfb01e4b3bb5a1148a5c,2020-05-02T20:00:00Z,348,1339,77997,77997,77997,04,18,136,2716,402,3118
20200502,CA,52197,634606,,4722,,1433,,,,,cdcd836d3f2948fcbdde32fb8efbae6bbeb2a69e,2020-05-02T20:00:00Z,2171,,686803,686803,686803,06,98,0,30063,1755,31818
20200502,CO,15768,61181,,931,2747,,,,,2553,065f53cbf418983ed19268484dea3198f7b125bf,2020-05-02T20:00:00Z,820,2747,76949,76949,76949,08,43,50,4075,484,4559
20200502,CT,28764,71493,,1592,7758,,,,,4346,f4f059cb7a023a48adc3b690a907ef83b83f7d1f,2020-05-02T20:00:00Z,2339,7758,100257,100257,100257,09,0,0,0,0,0
20200502,DC,4797,17207,,,,,,,,666,722c6a01ad5944719fd647c08bd7a7717dbf5b2e,2020-05-02T20:00:00Z,240,,22004,22004,22004,11,9,0,730,139,869
20200502,DE,5038,18074,,300,,,,,,1546,2ab2471592f3fbca26321a81492a2b938b532d1c,2020-05-02T20:00:00Z,168,,23112,23112,23112,10,9,0,407,120,527
20200502,FL,35463,380549,,,5945,,,,,,c20690bb991d4da1bddb716969ccfa53a453b59f,2020-05-02T20:00:00Z,1388,5945,416012,416012,416012,12,74,150,12578,735,13313
20200502,GA,28306,146494,,,5387,,1247,,,,517195ec926271fe90f47196d866dfd0a69267ed,2020-05-02T20:00:00Z,1174,5387,174800,174800,174800,13,20,118,5397,1036,6433
20200502,GU,148,3040,,,,,,,,131,a1d0aadbaf5094d3a604a69ca9368231ebe064d8,2020-05-02T20:00:00Z,5,,3188,3188,3188,66,0,0,181,2,183
20200502,HI,619,31366,,,72,,,,,532,0263c48df92747a76270ec5f04e8830a4deaf6e4,2020-05-02T20:00:00Z,16,72,31985,31985,31985,15,0,2,890,1,891
20200502,IA,8641,37708,,353,,131,,90,,3156,ed17f22a89d1b3cda764d3d2d25cfeabf4b5c191,2020-05-02T20:00:00Z,175,,46349,46349,46349,19,5,0,0,757,757
20200502,ID,2035,27455,,,178,,76,,,1215,2229b029f548e38537d5a305b6a25429cf761eaa,2020-05-02T20:00:00Z,63,178,29490,29490,29490,16,0,0,245,20,265
20200502,IL,58505,241391,,4717,,1250,,789,,,2a3dbca0ccefc372d1e390b6a935f7cce0bd7a84,2020-05-02T20:00:00Z,2559,,299896,299896,299896,17,102,0,12758,2450,15208
20200502,IN,19295,84846,,1456,,487,,244,,,1a8cd04e3a50a050e4070f9dc912c6210356485a,2020-05-02T20:00:00Z,1229,,104141,104141,104141,18,54,0,3837,665,4502
20200502,KS,4746,30196,,,541,,206,,95,286,d7909e12df5722cd6b00d7c32994875786162173,2020-05-02T20:00:00Z,131,541,34942,34942,34942,20,1,7,1611,297,1908
20200502,KY,4879,52770,,334,1411,178,652,,,1752,eab0626d70e347267d66b6b0a312b9cd55809188,2020-05-02T20:00:00Z,248,1411,57649,57649,57649,21,8,36,866,171,1037
20200502,LA,29140,143718,,1545,,,,208,,17303,6ccf32bd8398973e6411080fed6477626ccfcb58,2020-05-02T20:00:00Z,1950,,172858,172858,172858,22,23,0,4178,429,4607
20200502,MA,66263,232731,,3601,6378,921,,,,,c404a96f8e0a32a0e3bb3f337cea02dffc854ee0,2020-05-02T20:00:00Z,3846,6378,298994,298994,298994,25,130,209,7406,1952,9358
20200502,MD,24473,101049,,1657,4910,566,,,,1590,dcbc10201aa9817d42abc75396311ef10c0f8f4e,2020-05-02T20:00:00Z,1251,4910,125522,125522,125522,24,59,192,3538,1001,4539
20200502,ME,1152,19546,,36,181,19,,10,,689,7e3619c899147db3022fcbc9a8ab4da16beb73e8,2020-05-02T20:00:00Z,56,181,20698,20698,20698,23,1,4,0,29,29
20200502,MI,43207,158502,,2100,,850,,713,,15659,f18289a1ca4628e3c92d83e9f8c8eb2421761fc2,2020-05-02T20:00:00Z,4020,,201709,201709,201709,26,154,0,10353,851,11204
20200502,MN,6228,72779,,389,1159,135,404,,,2397,cd932ccccc02cefc20a08803e74a0cc421005bc3,2020-05-02T20:00:00Z,395,1159,79007,79007,79007,27,24,63,3680,498,4178
20200502,MO,8154,74590,,896,,,,141,,,5d91d52d238e224e1701f12b059257512e8aa32b,2020-05-02T20:00:00Z,351,,82744,82744,82744,29,14,0,0,319,319
20200502,MP,14,934,,,,,,,,12,1e3cf4eed75e3359a3696d318435e1c6787294e6,2020-05-02T20:00:00Z,2,,948,948,948,69,0,0,185,0,185
20200502,MS,7441,67034,,632,1265,142,,71,,3413,324a3ec14a9fa96125226803e6f13a031f337d6f,2020-05-02T20:00:00Z,291,1265,74475,74475,74475,28,10,39,2698,229,2927
20200502,MT,455,14180,,5,61,,,,,404,e119f4ea8f8ee1fd1f3ea144c1dc6673485bce38,2020-05-02T20:00:00Z,16,61,14635,14635,14635,30,0,0,430,2,432
20200502,NC,11509,127966,,502,,,,,,,959d64e6f77bfb33d06f4cf57371edb604c42c9a,2020-05-02T20:00:00Z,420,,139475,139475,139475,37,21,0,5057,586,5643
20200502,ND,1153,30394,,32,90,,,,,510,8e97db2be523df23ca5167835506a368dd39c145,2020-05-02T20:00:00Z,24,90,31547,31547,31547,38,1,4,1976,46,2022
20200502,NE,4838,24510,,,,,,,,,aea5e40050f0173c357eb6690a3f096a75c39952,2020-05-02T20:00:00Z,73,,29348,29348,29348,31,3,0,1406,557,1963
20200502,NH,2310,22039,159,103,270,,,,,980,47b2919e9a6e47ec81ab5308fb5acf13eec2fdae,2020-05-02T20:00:00Z,81,270,24508,24349,24349,33,9,8,2136,164,2300
20200502,NJ,123717,138595,676,5713,,1715,,1230,,15642,3bf57590e4bc42b23b19adc37b83f9a2442deed1,2020-05-02T20:00:00Z,7742,,262988,262312,262312,34,204,0,3240,2527,5767
20200502,NM,3513,67605,,159,587,,,,,785,f4e293d6366aebda6444a3b91fbebeff161711b4,2020-05-02T20:00:00Z,131,587,71118,71118,71118,35,8,51,3147,102,3249
20200502,NV,5311,39076,,,,,,,,182,569ca2c7c2da2a7ac6f01a3f6c35b2a9ed7b534b,2020-05-02T20:00:00Z,254,,44387,44387,44387,32,11,0,708,84,792
20200502,NY,312977,646094,,10350,67890,,,,,57540,2fc5fe89aacccbac703dcb56bd0e841887f06bbc,2020-05-02T20:00:00Z,18909,67890,959071,959071,959071,36,299,710,26970,4663,31633
20200502,OH,19335,126484,,1003,3712,424,1066,267,,,1424cfdcb39530af6e025b5ab918a6c713b78c1d,2020-05-02T20:00:00Z,1021,3712,145819,145819,145819,39,19,78,4721,592,5313
20200502,OK,3851,59804,,236,743,92,,,,2554,02223f054e78abe2b2268d368f021a99f55bad06,2020-05-02T20:00:00Z,238,743,63655,63655,63655,40,8,28,0,103,103
20200502,OR,2635,57501,,209,595,50,,22,,,1e7172ad8335fe75b138259c9eb48a81c12bdba9,2020-05-02T20:00:00Z,109,595,60136,60136,60136,41,5,4,1904,56,1960
20200502,PA,48305,187071,,2673,,,,571,,,589d97b93bc2e68f22fbc913102fb4bd7c81d171,2020-05-02T20:00:00Z,2418,,235376,235376,235376,42,64,0,6594,1334,7928
20200502,PR,1757,9313,,,,,,,,,de539068767c44b8f3d775a69ba4c665c6e46d28,2020-05-02T20:00:00Z,95,,11070,11070,11070,72,3,0,0,182,182
20200502,RI,9289,60639,,333,977,80,,54,,531,faa717ce7b5ec80cf6bd9b1dcd1acfd6cf837d1e,2020-05-02T20:00:00Z,296,977,69928,69928,69928,44,17,40,2953,327,3280
20200502,SC,6489,55127,,,1110,,,,,3622,308b5a0b0f04d1b13ac8a1ca3793f52f572f7fd2,2020-05-02T20:00:00Z,267,1110,61616,61616,61616,45,11,0,2006,231,2237
20200502,SD,2588,15503,,71,187,,,,,1759,0e595d182f937c1905d87f011763140a96b29f9e,2020-05-02T20:00:00Z,21,187,18091,18091,18091,46,0,8,665,63,728
20200502,TN,12661,183615,,,1125,,,,,5718,aaf30d6bc8f1f2966b6101418ed5ea398d951410,2020-05-02T20:00:00Z,209,1125,196276,196276,196276,47,5,12,9374,770,10144
20200502,TX,30522,350126,,1725,,,,,,14891,005b7769935fc76fada195d85f1b8a1e357cd8a5,2020-05-02T20:00:00Z,847,,380648,380648,380648,48,31,0,27580,1293,28873
20200502,UT,4981,112823,,,418,,,,,2185,4fe0d0aa858aa85fcc5d75bc80a12d8b8d63cca8,2020-05-02T20:00:00Z,49,418,117804,117804,117804,49,3,15,5093,153,5246
20200502,VA,17731,95471,458,1426,3738,375,,202,,2312,b3cf5aa0aec79e75dd8b42d97bf8726e1fdba293,2020-05-02T20:00:00Z,616,3738,113660,113202,113202,51,35,84,6724,830,7554
20200502,VI,66,922,54,,,,,,,51,57ddc0eb633f35329467603e458b1ad184d27211,2020-05-02T20:00:00Z,4,,1042,988,988,78,0,0,111,0,111
20200502,VT,886,15705,,11,,,,,,,07ffe0b903ace9914c005a3bcc7df3454a8f71bf,2020-05-02T20:00:00Z,51,,16591,16591,16591,50,1,0,351,7,358
20200502,WA,14637,184087,,428,,117,,,,,53591fc3887e1d07c8a4d497addae74605362cb4,2020-05-02T20:00:00Z,824,,198724,198724,198724,53,10,0,4433,310,4743
20200502,WI,7660,75570,231,582,1591,118,400,,,3698,8788718aa6379d5902a0cce68eec28c4e316bc9b,2020-05-02T20:00:00Z,334,1591,83461,83230,83230,55,7,47,3004,346,3350
20200502,WV,1169,47977,,76,,29,,15,,572,7598d7830fe0d88394f96b29819ef7904eed5093,2020-05-02T20:00:00Z,48,,49146,49146,49146,54,2,0,2269,33,2302
20200502,WY,566,9463,,13,58,,,,,387,ff12d02f27f62db0b2e74fa659a751acd0d18849,2020-05-02T20:00:00Z,7,58,10029,10029,10029,56,0,2,327,7,334
20200501,AK,364,19961,,25,,,,,,254,866cdb1cdd68e3d57576eb803cc5d7cf5be70f15,2020-05-01T20:00:00Z,9,,20325,20325,20325,02,0,0,1197,9,1206
20200501,AL,7158,84775,,,1008,,335,,195,,db92a61950477b955b7f9bb4dd6d8ee95f8ebcd0,2020-05-01T20:00:00Z,279,1008,91933,91933,91933,01,10,30,4598,139,4737
20200501,AR,3321,46355,,95,414,,,23,85,1973,071e6a9ca0a17eeae7497c8d9556ad40dfabc387,2020-05-01T20:00:00Z,64,414,49676,49676,49676,05,3,12,1231,66,1297
20200501,AS,0,57,,,,,,,,,f7185e057ece78f8eb117e5ce511eaa78eb2585a,2020-05-01T20:00:00Z,0,,57,57,57,60,0,0,54,0,54
20200501,AZ,7962,66917,,709,1203,311,,187,,1528,fbf09afacdcfc76ac137e1b5a6ffa9e820f9aebf,2020-05-01T20:00:00Z,330,1203,74879,74879,74879,04,10,34,2779,314,3093
20200501,CA,50442,604543,,4706,,1434,,,,,47e841c9f2fad0f6e846c6bb57794423e55ff7af,2020-05-01T20:00:00Z,2073,,654985,654985,654985,06,91,0,28123,1525,29648
20200501,CO,15284,57106,,959,2697,,,,,2486,e3247b2fc87d89899d941713f62d23a8e20d573b,2020-05-01T20:00:00Z,777,2697,72390,72390,72390,08,11,76,805,526,1331
20200501,CT,28764,71493,,1592,7758,,,,,4346,360df6002db8cb55bd24b10ada2266daf79f1ef2,2020-05-01T20:00:00Z,2339,7758,100257,100257,100257,09,82,7758,2060,1064,3124
20200501,DC,4658,16477,,,,,,,,666,06be531c53b69d6b6c77ee64b5b9a47ffb772cfb,2020-05-01T20:00:00Z,231,,21135,21135,21135,11,7,0,721,335,1056
20200501,DE,4918,17667,,281,,,,,,1403,852a8a304a110c8f3174fb155c79acc440ab6a6e,2020-05-01T20:00:00Z,159,,22585,22585,22585,10,7,0,581,184,765
20200501,FL,34728,367971,,,5795,,,,,,e6d29a0b9429c1ae6d243a3cc9ad386d0d5064cc,2020-05-01T20:00:00Z,1314,5795,402699,402699,402699,12,24,0,19256,1038,20294
20200501,GA,27270,141097,,,5269,,1215,,,,33b8c94a334a7f3a7ba505afcee1406b35570d39,2020-05-01T20:00:00Z,1154,5269,168367,168367,168367,13,34,113,18208,1115,19323
20200501,GU,146,2859,,,,,,,,131,76d7a9a90008e96c94d9c485c70c91fcf5bba420,2020-05-01T20:00:00Z,5,,3005,3005,3005,66,0,0,897,0,897
20200501,HI,618,30476,,,70,,,,,526,f6ff4036a49192436393354606e21ec017941492,2020-05-01T20:00:00Z,16,70,31094,31094,31094,15,0,1,449,5,454
20200501,IA,7884,37708,,345,,121,,91,,2899,947ce84099cf7a235f55c6ec9139c568aff26ba3,2020-05-01T20:00:00Z,170,,45592,45592,45592,19,8,0,2186,739,2925
20200501,ID,2015,27210,,,178,,75,,,1175,499d2a365b879606fc315e54f98851e264820908,2020-05-01T20:00:00Z,63,178,29225,29225,29225,16,3,3,501,31,532
20200501,IL,56055,228633,,4900,,1263,,777,,,76e75020ebd41f20b83876c163774035b1d1f68b,2020-05-01T20:00:00Z,2457,,284688,284688,284688,17,102,0,11684,3137,14821
20200501,IN,18630,81009,,1431,,514,,257,,,2fb87457d5dac719c2ac0995c56295feceecf224,2020-05-01T20:00:00Z,1175,,99639,99639,99639,18,61,0,3846,795,4641
20200501,KS,4449,28585,,,534,,206,,96,280,d32563d4b94f19179fda50e518b4b4451fb7643c,2020-05-01T20:00:00Z,130,534,33034,33034,33034,20,1,11,1197,211,1408
20200501,KY,4708,51904,,330,1375,178,642,,,1675,61da377ebe0cbf53b1b900e478bdf81be4dbec16,2020-05-01T20:00:00Z,240,1375,56612,56612,56612,21,5,16,2342,169,2511
20200501,LA,28711,139540,,1607,,,,230,,17303,f92c617aff82cecf8169e6fdfef6e66044d518ae,2020-05-01T20:00:00Z,1927,,168251,168251,168251,22,65,0,6232,710,6942
20200501,MA,64311,225325,,3716,6169,947,,,,,4bedeab225e7c054854c8c49222b0d98661c47e4,2020-05-01T20:00:00Z,3716,6169,289636,289636,289636,25,154,227,11883,2106,13989
20200501,MD,23472,97511,,1668,4718,568,,,,1517,6f3d7561a691a393a0828135f31b1f7197690789,2020-05-01T20:00:00Z,1192,4718,120983,120983,120983,24,52,159,4894,1730,6624
20200501,ME,1123,19546,,37,177,17,,9,,657,d9bc84de11a726df51c3dc40e14d2319768b15e5,2020-05-01T20:00:00Z,55,177,20669,20669,20669,23,2,7,0,28,28
20200501,MI,42356,148149,,2319,,966,,760,,8342,23a13755d3838194164378c2ddff31937ea4a240,2020-05-01T20:00:00Z,3866,,190505,190505,190505,26,77,0,9261,977,10238
20200501,MN,5730,69099,,369,1096,118,380,,,2282,770b5d70e5d2c28e7dd31406fda38a66674a11f0,2020-05-01T20:00:00Z,371,1096,74829,74829,74829,27,28,52,3959,594,4553
20200501,MO,7835,74590,,883,,,,137,,,77bae1cd8fe92a10b390dd3f6d3e83e12bb19cfd,2020-05-01T20:00:00Z,337,,82425,82425,82425,29,8,0,1465,273,1738
20200501,MP,14,749,,,,,,,,12,b4c2144e7c59c3aa0944ea07705b0c38a66c0f05,2020-05-01T20:00:00Z,2,,763,763,763,69,0,0,164,0,164
20200501,MS,7212,64336,,651,1226,160,,75,,3413,326ff79bfb063fd6068cd515d209f6eb1d00aeb2,2020-05-01T20:00:00Z,281,1226,71548,71548,71548,28,20,51,4811,397,5208
20200501,MT,453,13750,,5,61,,,,,397,8a5bc41a3630f3b87f1fcf4ebf1795d41ab1b41b,2020-05-01T20:00:00Z,16,61,14203,14203,14203,30,0,0,289,0,289
20200501,NC,10923,122909,,547,,,,,,,a3c2fb2312994ae51b89bf0936266a34d87d0e26,2020-05-01T20:00:00Z,399,,133832,133832,133832,37,21,0,5382,414,5796
20200501,ND,1107,28418,,27,86,,,,,482,694d83f4b959faf9b1c873edf866f03f36734a92,2020-05-01T20:00:00Z,23,86,29525,29525,29525,38,4,1,2025,40,2065
20200501,NE,4281,23104,,,,,,,,,f9f9bbe4ae4970fd58a1e99ca5d3cf005643649e,2020-05-01T20:00:00Z,70,,27385,27385,27385,31,2,0,1567,497,2064
20200501,NH,2146,19903,302,112,262,,,,,980,83ad58b21639cf7895582a76dd5eeec94072c0f0,2020-05-01T20:00:00Z,72,262,22351,22049,22049,33,6,3,36,92,128
20200501,NJ,121190,135355,583,5972,,1724,,1286,,15642,74f5c8c358fdc8d647f80edfd05d3ceff4842d41,2020-05-01T20:00:00Z,7538,,257128,256545,256545,34,310,0,6089,2538,8627
20200501,NM,3411,64458,,172,536,,,,,760,85766dc067e66f8da5342e6e54959f0d816740d9,2020-05-01T20:00:00Z,123,536,67869,67869,67869,35,11,0,2586,198,2784
20200501,NV,5227,38368,,,,,,,,182,3f34a96d819ede1db3d81c5cc1309ebc651031ba,2020-05-01T20:00:00Z,243,,43595,43595,43595,32,6,0,1380,229,1609
20200501,NY,308314,619124,,10993,67180,,,,,56187,1040a50dcd205824d909fee1957f07e1f0624cae,2020-05-01T20:00:00Z,18610,67180,927438,927438,927438,36,289,811,22860,3942,26802
20200501,OH,18743,121763,,,3634,,1056,,,,955a3376ddd26b76485da8840af1281780b00c0b,2020-05-01T20:00:00Z,1002,3634,140506,140506,140506,39,27,101,5900,716,6616
20200501,OK,3748,59804,,255,715,113,,,,2467,ee2ac4c88066f5b4cd96564eec31ee22b2632246,2020-05-01T20:00:00Z,230,715,63552,63552,63552,40,8,12,0,130,130
20200501,OR,2579,55597,,208,591,49,,23,,,62d650de76410a635d6f8fc182364df0f3a369a6,2020-05-01T20:00:00Z,104,591,58176,58176,58176,41,1,13,2075,69,2144
20200501,PA,46971,180477,,2683,,,,590,,,63dba92bf2a5f401ffdf185ae9d51628132e8d99,2020-05-01T20:00:00Z,2354,,227448,227448,227448,42,62,0,4875,1208,6083
20200501,PR,1575,9313,,,,,,,,,2f0f7ac2733ff39cb5d184d2efa679b572d3b6b4,2020-05-01T20:00:00Z,92,,10888,10888,10888,72,0,0,0,36,36
20200501,RI,8962,57686,,352,937,76,,51,,485,b6dc9871f69ab1f13c2e8aea8b14336941e76d3b,2020-05-01T20:00:00Z,279,937,66648,66648,66648,44,13,41,2597,341,2938
20200501,SC,6258,53121,,,1110,,,,,3622,8258efc898516f6fce4130983a6c7f35fe5e6196,2020-05-01T20:00:00Z,256,1110,59379,59379,59379,45,12,110,2704,163,2867
20200501,SD,2525,14838,,69,179,,,,,1686,e08bfaa69b7880a3c245f2bc69df0496f95703a7,2020-05-01T20:00:00Z,21,179,17363,17363,17363,46,4,6,259,76,335
20200501,TN,11891,174241,,,1113,,,,,5546,fbce2911ced0bfb999646b200379f802b2e9b922,2020-05-01T20:00:00Z,204,1113,186132,186132,186132,47,9,100,16058,1525,17583
20200501,TX,29229,322546,,1778,,,,,,14122,ad8c35afbe199853db1a7f148c79c8d9ae91ccb1,2020-05-01T20:00:00Z,816,,351775,351775,351775,48,34,0,20333,1142,21475
20200501,UT,4828,107730,,,403,,,,,2062,e8779ffd446f06ceb78905c8d0f3142fb13c78d1,2020-05-01T20:00:00Z,46,403,112558,112558,112558,49,0,13,3901,156,4057
20200501,VA,16901,88747,468,1431,3654,366,,193,,2196,195b6b0392ceb0b7acb785a8f4eccab4264f7026,2020-05-01T20:00:00Z,581,3654,106116,105648,105648,51,29,0,13084,1055,14139
20200501,VI,66,811,68,,,,,,,51,e1f3b895eb5ae085c96ced72c2012de714b5f4cf,2020-05-01T20:00:00Z,4,,945,877,877,78,0,0,4,0,4
20200501,VT,879,15354,,19,,,,,,,95d41bf5d7f34b2e23809b9f0dca2499ec91d416,2020-05-01T20:00:00Z,50,,16233,16233,16233,50,1,0,568,13,581
20200501,WA,14327,179654,,470,,120,,,,,cc3187e494257d1bcfe38de1e800e7c2fd61bbeb,2020-05-01T20:00:00Z,814,,193981,193981,193981,53,13,0,5924,257,6181
20200501,WI,7314,72566,218,560,1544,127,391,,,3352,98d8626b8fbd4ef7caec5d9236c97c2b73c71936,2020-05-01T20:00:00Z,327,1544,80098,79880,79880,55,11,32,3172,460,3632
20200501,WV,1136,45708,,81,,33,,18,,555,002aa67e5e412dcae7ee0483fa3caf7889d4ce6c,2020-05-01T20:00:00Z,46,,46844,46844,46844,54,5,0,2285,18,2303
20200501,WY,559,9136,,13,56,,,,,373,c295e3312ab8824563ff0ff9a364ca2aeb917294,2020-05-01T20:00:00Z,7,56,9695,9695,9695,56,0,0,234,15,249
20200430,AK,355,18764,,19,,,,,,252,78605f774dcba587c8b24512354a3830ef3b5e4f,2020-04-30T20:00:00Z,9,,19119,19119,19119,02,0,0,0,0,0
20200430,AL,7019,80177,,,978,,335,,195,,47546b95299bd673c18e27d5284d7ba75b362464,2020-04-30T20:00:00Z,269,978,87196,87196,87196,01,24,33,6570,177,6747
20200430,AR,3255,45124,,95,402,,,23,85,1305,8f880ed4454e1fc3bbeff4b0655314f8878cbe22,2020-04-30T20:00:00Z,61,402,48379,48379,48379,05,2,13,2867,63,2930
20200430,AS,0,3,17,,,,,,,,14c16072106c6d59a534dfcbd590ca14f42e4a7f,2020-04-30T20:00:00Z,0,,20,3,3,60,0,0,0,0,0
20200430,AZ,7648,64138,,755,1169,311,,194,,1499,eb3be7d08e6c0e46e5aa79eb92b2da29f2e6dc13,2020-04-30T20:00:00Z,320,1169,71786,71786,71786,04,16,38,2527,446,2973
20200430,CA,48917,576420,,4981,,1473,,,,,c7ce1d5139d266f5288852a7459f68b1844f7669,2020-04-30T20:00:00Z,1982,,625337,625337,625337,06,95,0,19781,2417,22198
20200430,CO,14758,56301,,966,2621,,,,,2415,a73e7ba81f00367d2f86a71ecffd065d46405bb7,2020-04-30T20:00:00Z,766,2621,71059,71059,71059,08,6,11,1587,23,1610
20200430,CT,27700,69433,,1650,,,,,,,8c982109251aeeb06276f4d206d17f63e48fd061,2020-04-30T20:00:00Z,2257,,97133,97133,97133,09,89,0,1382,933,2315
20200430,DC,4323,15756,,,,,,,,660,f83232cd2dc5b3dc946ed4e96bbb47bcbe2b9ee7,2020-04-30T20:00:00Z,224,,20079,20079,20079,11,19,0,633,217,850
20200430,DE,4734,17086,,296,,,,,,1275,53cb88f60dbb28089a1b59e5e6720bad1632b50c,2020-04-30T20:00:00Z,152,,21820,21820,21820,10,8,0,203,79,282
20200430,FL,33690,348715,1187,,5795,,,,,,0ab34c1effbbf79f11fcf5cdbe3bddd988da96c4,2020-04-30T20:00:00Z,1290,5795,383592,382405,382405,12,50,171,8420,497,8917
20200430,GA,26155,122889,,,5156,,1171,,,,a92f06545bd7268404aa042e63dfc9ac978c167e,2020-04-30T20:00:00Z,1120,5156,149044,149044,149044,13,27,100,4522,583,5105
20200430,GU,146,1962,,,,,,,,131,5121c826a9db554e688ff1dae22309e3dea2105d,2020-04-30T20:00:00Z,5,,2108,2108,2108,66,0,0,260,1,261
20200430,HI,613,30027,,,69,,,,,516,68f73080c79f2e818df1413c54fd4a538abcd024,2020-04-30T20:00:00Z,16,69,30640,30640,30640,15,0,0,1018,4,1022
20200430,IA,7145,35522,,335,,121,,86,,2697,d2f338abcdcba2e0fa0f8220d51dcce6426878ef,2020-04-30T20:00:00Z,162,,42667,42667,42667,19,14,0,1028,302,1330
20200430,ID,1984,26709,,,175,,74,,,1121,d71ed4874cca182a42af73f00646d42c7a57319e,2020-04-30T20:00:00Z,60,175,28693,28693,28693,16,0,2,279,32,311
20200430,IL,52918,216949,,4953,,1289,,785,,,2489b07c476ea4d77b5eaea38473635ac495e7cb,2020-04-30T20:00:00Z,2355,,269867,269867,269867,17,140,0,10637,2563,13200
20200430,IN,17835,77163,,1466,,549,,275,,,c8fc886c42fd5f1aa0265d49def26d5bab2ccd40,2020-04-30T20:00:00Z,1114,,94998,94998,94998,18,49,0,2795,653,3448
20200430,KS,4238,27388,,,523,,201,,93,272,d3fd4b03deea5bba50128f2f4d0d4a63afa86279,2020-04-30T20:00:00Z,129,523,31626,31626,31626,20,4,8,1668,500,2168
20200430,KY,4539,49562,,325,1359,176,636,,,1668,fc2749c93869fe4e96d209c6c1182224d77c822d,2020-04-30T20:00:00Z,235,1359,54101,54101,54101,21,10,28,1526,164,1690
20200430,LA,28001,133308,,1601,,,,231,,17303,ffbb44fa1709b3abef868f24a275396faba60e7e,2020-04-30T20:00:00Z,1862,,161309,161309,161309,22,17,0,4400,341,4741
20200430,MA,62205,213442,,3803,5942,1001,,,,,ac1043e15211b556b436230afb570d66d9bceecb,2020-04-30T20:00:00Z,3562,5942,275647,275647,275647,25,157,184,8089,1940,10029
20200430,MD,21742,92617,,1711,4559,590,,,,1432,fa502dee7c8cbe46804af0defd12dbf758dcc824,2020-04-30T20:00:00Z,1140,4559,114359,114359,114359,24,62,157,2537,893,3430
20200430,ME,1095,19546,,35,170,18,,8,,631,23f1898280efec4d0b4076972e17e3f681a230e3,2020-04-30T20:00:00Z,53,170,20641,20641,20641,23,1,4,0,39,39
20200430,MI,41379,138888,,2319,,966,,760,,8342,149b21fba0b816940d8f1d805c7d771098862770,2020-04-30T20:00:00Z,3789,,180267,180267,180267,26,119,0,6935,980,7915
20200430,MN,5136,65140,,365,1044,130,358,,,2172,c7877029a20338b92d95de76241cd6ce5340cba3,2020-04-30T20:00:00Z,343,1044,70276,70276,70276,27,24,94,3040,492,3532
20200430,MO,7562,73125,,853,,,,141,,,1a1abf5fe35f84bd58987ce3da1043a33be0ade6,2020-04-30T20:00:00Z,329,,80687,80687,80687,29,11,0,3391,137,3528
20200430,MP,14,585,,,,,,,,12,12c10f837dc9313d38df05f0595c91dfc3ef3c5f,2020-04-30T20:00:00Z,2,,599,599,599,69,0,0,375,0,375
20200430,MS,6815,59525,,639,1175,146,,72,,3413,3f09500f410c91d7dc257328084b9ec390bc2227,2020-04-30T20:00:00Z,261,1175,66340,66340,66340,28,11,49,0,246,246
20200430,MT,453,13461,,5,61,,,,,392,ede571e0cd4fa0c8ff04aa378c8d454f50dd7673,2020-04-30T20:00:00Z,16,61,13914,13914,13914,30,0,0,384,2,386
20200430,NC,10509,117527,,546,,,,,,,4235c99087b569be0ac54dcf137873aa012f6e91,2020-04-30T20:00:00Z,378,,128036,128036,128036,37,24,0,9035,561,9596
20200430,ND,1067,26393,,30,85,,,,,458,1f46447d3fb2a9fda5467bd5fd8abc6c15bd4bc4,2020-04-30T20:00:00Z,19,85,27460,27460,27460,38,0,3,1890,34,1924
20200430,NE,3784,21537,,,,,,,,,4c3f00c49659fc9da7f9eb8b16c566b832c74e9f,2020-04-30T20:00:00Z,68,,25321,25321,25321,31,13,0,1280,410,1690
20200430,NH,2054,19867,272,107,259,,,,,980,928262a0f857adc58b625885e944701b337a5740,2020-04-30T20:00:00Z,66,259,22193,21921,21921,33,6,10,1131,44,1175
20200430,NJ,118652,129266,478,6137,,1765,,1271,,15642,74e1d6c3ef9bb531214d50c4a164368246069cd4,2020-04-30T20:00:00Z,7228,,248396,247918,247918,34,458,0,4212,2388,6600
20200430,NM,3213,61872,,163,536,,,,,734,7d0282c78697eeb054805d8a2ca490a6be75afc8,2020-04-30T20:00:00Z,112,536,65085,65085,65085,35,2,27,3101,239,3340
20200430,NV,4998,36988,,,,,,,,158,8d0701d65c361ee64efa4657e9ccf99ae82c4af1,2020-04-30T20:00:00Z,237,,41986,41986,41986,32,7,0,858,100,958
20200430,NY,304372,596264,,11598,66369,,,,,54771,f8f20b366bc8b2b7ce1563f458cca342c543a475,2020-04-30T20:00:00Z,18321,66369,900636,900636,900636,36,306,972,23474,4681,28155
20200430,OH,18027,115863,,,3533,,1035,,,,b15d27271332817abe9e8f2685a69eeb5c8bea6e,2020-04-30T20:00:00Z,975,3533,133890,133890,133890,39,38,112,4258,724,4982
20200430,OK,3618,59804,,291,703,127,,,,2401,c5b57e198c97986bfd126eea9f46b8d6ff675320,2020-04-30T20:00:00Z,222,703,63422,63422,63422,40,8,10,2010,145,2155
20200430,OR,2510,53522,,243,578,65,,28,,,66ce1bbd5082fed98e37feb59ed2a586ab910abc,2020-04-30T20:00:00Z,103,578,56032,56032,56032,41,2,9,1496,64,1560
20200430,PA,45763,175602,,2707,,,,556,,,4aab899cab9dcd24be2bdca962618e9dac96ab33,2020-04-30T20:00:00Z,2292,,221365,221365,221365,42,97,0,5085,1397,6482
20200430,PR,1539,9313,,,,,,,,,b543f5061c456bb0148d21dc907c06b5e6c4a5df,2020-04-30T20:00:00Z,92,,10852,10852,10852,72,6,0,0,106,106
20200430,RI,8621,55089,,339,896,85,,54,,461,4bfc8df6d3207e426f46a25ac742cb7519b64708,2020-04-30T20:00:00Z,266,896,63710,63710,63710,44,15,146,3171,374,3545
20200430,SC,6095,50417,,,1000,,,,,3252,8c0c449c64108bb46dc419b8fd4a2870a83e4410,2020-04-30T20:00:00Z,244,1000,56512,56512,56512,45,41,0,2081,214,2295
20200430,SD,2449,14579,,76,173,,,,,1573,9e53ce83842079e1aba91f1d6f0fb5f70b979ec9,2020-04-30T20:00:00Z,17,173,17028,17028,17028,46,4,8,119,76,195
20200430,TN,10366,158183,,,1013,,,,,5140,f1ccc301525b8a1ebb531c8113646a9752873024,2020-04-30T20:00:00Z,195,1013,168549,168549,168549,47,0,0,0,0,0
20200430,TX,28087,302213,,1686,,,,,,13353,50c44ae204797f6b51d011985a82cef19120e326,2020-04-30T20:00:00Z,782,,330300,330300,330300,48,50,0,14477,1033,15510
20200430,UT,4672,103829,,,390,,,,,1939,2b16ca545a1912ee87a5e61644c900f26f69fb79,2020-04-30T20:00:00Z,46,390,108501,108501,108501,49,1,7,2546,177,2723
20200430,VA,15846,75663,583,1550,3654,372,,208,,2104,b8be11d2e490f72c79a16f7b35e2ff1061e82d48,2020-04-30T20:00:00Z,552,3654,92092,91509,91509,51,30,46,4684,885,5569
20200430,VI,66,807,43,,,,,,,51,8956972dcc46598a124db4036ab71bd3f43f03a3,2020-04-30T20:00:00Z,4,,916,873,873,78,0,0,75,4,79
20200430,VT,866,14786,,23,,,,,,,4a39e04a8aa48535e8b6c4caf0374862d66a6de8,2020-04-30T20:00:00Z,49,,15652,15652,15652,50,2,0,219,4,223
20200430,WA,14070,173730,,474,,145,,,,,cc33c097c3f262e8f28e408e72212f232d627c00,2020-04-30T20:00:00Z,801,,187800,187800,187800,53,15,0,5057,228,5285
20200430,WI,6854,69394,195,554,1512,119,382,,,3352,a72e9d7f5daaddd57f115611a50fd9be4bdbbf4b,2020-04-30T20:00:00Z,316,1512,76443,76248,76248,55,8,23,2764,334,3098
20200430,WV,1118,43423,,84,,38,,20,,545,88ebc31ed1b6b8d15b66f469b51a954c647a650d,2020-04-30T20:00:00Z,41,,44541,44541,44541,54,3,0,1447,23,1470
20200430,WY,544,8902,,13,56,,,,,371,422d7fc5cdc6081df83ce7fe989cbfce32d03861,2020-04-30T20:00:00Z,7,56,9446,9446,9446,56,0,0,221,8,229
20200429,AK,355,18764,,14,,,,,,240,1f164fdcaff1515f7d932661d55c2befc47d1d56,2020-04-29T20:00:00Z,9,,19119,19119,19119,02,0,0,2026,4,2030
20200429,AL,6842,73607,,,945,,335,,195,,64ed895334be8e81ee542c66073a35a9e476e673,2020-04-29T20:00:00Z,245,945,80449,80449,80449,01,3,34,4467,155,4622
20200429,AR,3192,42257,,93,389,,,18,82,1249,9827fcec07de693367e6146e20eafb073bc69b3c,2020-04-29T20:00:00Z,59,389,45449,45449,45449,05,7,389,4697,81,4778
20200429,AS,0,3,17,,,,,,,,a0b09af6fe54759d2ebe74bd76d6adc8ebd1acaf,2020-04-29T20:00:00Z,0,,20,3,3,60,0,0,0,0,0
20200429,AZ,7202,61611,,756,1131,312,,191,,1475,4e256d208ebc38ef89648f5a514a21008cfc35f3,2020-04-29T20:00:00Z,304,1131,68813,68813,68813,04,11,36,1121,254,1375
20200429,CA,46500,556639,,5011,,1512,,,,,f46fde83b3afd4e5e103064c1657eaffb73550e3,2020-04-29T20:00:00Z,1887,,603139,603139,603139,06,78,0,24062,1469,25531
20200429,CO,14735,54714,,964,2610,,,,,2275,6eced05a29e869942b46ce9596c160373cc0d308,2020-04-29T20:00:00Z,760,2610,69449,69449,69449,08,54,125,2252,856,3108
20200429,CT,26767,68051,,1691,,,,,,,8c6b2ffdc821d04e25e60dedf4249176e6ec45cf,2020-04-29T20:00:00Z,2168,,94818,94818,94818,09,79,0,1618,455,2073
20200429,DC,4106,15123,,,,,,,,660,a5fa10a8dc16efd847789917521fe595b5c12bfb,2020-04-29T20:00:00Z,205,,19229,19229,19229,11,15,0,232,112,344
20200429,DE,4655,16883,,326,,,,,,1173,71a61b163d4fc46b2cf2f9c1ac71bd4fc2029fb6,2020-04-29T20:00:00Z,144,,21538,21538,21538,10,7,0,278,80,358
20200429,FL,33193,340295,1252,,5624,,,,,,a0d7c24faa8a1538b8ebeb89fec735a7ef2dfc64,2020-04-29T20:00:00Z,1240,5624,374740,373488,373488,12,86,358,6266,347,6613
20200429,GA,25572,118367,,,5056,,1148,,,,c313bc699983c8aec7349a38f2f4417f73f3673d,2020-04-29T20:00:00Z,1093,5056,143939,143939,143939,13,67,242,2962,957,3919
20200429,GU,145,1702,,,,,,,,130,6625cc97c28e0688d90ab911de3f7829e1da223c,2020-04-29T20:00:00Z,5,,1847,1847,1847,66,0,0,164,0,164
20200429,HI,609,29009,,,69,,,,,505,208da1bd9762347d0c3f6c0aa21889fe726aab8d,2020-04-29T20:00:00Z,16,69,29618,29618,29618,15,0,1,433,2,435
20200429,IA,6843,34494,,323,,100,,74,,2428,2517bd4cb1c4aaef3f6965da50b8a99d8c722e0d,2020-04-29T20:00:00Z,148,,41337,41337,41337,19,12,0,1047,467,1514
20200429,ID,1952,26430,,,173,,73,,,1087,0679caa1be76cd7edbe27c8eef1127e26df8fcb7,2020-04-29T20:00:00Z,60,173,28382,28382,28382,16,2,1,8295,35,8330
20200429,IL,50355,206312,,5036,,1290,,777,,,19b3fbdd86f509800b6a5951b89e643ebff24854,2020-04-29T20:00:00Z,2215,,256667,256667,256667,17,90,0,12225,2253,14478
20200429,IN,17182,74368,,1484,,570,,262,,,76357cce832faa77be9318a8e3e3edd25a44877a,2020-04-29T20:00:00Z,1065,,91550,91550,91550,18,164,0,3775,594,4369
20200429,KS,3738,25720,,,515,,198,,88,266,f64accacc2e61381c5ff27021e4ad79d8f764a02,2020-04-29T20:00:00Z,125,515,29458,29458,29458,20,1,11,1121,247,1368
20200429,KY,4375,48036,,320,1331,170,625,,,1617,ed9f7597d1bc9b6469a485fcd44cbfcf3a12f948,2020-04-29T20:00:00Z,225,1331,52411,52411,52411,21,12,50,3383,229,3612
20200429,LA,27660,128908,,1629,,,,244,,17303,e4c13c24840f30315ee857c5b45525493c44e2d7,2020-04-29T20:00:00Z,1845,,156568,156568,156568,22,44,0,5086,374,5460
20200429,MA,60265,205353,,3856,5758,1011,,,,,e82edc3809a3f02a95cf9da2b663d7837bb7f6d8,2020-04-29T20:00:00Z,3405,5758,265618,265618,265618,25,252,243,9155,1963,11118
20200429,MD,20849,90080,,1610,4402,586,,,,1361,c052482913bfdbfd0b81e16788ea841449a11138,2020-04-29T20:00:00Z,1078,4402,110929,110929,110929,24,62,134,2408,736,3144
20200429,ME,1056,19546,,32,166,17,,7,,615,6009a4993f755bd9b84bceb6cc7cd1af26f6eba3,2020-04-29T20:00:00Z,52,166,20602,20602,20602,23,1,3,2762,16,2778
20200429,MI,40399,131953,,2498,,997,,778,,8342,ea630b8c2bbae617ee7a14d6e46f8637cdfb8f2c,2020-04-29T20:00:00Z,3670,,172352,172352,172352,26,103,0,6410,1137,7547
20200429,MN,4644,62100,,320,950,119,337,,,2043,94d1714f8df5eff2a1689eb75a6864979562745e,2020-04-29T20:00:00Z,319,950,66744,66744,66744,27,18,38,2452,463,2915
20200429,MO,7425,69734,,891,,,,125,,,c74b01298fd75e3c04f25cdc78baecc1abe544ad,2020-04-29T20:00:00Z,318,,77159,77159,77159,29,4,0,3534,122,3656
20200429,MP,14,210,,,,,,,,12,bb4791a9dd40da25fc9763a56781bd576f5ee608,2020-04-29T20:00:00Z,2,,224,224,224,69,0,0,159,0,159
20200429,MS,6569,59525,,677,1126,151,,69,,3413,5f4f2803f0efbcb0aac7c2b4a683e5f5dd2f167b,2020-04-29T20:00:00Z,250,1126,66094,66094,66094,28,11,38,1455,227,1682
20200429,MT,451,13077,,5,61,,,,,382,6b50b0f8f89117610c0f881cf5eb6ad75d66f990,2020-04-29T20:00:00Z,16,61,13528,13528,13528,30,1,0,337,0,337
20200429,NC,9948,108492,,551,,,,,,,2c107d80a39f8b66f62dd4f2bbf337c3ff26a93d,2020-04-29T20:00:00Z,354,,118440,118440,118440,37,12,0,5308,380,5688
20200429,ND,1033,24503,,28,82,,,,,437,f87e1b7ed71db1b7bccec029efc3717fff2baa9f,2020-04-29T20:00:00Z,19,82,25536,25536,25536,38,0,3,1771,42,1813
20200429,NE,3374,20257,,,,,,,,,fca9c5cb2e5e35dc8ff93e2bf5b829a694e189ad,2020-04-29T20:00:00Z,55,,23631,23631,23631,31,0,0,10,16,26
20200429,NH,2010,18736,81,106,249,,,,,936,3e284556ede802ab72599dc1af456ed050e74adf,2020-04-29T20:00:00Z,60,249,20827,20746,20746,33,0,3,529,72,601
20200429,NJ,116264,125054,617,6289,,1811,,1327,,15642,3de865bb392cd949d7249dfb9aea81ab607418df,2020-04-29T20:00:00Z,6770,,241935,241318,241318,34,328,0,4551,2408,6959
20200429,NM,2974,58771,,157,509,,,,,705,19816f1b53e3656092662a886bf6da523598162e,2020-04-29T20:00:00Z,110,509,61745,61745,61745,35,6,28,2791,151,2942
20200429,NV,4898,36130,,,,,,,,100,071849e66083154e0f0b2a5ef48c60d5b0d1725a,2020-04-29T20:00:00Z,230,,41028,41028,41028,32,11,0,816,93,909
20200429,NY,299691,572790,,12159,65397,,,,,53238,8d7df6e55c12008e55e61a3fb35f2fdf54a851bc,2020-04-29T20:00:00Z,18015,65397,872481,872481,872481,36,377,1079,22902,4585,27487
20200429,OH,17303,111605,,,3421,,1014,,,,6efa8e65566725cc753e1ac69f6f07fa132aea2f,2020-04-29T20:00:00Z,937,3421,128908,128908,128908,39,138,81,5027,1175,6202
20200429,OK,3473,57794,,283,693,126,,,,2319,8b06a16a70042a432488fdb4529018c2998fb34d,2020-04-29T20:00:00Z,214,693,61267,61267,61267,40,7,37,1505,63,1568
20200429,OR,2446,52026,,227,569,56,,24,,,6af410101dcd418194b396769a3654e72af48772,2020-04-29T20:00:00Z,101,569,54472,54472,54472,41,9,15,3182,92,3274
20200429,PA,44366,170517,,2781,,,,602,,,e5275c7a177316d487ef08a9f6ed0ef22765edef,2020-04-29T20:00:00Z,2195,,214883,214883,214883,42,479,0,4693,1102,5795
20200429,PR,1433,9313,1940,,,,,,,,6e5b70b3039c8e5cb9b2e8172e9d7dd90abe48ec,2020-04-29T20:00:00Z,86,,12686,10746,10746,72,0,0,0,33,33
20200429,RI,8247,51918,,269,750,80,,55,,391,88f1a93380a6c41a26e08b8f84cfc0bd8963f5d4,2020-04-29T20:00:00Z,251,750,60165,60165,60165,44,12,18,2151,321,2472
20200429,SC,5881,48336,,,1000,,,,,3252,9fb8a2d1b879d45559b00721d52316bc432d12da,2020-04-29T20:00:00Z,203,1000,54217,54217,54217,45,26,56,1804,268,2072
20200429,SD,2373,14460,,69,165,,,,,1492,dd2e8f2e118e4fbfbd9169de4ea8de5c4a63d371,2020-04-29T20:00:00Z,13,165,16833,16833,16833,46,2,8,161,60,221
20200429,TN,10366,158183,,,1013,,,,,5140,da51c5fd879b74591bb6dfc82e9431f2362d2ba9,2020-04-29T20:00:00Z,195,1013,168549,168549,168549,47,7,119,6307,314,6621
20200429,TX,27054,287736,,1702,,,,,,12507,b45e638d5687b271634bdb29e6a71a4a20a608be,2020-04-29T20:00:00Z,732,,314790,314790,314790,48,42,0,13523,883,14406
20200429,UT,4495,101283,,,383,,,,,1790,3a41f26bf3b81e58453d42c8b5147b5b5303dc31,2020-04-29T20:00:00Z,45,383,105778,105778,105778,49,0,13,3187,152,3339
20200429,VA,14961,70979,620,1566,3608,387,,222,,2042,828ba889b947532ee611ea81afffc82a36f22133,2020-04-29T20:00:00Z,522,3608,86560,85940,85940,51,30,186,2020,1167,3187
20200429,VI,62,732,78,,,,,,,51,dfd3bf6d4b15c2cccc01fdc13eb8f5167e5c31d7,2020-04-29T20:00:00Z,4,,872,794,794,78,0,0,13,3,16
20200429,VT,862,14567,,26,,,,,,,68053758c35965f091df0f9030da8d889197a859,2020-04-29T20:00:00Z,47,,15429,15429,15429,50,0,0,214,0,214
20200429,WA,13842,168673,,490,,156,,,,,af0bcc6ea3de117f946fdf97b697b4411aee928a,2020-04-29T20:00:00Z,786,,182515,182515,182515,53,21,0,2680,156,2836
20200429,WI,6520,66630,227,577,1489,121,363,,,,fb9dc22bf3cbf49e772a922ecc218dfe8291aefb,2020-04-29T20:00:00Z,308,1489,73377,73150,73150,55,8,33,3095,231,3326
20200429,WV,1095,41976,,102,,40,,21,,504,a74fcd6eab50ad28b87f1187e435e16087646429,2020-04-29T20:00:00Z,38,,43071,43071,43071,54,1,0,0,16,16
20200429,WY,536,8681,,12,56,,,,,362,4519925848c07b3cd921b4b28e29cb8793eeb070,2020-04-29T20:00:00Z,7,56,9217,9217,9217,56,0,0,455,147,602
20200428,AK,351,16738,,16,,,,,,228,6d6333484b758bb236b3f2fa9857f40c52a59d0a,2020-04-28T20:00:00Z,9,,17089,17089,17089,02,0,0,827,6,833
20200428,AL,6687,69140,,,911,,335,,195,,ba9dbab92f047c4b4b3e3857de416e7cb174b05e,2020-04-28T20:00:00Z,242,911,75827,75827,75827,01,20,39,1642,188,1830
20200428,AR,3111,37560,,104,,,,20,,1146,6310b3c9131a8d988038f31a216d268bce711cb5,2020-04-28T20:00:00Z,52,,40671,40671,40671,05,2,0,120,94,214
20200428,AS,0,3,17,,,,,,,,cb1dd833c2e825a207b819e419821f0f66cf61ed,2020-04-28T20:00:00Z,0,,20,3,3,60,0,0,0,0,0
20200428,AZ,6948,60490,,737,1095,303,,193,,1450,794b840cd5db415c34fde311f79479b9e3b3df36,2020-04-28T20:00:00Z,293,1095,67438,67438,67438,04,18,44,663,232,895
20200428,CA,45031,532577,,4983,,1485,,,,,84adeda0e1c36c6532c7897963d499d2b201743e,2020-04-28T20:00:00Z,1809,,577608,577608,577608,06,54,0,22632,1567,24199
20200428,CO,13879,52462,,994,2485,,,,,2275,eb384d5da0dc450b12617ac863390a31a5ff2bb5,2020-04-28T20:00:00Z,706,2485,66341,66341,66341,08,26,47,2629,438,3067
20200428,CT,26312,66433,,1732,,,,,,,a492bcfb6e7700ed40493b8a4f5bdd1e5c37d867,2020-04-28T20:00:00Z,2089,,92745,92745,92745,09,91,0,11891,1043,12934
20200428,DC,3994,14891,,,,,,,,660,e4b6b3e2cdbea56f43328c9cb631504e07bd4434,2020-04-28T20:00:00Z,190,,18885,18885,18885,11,5,0,367,102,469
20200428,DE,4575,16605,,337,,,,,,1096,77b5822d3a013f5e2bd37d8ec74cd14da0eb2b9b,2020-04-28T20:00:00Z,137,,21180,21180,21180,10,12,0,1151,413,1564
20200428,FL,32846,334029,1216,,5266,,,,,,fdcf82ce88627d5000c5b246ed36938e5c004182,2020-04-28T20:00:00Z,1154,5266,368091,366875,366875,12,53,55,9704,708,10412
20200428,GA,24615,115405,,,4814,,1087,,,,01f2ea276fc76ba7144a5c7276dcc870ba576e6c,2020-04-28T20:00:00Z,1026,4814,140020,140020,140020,13,55,133,12149,702,12851
20200428,GU,145,1538,,3,,,,,,129,bd39a1aae2b85180c8d3bc461b5b9f8b94f917f2,2020-04-28T20:00:00Z,5,,1683,1683,1683,66,0,0,114,1,115
20200428,HI,607,28576,,,68,,,,,493,1a60838d7486cd9621d869ef0d10ffe28fbeeafe,2020-04-28T20:00:00Z,16,68,29183,29183,29183,15,2,0,172,1,173
20200428,IA,6376,33447,,304,,98,,64,,2164,8f5d5d49c3ee4ff3c973cfb5b483f3efe433f56b,2020-04-28T20:00:00Z,136,,39823,39823,39823,19,9,0,1165,508,1673
20200428,ID,1917,18135,,,172,,73,,,1039,12e5fad4870c1bb75091871eddfe87f7ed275810,2020-04-28T20:00:00Z,58,172,20052,20052,20052,16,2,3,137,20,157
20200428,IL,48102,194087,,4738,,1245,,778,,,bd003794f63b63c99a44384541d31450e8108158,2020-04-28T20:00:00Z,2125,,242189,242189,242189,17,142,0,12342,2219,14561
20200428,IN,16588,70593,,1518,,546,,275,,,dcce1abae4717800b18cd8b44b33217d9caf1619,2020-04-28T20:00:00Z,901,,87181,87181,87181,18,57,0,2078,627,2705
20200428,KS,3491,24599,,,504,,,,,,0f367ea1af4427ee3b8f71aceb49ae4543f060be,2020-04-28T20:00:00Z,124,504,28090,28090,28090,20,4,8,760,163,923
20200428,KY,4146,44653,,313,1281,165,612,,,1521,a8bb68943deaaf5d9a61e1ff33c1f2e6343dc197,2020-04-28T20:00:00Z,213,1281,48799,48799,48799,21,5,7,253,72,325
20200428,LA,27286,123822,,1666,,,,244,,17303,b75b5877e1e6b087a124aa113d4af3bf1efcf850,2020-04-28T20:00:00Z,1801,,151108,151108,151108,22,131,0,3901,218,4119
20200428,MA,58302,196198,,3875,5515,1005,,,,,e91eb7f8440568bfcd5f08e8f2bdca523b67bec0,2020-04-28T20:00:00Z,3153,5515,254500,254500,254500,25,150,278,7773,1840,9613
20200428,MD,20113,87672,,1528,4268,551,,,,1295,f127de9e4f92b2670f32656788888e6fd517cd11,2020-04-28T20:00:00Z,1016,4268,107785,107785,107785,24,71,167,2183,626,2809
20200428,ME,1040,16784,,33,163,17,,7,,585,5237040af23bfb0b707d507b544164b67154ee50,2020-04-28T20:00:00Z,51,163,17824,17824,17824,23,0,2,0,17,17
20200428,MI,39262,125543,,2623,,1027,,801,,8342,17a45d2d2885b1efd7f775ad72e08ed104aceefb,2020-04-28T20:00:00Z,3567,,164805,164805,164805,26,160,0,5993,1052,7045
20200428,MN,4181,59648,,314,912,120,324,,,1912,61d2821a7b572cb3675730fc96c0a05088dd95f2,2020-04-28T20:00:00Z,301,912,63829,63829,63829,27,15,51,2196,365,2561
20200428,MO,7303,66200,,655,,,,105,,,ce5c2c28ea04a6f535db0726cd34c5992c15e6fe,2020-04-28T20:00:00Z,314,,73503,73503,73503,29,26,0,2265,132,2397
20200428,MP,14,51,,,,,,,,12,4bb66f22aefb9ed9babcfeb87cd0bf2683b41021,2020-04-28T20:00:00Z,2,,65,65,65,69,0,0,0,0,0
20200428,MS,6342,58070,,639,1088,162,,77,,,fd962f9fc652f41d43b8816c1eb395c5d7c66adc,2020-04-28T20:00:00Z,239,1088,64412,64412,64412,28,10,28,702,248,950
20200428,MT,451,12740,,10,61,,,,,356,7d183cc2da51791340c889d1d1f554d4f0f42b98,2020-04-28T20:00:00Z,15,61,13191,13191,13191,30,1,0,156,2,158
20200428,NC,9568,103184,,463,,,,,,,49e7478e4c6abc770fa6e98feec4df832598cd53,2020-04-28T20:00:00Z,342,,112752,112752,112752,37,36,0,2406,426,2832
20200428,ND,991,22732,,25,79,,,,,409,6dac62a3b85310dd121666134f684824594587ed,2020-04-28T20:00:00Z,19,79,23723,23723,23723,38,0,2,1240,49,1289
20200428,NE,3358,20247,,,,,,,,,9b66bbf3d4774b47463d50a0f6c2561ab62bf0a1,2020-04-28T20:00:00Z,55,,23605,23605,23605,31,-1,0,912,330,1242
20200428,NH,1938,18207,223,99,246,,,,,798,a112aa908bfbc49b3315ec924b559d1c4b95488a,2020-04-28T20:00:00Z,60,246,20368,20145,20145,33,0,4,347,74,421
20200428,NJ,113856,120503,,6476,,1809,,1262,,15642,9c3b8b4da7b9875543aee04d4a5254722c12dc27,2020-04-28T20:00:00Z,6442,,234359,234359,234359,34,398,0,3916,2668,6584
20200428,NM,2823,55980,,155,481,,,,,666,8699789075bb424e8e4d1e254c53638e68801133,2020-04-28T20:00:00Z,104,481,58803,58803,58803,35,5,69,2091,97,2188
20200428,NV,4805,35314,,,,,,,,,a07e8686bf512f94605da141b5823b2ed19860e8,2020-04-28T20:00:00Z,219,,40119,40119,40119,32,13,0,1191,115,1306
20200428,NY,295106,549888,,12645,64318,,,,,51673,4577e5826cad0945fd2dbf7648519b073d5e7ea9,2020-04-28T20:00:00Z,17638,64318,844994,844994,844994,36,335,748,15789,3110,18899
20200428,OH,16128,106578,,,3340,,1004,,,,1bcf118ab0e6d117757abc46cc8721248f5bfbcd,2020-04-28T20:00:00Z,799,3340,122706,122706,122706,39,46,108,2886,429,3315
20200428,OK,3410,56289,,288,656,118,,,,2260,dd9faa65420e0739763ec3cbf21cc5ec229719bf,2020-04-28T20:00:00Z,207,656,59699,59699,59699,40,10,0,6398,130,6528
20200428,OR,2354,48844,,249,554,71,,31,,,9e41ff0b60b650cd45d995c32ee536f5b916f926,2020-04-28T20:00:00Z,92,554,51198,51198,51198,41,0,0,0,0,0
20200428,PA,43264,165824,,2781,,,,616,,,da8a5202404b84b9cc653544eda179b396b9f1fa,2020-04-28T20:00:00Z,1716,,209088,209088,209088,42,119,0,4452,1214,5666
20200428,PR,1400,9313,1940,,,,,,,,d6ee498eab880735051c992e2842a4a409a472e7,2020-04-28T20:00:00Z,86,,12653,10713,10713,72,2,0,0,11,11
20200428,RI,7926,49767,,266,732,84,,55,,466,9adeaf660fb8276e8fadef1c338393bccf467267,2020-04-28T20:00:00Z,239,732,57693,57693,57693,44,6,14,1590,218,1808
20200428,SC,5613,46532,,,944,,,,,2830,34e5fb243fc3944e0e04315125636b81d85f7e4f,2020-04-28T20:00:00Z,177,944,52145,52145,52145,45,3,0,1261,123,1384
20200428,SD,2313,14299,,69,157,,,,,1392,b5d2f209ecb038c841f1a35138eec4420b8adc05,2020-04-28T20:00:00Z,11,157,16612,16612,16612,46,0,7,169,68,237
20200428,TN,10052,151876,,,894,,,,,4921,fe340d545e4636308fe77e909229ab8bfcdc63ba,2020-04-28T20:00:00Z,188,894,161928,161928,161928,47,4,57,7392,134,7526
20200428,TX,26171,274213,,1682,,,,,,11786,50f18f61bcb01eba60a9a5a4bfe34b7e6f886719,2020-04-28T20:00:00Z,690,,300384,300384,300384,48,27,0,8993,874,9867
20200428,UT,4343,98096,,,370,,,,,1704,635cbaea75989c8b5e1add7c80859585284fea5b,2020-04-28T20:00:00Z,45,370,102439,102439,102439,49,4,21,2134,110,2244
20200428,VA,13794,68959,560,1508,3422,376,,217,,1914,7bdfc9b5739aa65136f8908aab2419c3d3ba7645,2020-04-28T20:00:00Z,492,3422,83313,82753,82753,51,34,124,1815,259,2074
20200428,VI,59,719,57,,,,,,,51,532a1423de7258c1fa4c408f648309fe73083029,2020-04-28T20:00:00Z,4,,835,778,778,78,0,0,3,0,3
20200428,VT,862,14353,,29,,,,,,,16959b7761aa7f9b11287a1c7e92847c2ffa5416,2020-04-28T20:00:00Z,47,,15215,15215,15215,50,0,0,135,7,142
20200428,WA,13686,165993,,436,,158,,,,,1a91d4a0c3ecebe8a321950c713fa1ea82dc7cdd,2020-04-28T20:00:00Z,765,,179679,179679,179679,53,16,0,4037,165,4202
20200428,WI,6289,63535,193,544,1456,123,363,,,,9ea3d1cd925c35584f5676cb65cfa6ac5e72aed9,2020-04-28T20:00:00Z,300,1456,70017,69824,69824,55,19,41,2224,208,2432
20200428,WV,1079,41976,,87,,28,,15,,481,21300b5e4346c96580507d3940949ddec956f8de,2020-04-28T20:00:00Z,37,,43055,43055,43055,54,1,0,0,16,16
20200428,WY,389,8226,,16,56,,,,,343,40b0c5dd4f57eb95ec54b7b9c164d0d0f5bff470,2020-04-28T20:00:00Z,7,56,8615,8615,8615,56,0,2,429,19,448
20200427,AK,345,15911,,10,,,,,,218,0503e68a5324c7bf6213cb52f90add2539db6155,2020-04-27T20:00:00Z,9,,16256,16256,16256,02,0,0,75,4,79
20200427,AL,6499,67498,,,872,,335,,195,,067eb0245aee3ef0cb059b83cdc8420af4bbb8bb,2020-04-27T20:00:00Z,222,872,73997,73997,73997,01,6,27,217,229,446
20200427,AR,3017,37440,,109,,,,25,,987,9a3c4c406e333bb30e983ce69cbae10c300d6326,2020-04-27T20:00:00Z,50,,40457,40457,40457,05,1,0,912,76,988
20200427,AS,0,3,17,,,,,,,,88aa4e98ae3a6e1e3968cc999794db230ef69b81,2020-04-27T20:00:00Z,0,,20,3,3,60,0,0,0,0,0
20200427,AZ,6716,59827,,647,1051,328,,200,,1418,a79d7c67e4cabcf95aae37f66ddcf048c06bb93b,2020-04-27T20:00:00Z,275,1051,66543,66543,66543,04,0,14,1542,190,1732
20200427,CA,43464,509945,,4878,,1499,,,,,7e0060a60a33304fbcd09327f77a224932b0befb,2020-04-27T20:00:00Z,1755,,553409,553409,553409,06,45,0,26025,1300,27325
20200427,CO,13441,49833,,1007,2438,,,,,2150,331571e974964aca7c0337b087b51b4b5d1dcd9c,2020-04-27T20:00:00Z,680,2438,63274,63274,63274,08,8,28,3010,473,3483
20200427,CT,25269,54542,,1758,,,,,,,11b0dc3e29632a8a1d905f26613702efd07cfe8c,2020-04-27T20:00:00Z,1998,,79811,79811,79811,09,74,0,0,0,0
20200427,DC,3892,14524,,402,,,,,,659,ac84cb61adbd25453bb4ff7b5f54acb294212c11,2020-04-27T20:00:00Z,185,,18416,18416,18416,11,7,0,297,51,348
20200427,DE,4162,15454,,325,,,,,,996,eaec04146fb9b00e6d25750f95d0ca0ac107c545,2020-04-27T20:00:00Z,125,,19616,19616,19616,10,5,0,239,128,367
20200427,FL,32138,324325,1099,,5211,,,,,,d94ef63929fe1cb9a069dd41fd26d002dc90555f,2020-04-27T20:00:00Z,1101,5211,357562,356463,356463,12,7,56,11240,610,11850
20200427,GA,23913,103256,,,4681,,1057,,,,65a8ebf663be0e922e669f0df9e73043f8152dfc,2020-04-27T20:00:00Z,971,4681,127169,127169,127169,13,59,322,3434,512,3946
20200427,GU,144,1424,,3,,,,,,128,192e4ec5ae89fe9b924e62e2fa558a8e052fa504,2020-04-27T20:00:00Z,5,,1568,1568,1568,66,0,0,37,3,40
20200427,HI,606,28404,,,68,,,,,488,cc95e795ba899eeb6cfae07acf59d140dd11c604,2020-04-27T20:00:00Z,14,68,29010,29010,29010,15,0,0,524,3,527
20200427,IA,5868,32282,,300,,100,,58,,2021,e73799ea8d2a068e792169ed630344605c37695a,2020-04-27T20:00:00Z,127,,38150,38150,38150,19,9,0,1668,392,2060
20200427,ID,1897,17998,,,169,,71,,,983,2039b974e905f2796e680f2b544fccd429bb5b9f,2020-04-27T20:00:00Z,56,169,19895,19895,19895,16,0,0,320,10,330
20200427,IL,45883,181745,,4672,,1249,,763,,,f628a096fa362b138e1f5e58d5ec982082189e1b,2020-04-27T20:00:00Z,1983,,227628,227628,227628,17,50,0,10696,1980,12676
20200427,IN,15961,68515,,1493,,581,,284,,,cf60bade404ded3664e1f0bad93a17dd0472b7dc,2020-04-27T20:00:00Z,844,,84476,84476,84476,18,31,0,1819,949,2768
20200427,KS,3328,23839,,,496,,,,,,0fc8939cb3c5a6bbebfc2bfa2521d7362b4e8d0a,2020-04-27T20:00:00Z,120,496,27167,27167,27167,20,2,11,786,154,940
20200427,KY,4074,44400,,308,1274,166,608,,,1511,d0103bcbf958ac82307466f606e09602ec13d206,2020-04-27T20:00:00Z,208,1274,48474,48474,48474,21,3,8,1747,169,1916
20200427,LA,27068,119921,,1683,,,,262,,17303,d604b75bdb03f353db9e8aac3c926b1d496df9d3,2020-04-27T20:00:00Z,1670,,146989,146989,146989,22,0,0,3658,295,3953
20200427,MA,56462,188425,,3892,5237,1089,,,,,6840cb9a1aa06e42fc154748cf79660dd665966f,2020-04-27T20:00:00Z,3003,5237,244887,244887,244887,25,104,133,7263,1524,8787
20200427,MD,19487,85489,,1513,4101,535,,,,1263,93d7615b261b82851b02dea64f14ad4fe2cea382,2020-04-27T20:00:00Z,945,4101,104976,104976,104976,24,35,139,7405,906,8311
20200427,ME,1023,16784,,39,161,16,,7,,549,9b638b6d4f314c5476ca5f227900b829d5b972f0,2020-04-27T20:00:00Z,51,161,17807,17807,17807,23,1,2,0,8,8
20200427,MI,38210,119550,,2667,,1059,,832,,8342,ce7c467c0c767cd5f7b5554d6e533637dd34bb7b,2020-04-27T20:00:00Z,3407,,157760,157760,157760,26,92,0,6322,432,6754
20200427,MN,3816,57452,,292,861,122,316,,,1842,adc3739f7759b97caf48b622ed7713cf6ce8af6a,2020-04-27T20:00:00Z,286,861,61268,61268,61268,27,14,32,2067,214,2281
20200427,MO,7171,63935,,679,,,,109,,,e283ef13dbb00a4eca94cafd6125895912c283f7,2020-04-27T20:00:00Z,288,,71106,71106,71106,29,14,0,1184,174,1358
20200427,MP,14,51,,,,,,,,11,ec5550b5c36e0adb662330ef8b27e922fb8e2cef,2020-04-27T20:00:00Z,2,,65,65,65,69,0,0,0,0,0
20200427,MS,6094,57368,,590,1060,142,,71,,,5993cb137aead9e2e57ed8105929da3ea1fdbe64,2020-04-27T20:00:00Z,229,1060,63462,63462,63462,28,2,59,2491,183,2674
20200427,MT,449,12584,,11,61,,,,,352,85402e977e87df749a2972a813c68c7ffcd63130,2020-04-27T20:00:00Z,14,61,13033,13033,13033,30,0,0,170,1,171
20200427,NC,9142,100778,,473,,,,,,,cccfb81b00a1ade2e73247d016ba50723d79ccb3,2020-04-27T20:00:00Z,306,,109920,109920,109920,37,7,0,1714,312,2026
20200427,ND,942,21492,,23,77,,,,,350,6184fef9f342356dcd0d4091d3d9dd72bfcd8468,2020-04-27T20:00:00Z,19,77,22434,22434,22434,38,2,6,1642,75,1717
20200427,NE,3028,19335,,,,,,,,,4f6b888d481245ae68932476138b5af530d2d2d8,2020-04-27T20:00:00Z,56,,22363,22363,22363,31,3,0,839,296,1135
20200427,NH,1864,17860,270,101,242,,,,,779,7516b4a4ea70c7b9c68f715080aad738915399e3,2020-04-27T20:00:00Z,60,242,19994,19724,19724,33,0,4,896,77,973
20200427,NJ,111188,116587,,6407,,1801,,1303,,,3c5478d5331affe1b9b7d41035688ce607eeaf05,2020-04-27T20:00:00Z,6044,,227775,227775,227775,34,106,0,2481,2150,4631
20200427,NM,2726,53889,,148,412,,,,,650,1ee9c081a7049e8d88c4dd414c0847a9b2dd95c9,2020-04-27T20:00:00Z,99,412,56615,56615,56615,35,6,0,2814,66,2880
20200427,NV,4690,34123,,,,,,,,,396e58e0594f49d5bb32db1eae9693d375109f3a,2020-04-27T20:00:00Z,206,,38813,38813,38813,32,0,0,539,88,627
20200427,NY,291996,534099,,12819,63570,,,,,50751,5b2a7aef7d4c8ab462441ae36d996688ccaf8eec,2020-04-27T20:00:00Z,17303,63570,826095,826095,826095,36,337,1044,16794,3951,20745
20200427,OH,15699,103692,,,3232,,978,,,,7412933bbe530b91898c8a87f9a6d16eeba81584,2020-04-27T20:00:00Z,753,3232,119391,119391,119391,39,25,54,3269,339,3608
20200427,OK,3280,49891,,306,656,150,,,,2167,922a005a4b97646839ef6ce4107ec4bdd4db6890,2020-04-27T20:00:00Z,197,656,53171,53171,53171,40,2,3,0,27,27
20200427,OR,2354,48844,,249,554,71,,31,,,b5da21fe68307a1ff480e5ac7f8da2601cd0fe1d,2020-04-27T20:00:00Z,92,554,51198,51198,51198,41,1,8,2191,43,2234
20200427,PA,42050,161372,,2800,,,,629,,,893901daaec42129acd0e848c482a04383487bd6,2020-04-27T20:00:00Z,1597,,203422,203422,203422,42,47,0,3944,885,4829
20200427,PR,1389,9313,1940,,,,,,,,76939eb496201f1edd19034d9a07c27a77168861,2020-04-27T20:00:00Z,84,,12642,10702,10702,72,0,0,0,18,18
20200427,RI,7708,48177,,266,718,81,,56,,452,ccff580fa5545c99bc6bea53c3ef8a0a98cf6a11,2020-04-27T20:00:00Z,233,718,55885,55885,55885,44,7,27,2213,269,2482
20200427,SC,5490,45271,,,944,,,,,3701,997bdf56c23a76682ec10b3923b9c818be130db5,2020-04-27T20:00:00Z,174,944,50761,50761,50761,45,0,0,0,0,0
20200427,SD,2245,14130,,61,150,,,,,1316,da7b1e99ed2b75020686d32fb47b5ece32c3fa8a,2020-04-27T20:00:00Z,11,150,16375,16375,16375,46,0,15,68,33,101
20200427,TN,9918,144484,,,837,,,,,4720,7a27e30b9fe3a52abb6fa5f8b30eba326b5e5ee6,2020-04-27T20:00:00Z,184,837,154402,154402,154402,47,3,9,5930,251,6181
20200427,TX,25297,265220,,1563,,,,,,11170,874ea844002b828c87f62fa1a1a250863013c3fd,2020-04-27T20:00:00Z,663,,290517,290517,290517,48,15,0,13830,666,14496
20200427,UT,4233,95962,,,349,,,,,1641,0c32034bce8f892839893087c6473945d1f85295,2020-04-27T20:00:00Z,41,349,100195,100195,100195,49,0,4,4383,110,4493
20200427,VA,13535,67144,542,1455,3298,389,,217,,1843,30372d4dd7aa8ff88461330fa1e67fa532cc2dab,2020-04-27T20:00:00Z,458,3298,81221,80679,80679,51,10,1284,3514,1047,4561
20200427,VI,59,716,5,,,,,,,51,17bd05c1f790b327eff70ad7e0282cfa22a0cf0f,2020-04-27T20:00:00Z,4,,780,775,775,78,0,0,16,2,18
20200427,VT,855,14218,,33,,,,,,,f1ac96b8d1031ba8cdc230b2efa066cb9b506141,2020-04-27T20:00:00Z,47,,15073,15073,15073,50,1,0,272,4,276
20200427,WA,13521,161956,,536,,115,,,,,b7f65c1f834f09376bc42e0b2bf25759a23d9ef0,2020-04-27T20:00:00Z,749,,175477,175477,175477,53,11,0,37,0,37
20200427,WI,6081,61311,204,337,1415,124,355,,,,f15645ba52e5ca7df3225c17119102d68f199263,2020-04-27T20:00:00Z,281,1415,67596,67392,67392,55,9,18,2076,170,2246
20200427,WV,1063,41976,,100,,38,,20,,455,82827997173c5f19f942dabc3794c0188c957c95,2020-04-27T20:00:00Z,36,,43039,43039,43039,54,2,0,3957,19,3976
20200427,WY,370,7797,,16,54,,,,,342,4a0c9ee19e304b68e5f47523505cc41a42d32f0f,2020-04-27T20:00:00Z,7,54,8167,8167,8167,56,0,0,0,8,8
20200426,AK,341,15836,,14,,,,,,217,598ec390a86de9a377a05ce8777e10f7ffb0def6,2020-04-26T20:00:00Z,9,,16177,16177,16177,02,0,0,443,2,445
20200426,AL,6270,67281,,,845,,288,,170,,29138be5cd616827aaeb6d007d6a38aa983de8f7,2020-04-26T20:00:00Z,216,845,73551,73551,73551,01,4,6,2074,133,2207
20200426,AR,2941,36528,,104,291,,,25,57,985,8bd13e8057f0336047fc5efe259c5115034b6a5f,2020-04-26T20:00:00Z,49,291,39469,39469,39469,05,2,0,1304,112,1416
20200426,AS,0,3,17,,,,,,,,58fa2d12938977152614302706e7b6f06fc8ea8b,2020-04-26T20:00:00Z,0,,20,3,3,60,0,0,0,0,0
20200426,AZ,6526,58285,,671,1037,308,,200,,1383,6433ae956d97b647316a5468bf4d52de556b73ed,2020-04-26T20:00:00Z,275,1037,64811,64811,64811,04,9,15,2057,246,2303
20200426,CA,42164,483920,,4928,,1473,,,,,15d7a3a4b05b30dad26b479c9c9e258b97f4e23d,2020-04-26T20:00:00Z,1710,,526084,526084,526084,06,59,0,19022,1027,20049
20200426,CO,12968,46823,,1046,2410,,,,,2150,e197cd1b56226efc9437695db2b0c7b7d09239a4,2020-04-26T20:00:00Z,672,2410,59791,59791,59791,08,-2,44,2290,712,3002
20200426,CT,25269,54542,,1766,,,,,,,ffb8061cbccc29e3d503cc3cbd986d12f1e33101,2020-04-26T20:00:00Z,1924,,79811,79811,79811,09,62,0,1522,687,2209
20200426,DC,3841,14227,,402,,120,,69,,657,d320b7b210845d03de67dbeaa04ff27a4b48ce6c,2020-04-26T20:00:00Z,178,,18068,18068,18068,11,13,0,624,142,766
20200426,DE,4034,15215,,317,,,,,,911,b958368a67cc9aa39190a7be9d03a4ea938d10cf,2020-04-26T20:00:00Z,120,,19249,19249,19249,10,8,0,1093,458,1551
20200426,FL,31528,313085,1183,,5155,,,,,,b4ee31750858fd4693944620b152a3751d6bd5a5,2020-04-26T20:00:00Z,1094,5155,345796,344613,344613,12,19,110,10825,689,11514
20200426,GA,23401,99822,,,4359,,,,,,679d436432d9aa39fe6d0a4976076ee6edcc7706,2020-04-26T20:00:00Z,912,4359,123223,123223,123223,13,8,33,3503,706,4209
20200426,GU,141,1387,,2,,,,,,128,14df41e4fb919a0f106be2762f609892aa65696d,2020-04-26T20:00:00Z,5,,1528,1528,1528,66,0,0,79,0,79
20200426,HI,603,27880,,,68,,,,,482,88e19729e64c94b3b9d5237346b430d6abc7478a,2020-04-26T20:00:00Z,14,68,28483,28483,28483,15,1,1,441,2,443
20200426,IA,5476,30614,,286,,99,,55,,1900,e3b1b01501635eb50f90e6d18cb7f889d7209039,2020-04-26T20:00:00Z,118,,36090,36090,36090,19,6,0,1356,384,1740
20200426,ID,1887,17678,,,169,,72,,,938,3f714d5e144e3e3394a496df544723b4efd5b40a,2020-04-26T20:00:00Z,56,169,19565,19565,19565,16,2,1,187,17,204
20200426,IL,43903,171049,,4595,,1267,,772,,,74503e34ae253c57314215429707bfb71d97abe7,2020-04-26T20:00:00Z,1933,,214952,214952,214952,17,59,0,11209,2126,13335
20200426,IN,15012,66696,,1446,,589,,310,,,6019740b4ce0b961034ca31c9b3e08c8d87298d1,2020-04-26T20:00:00Z,813,,81708,81708,81708,18,28,0,1317,617,1934
20200426,KS,3174,23053,,,485,,,,,,5c9b0f7e8b09e90a4b781d29e2ef57d6221a296a,2020-04-26T20:00:00Z,118,485,26227,26227,26227,20,1,11,910,118,1028
20200426,KY,3905,42653,,301,1266,164,605,,,1501,83d63b61a350d050749ed3c4468d4293411ae7a0,2020-04-26T20:00:00Z,205,1266,46558,46558,46558,21,5,123,1470,126,1596
20200426,LA,26773,116263,,1701,,,,265,,14927,8b195658a15ee0138ffbf2d0b28590023b83f7ac,2020-04-26T20:00:00Z,1670,,143036,143036,143036,22,26,0,3773,261,4034
20200426,MA,54938,181162,,3879,5104,1077,,,,,45704df9962b4d0576983dc77cbd56aac1d2c141,2020-04-26T20:00:00Z,2899,5104,236100,236100,236100,25,22,139,7665,1590,9255
20200426,MD,18581,78084,,1463,3962,530,,,,1177,5464d20ecd89fcd333a7c612204e74072a377c98,2020-04-26T20:00:00Z,910,3962,96665,96665,96665,24,35,202,6727,815,7542
20200426,ME,1015,16784,,39,159,19,,7,,532,1b1c1d51d595a84ee7d773f087c737238ec637d1,2020-04-26T20:00:00Z,50,159,17799,17799,17799,23,0,3,0,25,25
20200426,MI,37778,113228,,2757,,1099,,871,,8342,3bd751e0f499522c51c8ad628dbd764fdfb97f2e,2020-04-26T20:00:00Z,3315,,151006,151006,151006,26,41,0,6387,575,6962
20200426,MN,3602,55385,,285,829,115,301,,,1774,fe331e2a1192e61065a1bc2a69f1f095b2123ad3,2020-04-26T20:00:00Z,272,829,58987,58987,58987,27,28,32,2234,156,2390
20200426,MO,6997,62751,,679,,,,109,,,a3d604b0bbb8b05a805174b4c931ddc0041142b3,2020-04-26T20:00:00Z,274,,69748,69748,69748,29,1,0,2359,171,2530
20200426,MP,14,51,,,,,,,,11,603eac41e079e49fd1d794fcfc5450f52e6a4299,2020-04-26T20:00:00Z,2,,65,65,65,69,0,0,0,0,0
20200426,MS,5911,54877,,644,1001,146,,67,,,4dac06cfd26f80e4ff6d80f25ad332fd45b11d24,2020-04-26T20:00:00Z,227,1001,60788,60788,60788,28,6,5,1638,193,1831
20200426,MT,448,12414,,11,61,,,,,339,6aff37b46eaff2bbf4aacc686e525ce62d585aa4,2020-04-26T20:00:00Z,14,61,12862,12862,12862,30,0,0,362,3,365
20200426,NC,8830,99064,,451,,,,,,,73050686fc3d837a4d1117ee68abead5e542d3b8,2020-04-26T20:00:00Z,299,,107894,107894,107894,37,10,0,2422,207,2629
20200426,ND,867,19850,,18,71,,,,,326,ba66dd35d32ce58aff43651967d6ff6b713927bc,2020-04-26T20:00:00Z,17,71,20717,20717,20717,38,1,1,1303,64,1367
20200426,NE,2732,18496,,,,,,,,,192857c45fc1a408a06921c7d614185710f133ae,2020-04-26T20:00:00Z,53,,21228,21228,21228,31,3,0,944,311,1255
20200426,NH,1787,16964,550,95,238,,,,,777,4e27de3fee4323abe8af8e587e5c3ba1fad3fcdb,2020-04-26T20:00:00Z,60,238,19301,18751,18751,33,7,14,957,67,1024
20200426,NJ,109038,114106,,6573,,1804,,1418,,,6059daac4fb54aa392e192062ad3eb0cd6fa8d4f,2020-04-26T20:00:00Z,5938,,223144,223144,223144,34,75,0,5943,3515,9458
20200426,NM,2660,51075,,152,412,,,,,614,5b6c1c5cf2c6bb305176da228aa4362faeacaef6,2020-04-26T20:00:00Z,93,412,53735,53735,53735,35,9,0,2086,139,2225
20200426,NV,4602,33584,,,,,,,,,eff901058fef0448edfbd3f26bea8d9c13c58665,2020-04-26T20:00:00Z,206,,38186,38186,38186,32,2,0,915,63,978
20200426,NY,288045,517305,,12839,62526,5016,,,,49687,2a47d3ac63566fd5b660a9c957c8cfb0ca6bbddf,2020-04-26T20:00:00Z,16966,62526,805350,805350,805350,36,367,1067,21880,5902,27782
20200426,OH,15360,100423,,,3178,,952,,,,ba664254293cf518f790f7f2f622b890bb9f6c8f,2020-04-26T20:00:00Z,728,3178,115783,115783,115783,39,17,63,4027,377,4404
20200426,OK,3253,49891,,306,653,150,,,,2139,df945c968e381cefc24c7751a9b600b0b90b62a7,2020-04-26T20:00:00Z,195,653,53144,53144,53144,40,1,16,0,60,60
20200426,OR,2311,46653,,249,546,71,,31,,,5b854b610ddc05cd40806f79c2279776543f2b9f,2020-04-26T20:00:00Z,91,546,48964,48964,48964,41,4,10,1529,58,1587
20200426,PA,41165,157428,,2736,,,,632,,,ae04ca0488b225899a5ff5442b33ed04c3c2ef16,2020-04-26T20:00:00Z,1550,,198593,198593,198593,42,13,0,4542,1116,5658
20200426,PR,1371,9313,1940,,,,,,,,b5ae3dea3215eaeaa88c14053880e6297c266e97,2020-04-26T20:00:00Z,84,,12624,10684,10684,72,1,0,0,64,64
20200426,RI,7439,45964,,258,691,78,,53,,433,53ab44090ddfb499c3a8e800c2da5f3409e96fcd,2020-04-26T20:00:00Z,226,691,53403,53403,53403,44,11,115,2202,310,2512
20200426,SC,5490,45271,,,944,,,,,3701,f776a2f2b91df1054cc05c3c60df7370f05d55c7,2020-04-26T20:00:00Z,174,944,50761,50761,50761,45,8,0,1510,237,1747
20200426,SD,2212,14062,,64,135,,,,,1257,d1059370ad2364cf07281939f4cf66e7f4a0ddaf,2020-04-26T20:00:00Z,11,135,16274,16274,16274,46,1,7,613,65,678
20200426,TN,9667,138554,,,828,,,,,4527,c2c390d12369a40a6189b7caa9f100b78445a8c7,2020-04-26T20:00:00Z,181,828,148221,148221,148221,47,3,7,6337,478,6815
20200426,TX,24631,251390,,1542,,,,,,10763,9df279710d517bc43a0493023eb248465cfbc028,2020-04-26T20:00:00Z,648,,276021,276021,276021,48,25,0,12347,858,13205
20200426,UT,4123,91579,,,345,,,,,1568,10d7f1f214d7d7928d0a63a16ec1be3769f2db1e,2020-04-26T20:00:00Z,41,345,95702,95702,95702,49,0,16,5321,175,5496
20200426,VA,12488,63630,539,1436,2014,387,,217,,1815,6788017adf66ca2be4e8fd168b7bf9423d49992c,2020-04-26T20:00:00Z,448,2014,76657,76118,76118,51,12,72,3354,586,3940
20200426,VI,57,700,19,,,,,,,51,b6499a7cbdbeff52807693be6ad5dcd3f95e2184,2020-04-26T20:00:00Z,4,,776,757,757,78,1,0,7,2,9
20200426,VT,851,13946,,34,,,,,,,6ec880ed310b1b3572d49a151e6a612b418227c6,2020-04-26T20:00:00Z,46,,14797,14797,14797,50,0,0,107,8,115
20200426,WA,13521,161919,,508,,145,,,,,c70721ad637c7347d9cfafc0cc8a5596f6bcf96d,2020-04-26T20:00:00Z,738,,175440,175440,175440,53,73,0,0,0,0
20200426,WI,5911,59235,197,337,1397,136,353,,,,c603b9318c363bfc6a99c1281df0074bb6687e6d,2020-04-26T20:00:00Z,272,1397,65343,65146,65146,55,6,21,2097,224,2321
20200426,WV,1044,38019,,100,,38,,20,,455,8171b5b94769802de289832da22cc4f57109a2c1,2020-04-26T20:00:00Z,34,,39063,39063,39063,54,2,0,6073,24,6097
20200426,WY,362,7797,,16,54,,,,,334,4bace06f1b80b31f742714cf7ee8a5c6c5d8724b,2020-04-26T20:00:00Z,7,54,8159,8159,8159,56,0,0,0,13,13
20200425,AK,339,15393,,32,,,,,,217,ab748b658b14f06c13e30194100f210b2136340e,2020-04-25T20:00:00Z,9,,15732,15732,15732,02,0,0,3451,0,3451
20200425,AL,6137,65207,,,839,,288,,170,,7bf5132c6fc6ee52a0ff04abc4cd5430c20b506c,2020-04-25T20:00:00Z,212,839,71344,71344,71344,01,15,71,18344,305,18649
20200425,AR,2829,35224,,104,291,,,25,57,964,58b9bd7f87ceaa7eb18f988e56f5ff87f50faf84,2020-04-25T20:00:00Z,47,291,38053,38053,38053,05,2,0,2387,88,2475
20200425,AS,0,3,17,,,,,,,,9bbbe48f731360bdff6ba5de6550e13b34e278d0,2020-04-25T20:00:00Z,0,,20,3,3,60,0,0,0,0,0
20200425,AZ,6280,56228,,697,1022,313,,191,,1345,c61443f5a5a14bd10e15d579fdf0ff8872ddb036,2020-04-25T20:00:00Z,266,1022,62508,62508,62508,04,0,38,1559,235,1794
20200425,CA,41137,464898,,4847,,1458,,,,,839b13775fa967aaa33b0e349cffe22cdd7ab01b,2020-04-25T20:00:00Z,1651,,506035,506035,506035,06,89,0,9979,1883,11862
20200425,CO,12256,44533,,1084,2366,,,,,2086,cc0d38ad3c6159b86e71f9ff63a59f26eb1322d4,2020-04-25T20:00:00Z,674,2366,56789,56789,56789,08,122,129,3471,994,4465
20200425,CT,24582,53020,,1810,,,,,,,a8ec4fc06435a938d908fb93e8ff9b97a6f1d512,2020-04-25T20:00:00Z,1862,,77602,77602,77602,09,98,0,2903,661,3564
20200425,DC,3699,13603,,402,,120,,69,,652,dd5619154709c8564b37abff92c5afa2ec907c59,2020-04-25T20:00:00Z,165,,17302,17302,17302,11,12,0,598,171,769
20200425,DE,3576,14122,,300,,,,,,809,ba98f1238ca631aaa590adf5e62e574a12559826,2020-04-25T20:00:00Z,112,,17698,17698,17698,10,12,0,185,134,319
20200425,FL,30839,302260,1292,,5045,,,,,,1609ffd293a3cab3e1429599cf9acea6f18cade6,2020-04-25T20:00:00Z,1075,5045,334391,333099,333099,12,44,157,15475,665,16140
20200425,GA,22695,96319,,,4326,,,,,,e6f8736561002b8c2af62ef508e632bfdb789123,2020-04-25T20:00:00Z,904,4326,119014,119014,119014,13,12,105,11290,548,11838
20200425,GU,141,1308,,2,,,,,,128,8e3e2d41fc749e986f3e65d2d479a658d208b9e6,2020-04-25T20:00:00Z,5,,1449,1449,1449,66,0,0,75,0,75
20200425,HI,601,27439,,,67,,,,,463,c2746fad3a6cb11433ab2726e41a5672eaa5b871,2020-04-25T20:00:00Z,13,67,28040,28040,28040,15,1,4,1148,5,1153
20200425,IA,5092,29258,,293,,108,,60,,1723,264ebddfa98b3c486df85933e6b60ebe9fc34c11,2020-04-25T20:00:00Z,112,,34350,34350,34350,19,5,0,1730,647,2377
20200425,ID,1870,17491,,,168,,71,,,867,3dc6ff044234336909ebc16235d21d42858cdcb1,2020-04-25T20:00:00Z,54,168,19361,19361,19361,16,0,2,236,34,270
20200425,IL,41777,159840,,4699,,1244,,763,,,ba7fe161ec0389af9dc3ddf392a3bd651270c6b5,2020-04-25T20:00:00Z,1874,,201617,201617,201617,17,79,0,9866,2119,11985
20200425,IN,14395,65379,,1515,,598,,324,,,b7f45b4815b1a040afe913eda4812107a789908e,2020-04-25T20:00:00Z,785,,79774,79774,79774,18,44,0,3506,715,4221
20200425,KS,3056,22143,,,474,,,,,,6b9610a5b753a1566b06c4371aa88aab5548c848,2020-04-25T20:00:00Z,117,474,25199,25199,25199,20,6,17,1332,279,1611
20200425,KY,3779,41183,,303,1143,164,575,,,1341,d65c3fe34449ef4d2f4b3329189d80e2896c7708,2020-04-25T20:00:00Z,200,1143,44962,44962,44962,21,9,28,1820,298,2118
20200425,LA,26512,112490,,1700,,,,268,,14927,e70b80052c8975c6f8567e7b313497a78f84401c,2020-04-25T20:00:00Z,1644,,139002,139002,139002,22,43,0,-5086,372,-4714
20200425,MA,53348,173497,,3879,4965,1058,,,,,64391fd07d2f7c57aa92b575f9447a62d86f0ab9,2020-04-25T20:00:00Z,2877,4965,226845,226845,226845,25,0,213,9253,2379,11632
20200425,MD,17766,71357,,1408,3760,538,,,,1165,4334376cfaf8d5dd4cf1cbba0115ff8f8fad143a,2020-04-25T20:00:00Z,875,3760,89123,89123,89123,24,77,142,3257,1150,4407
20200425,ME,990,16784,,39,156,17,,7,,519,47ffb431ec1afbc81d34228b415c1d17baab76db,2020-04-25T20:00:00Z,50,156,17774,17774,17774,23,3,4,0,25,25
20200425,MI,37203,106841,,2889,,1164,,934,,8342,dc1bafea9aa014dbbf0d912657e5715eea79221d,2020-04-25T20:00:00Z,3274,,144044,144044,144044,26,189,0,7186,562,7748
20200425,MN,3446,53151,,288,797,109,291,,,1654,92089bc29be8b94575d3b84aa548e54e49969b1a,2020-04-25T20:00:00Z,244,797,56597,56597,56597,27,23,41,2549,261,2810
20200425,MO,6826,60392,,850,,,,142,,,ba3ca27b8fb09128a3dc6677451a4e9e88fdeae7,2020-04-25T20:00:00Z,273,,67218,67218,67218,29,11,0,1810,201,2011
20200425,MP,14,51,,,,,,,,11,e516d249d904d0f0bc0a9e7f42ff895d45508042,2020-04-25T20:00:00Z,2,,65,65,65,69,0,0,0,0,0
20200425,MS,5718,53239,,649,996,152,,78,,,0da021ed66139f9c8fe06b9fc5393918e7de1de2,2020-04-25T20:00:00Z,221,996,58957,58957,58957,28,12,26,3003,284,3287
20200425,MT,445,12052,,11,61,,,,,339,9c904206f2bc989f7dad09a572b9b3e9f2eeb1ec,2020-04-25T20:00:00Z,14,61,12497,12497,12497,30,0,2,369,1,370
20200425,NC,8623,96642,,456,,,,,,,ca606046f9f34bf7a0f05e965b09e47995e79363,2020-04-25T20:00:00Z,289,,105265,105265,105265,37,20,0,4110,571,4681
20200425,ND,803,18547,,17,70,,,,,310,06a464071cf5f131d1f48513239ae724d8ab3a03,2020-04-25T20:00:00Z,16,70,19350,19350,19350,38,1,3,1846,55,1901
20200425,NE,2421,17552,,,,,,,,,40c243db5d40bdd35ab740282c6f1bec9a7355cc,2020-04-25T20:00:00Z,50,,19973,19973,19973,31,3,0,1064,297,1361
20200425,NH,1720,16007,398,89,224,,,,,578,a19672e20648acf4f39569520337eadae646b683,2020-04-25T20:00:00Z,53,224,18125,17727,17727,33,2,6,868,50,918
20200425,NJ,105523,108163,,6722,,1971,,1442,,,a516df8cf326348b3a6975e89ceaf80c38ad0c67,2020-04-25T20:00:00Z,5863,,213686,213686,213686,34,246,0,4397,3327,7724
20200425,NM,2521,48989,,152,412,,,,,614,673e2265aa9c9cb9ee329d8e1e3ec6585077517d,2020-04-25T20:00:00Z,84,412,51510,51510,51510,35,6,45,4805,142,4947
20200425,NV,4539,32669,,,,,,,,,2fa4c865e5b369805e6a0976a6ce1b9b9d19bd8c,2020-04-25T20:00:00Z,204,,37208,37208,37208,32,7,0,875,141,1016
20200425,NY,282143,495425,,13524,61459,5016,,,,47935,c826721681bdab8a913804e48543e01efaba28a6,2020-04-25T20:00:00Z,16599,61459,777568,777568,777568,36,437,1045,36359,10553,46912
20200425,OH,14983,96396,,,3115,,938,,,,d094f58fc899f0a339005df517a284702d75861d,2020-04-25T20:00:00Z,711,3115,111379,111379,111379,39,21,62,3868,402,4270
20200425,OK,3193,49891,,306,637,150,,,,2080,3b7e449893a2fd060cffdc851a0cd942d4afe61c,2020-04-25T20:00:00Z,194,637,53084,53084,53084,40,6,0,6872,72,6944
20200425,OR,2253,45124,,261,536,60,,29,,,f9b4dcb4a8cb42caacdf3662769e804f944700e9,2020-04-25T20:00:00Z,87,536,47377,47377,47377,41,1,16,1809,76,1885
20200425,PA,40049,152886,,2748,,,,640,,,2efa8bed58b17061bbc8b61bdeee341df638f22b,2020-04-25T20:00:00Z,1537,,192935,192935,192935,42,45,0,5395,1397,6792
20200425,PR,1307,9313,1940,,,,,,,,fe91c8e2f957b3513e641211ff7d12c67662ea2c,2020-04-25T20:00:00Z,83,,12560,10620,10620,72,6,0,0,31,31
20200425,RI,7129,43762,,263,576,77,,52,,410,3953284c29fdb2b45397641e696e87c3010a8f20,2020-04-25T20:00:00Z,215,576,50891,50891,50891,44,13,0,3204,430,3634
20200425,SC,5253,43761,,,944,,,,,3701,66da9ea041e7effddcfe6545b94de7336b8ab0d8,2020-04-25T20:00:00Z,166,944,49014,49014,49014,45,16,107,4215,336,4551
20200425,SD,2147,13449,,61,128,,,,,1223,8da3a0a1659d04e0f5524310f4648b416336b7b5,2020-04-25T20:00:00Z,10,128,15596,15596,15596,46,0,4,665,107,772
20200425,TN,9189,132217,,,821,,,,,4467,ef879c5400e27cd1f2717feae30fd54cdcd53386,2020-04-25T20:00:00Z,178,821,141406,141406,141406,47,10,13,9615,463,10078
20200425,TX,23773,239043,,1597,,,,,,9986,3edb66bcce3c0625bc232c42f08bdaf8e3a9286f,2020-04-25T20:00:00Z,623,,262816,262816,262816,48,30,0,19302,967,20269
20200425,UT,3948,86258,,,329,,,,,1399,bbea883fb0181f8578a0df87ad7f41756d31d278,2020-04-25T20:00:00Z,41,329,90206,90206,90206,49,2,14,5343,166,5509
20200425,VA,11902,60276,1405,1405,1942,357,,223,,1717,94d67b6145b25b3834839ac0d078d89b791fddee,2020-04-25T20:00:00Z,436,1942,73583,72178,72178,51,26,105,2430,733,3163
20200425,VI,55,693,22,,,,,,,51,00132eda04881de96d2965f39eee3fac7d9ea5eb,2020-04-25T20:00:00Z,3,,770,748,748,78,0,0,51,1,52
20200425,VT,843,13839,,37,,,,,,,7077af30889c12fda69f285fa17527dc0c0b64c4,2020-04-25T20:00:00Z,46,,14682,14682,14682,50,2,0,356,16,372
20200425,WA,13521,161919,,455,,174,,,,,7a40ea37798832b9702a3b81700c4bdbe2b7f50a,2020-04-25T20:00:00Z,665,,175440,175440,175440,53,6,0,386,224,610
20200425,WI,5687,57138,241,337,1376,136,353,,,,f0c33a725adc99f14667cda2c4c004597f625b74,2020-04-25T20:00:00Z,266,1376,63066,62825,62825,55,4,23,2565,331,2896
20200425,WV,1020,31946,,97,,36,,19,,439,4761239a47832524693c2a885c4e405e8e6f74d0,2020-04-25T20:00:00Z,32,,32966,32966,32966,54,0,0,3123,32,3155
20200425,WY,349,7797,,16,54,,,,,321,610d62bfb3794b39e277a9b63e9514be268f7b53,2020-04-25T20:00:00Z,7,54,8146,8146,8146,56,0,0,101,0,101
20200424,AK,339,11942,,36,,,,,,208,0b9cdafd1d82e743b065f4cd36e3a4f97a0d0f0e,2020-04-24T20:00:00Z,9,,12281,12281,12281,02,0,0,118,2,120
20200424,AL,5832,46863,,,768,,288,,170,,9d8fbcc7573f833b3b7e9936e784ac0bdee267f4,2020-04-24T20:00:00Z,197,768,52695,52695,52695,01,0,0,0,54,54
20200424,AR,2741,32837,,101,291,,,24,57,929,8019de595733d1e5650d3be233a479378a4a29bf,2020-04-24T20:00:00Z,45,291,35578,35578,35578,05,0,0,3712,276,3988
20200424,AS,0,3,17,,,,,,,,aa59004e05304324850c80a3cf7e8d3c7f92c3c3,2020-04-24T20:00:00Z,,,20,3,3,60,0,0,0,0,0
20200424,AZ,6045,54669,,639,984,332,,186,,1313,5ce13a11a96830ada8b9956376db507f09a391d3,2020-04-24T20:00:00Z,266,984,60714,60714,60714,04,17,984,1741,276,2017
20200424,CA,39254,454919,,4880,,1521,,,,,92b2177ee03e94d3b0f5ce2ca074415cc2cce85c,2020-04-24T20:00:00Z,1562,,494173,494173,494173,06,93,0,10191,1885,12076
20200424,CO,11262,41062,,1084,2237,,,,,,3b2060d8ade87af0f65000ee751f8f51c760ba36,2020-04-24T20:00:00Z,552,2237,52324,52324,52324,08,44,114,1295,384,1679
20200424,CT,23921,50117,,1877,,,,,,,8ddae8d7972a258d777dc46ee8bfbf4050431559,2020-04-24T20:00:00Z,1764,,74038,74038,74038,09,125,0,1720,821,2541
20200424,DC,3528,13005,,402,,120,,69,,651,391cd8cee3de9f7fe396c2655c15cf0db79d906b,2020-04-24T20:00:00Z,153,,16533,16533,16533,11,14,0,436,167,603
20200424,DE,3442,13937,,277,,,,,,703,c1596bffa65afeb5e92b852fd6c03c0ff18dcc8f,2020-04-24T20:00:00Z,100,,17379,17379,17379,10,8,0,333,134,467
20200424,FL,30174,286785,1287,,4888,,,,,,fa890ad76821cb6ad5e9791783d145d97a0810e3,2020-04-24T20:00:00Z,1031,4888,318246,316959,316959,12,52,195,18909,1342,20251
20200424,GA,22147,85029,,,4221,,,,,,11676a98fdace28912ee10f1b83d65e36e83ee0f,2020-04-24T20:00:00Z,892,4221,107176,107176,107176,13,20,152,5479,635,6114
20200424,GU,141,1233,,2,,,,,,126,bf2807c4fcbd5953c89031fc92c07eb3b91d54b1,2020-04-24T20:00:00Z,5,,1374,1374,1374,66,0,0,53,6,59
20200424,HI,596,26291,,,63,,,,,455,75e2e4832df0d3c479cf2d0f86fb7539d3db77c5,2020-04-24T20:00:00Z,12,63,26887,26887,26887,15,0,0,755,4,759
20200424,IA,4445,27528,,278,,104,,60,,1604,a027b7e49ed889fef7cc93da51537d75d749e4c0,2020-04-24T20:00:00Z,107,,31973,31973,31973,19,11,0,2190,521,2711
20200424,ID,1836,17255,,,166,,63,,,822,3257af47faf310d2ac6c6679ef341524b31192a5,2020-04-24T20:00:00Z,54,166,19091,19091,19091,16,0,4,965,34,999
20200424,IL,39658,149974,,4828,,1225,,709,,,23545033f0633a7a83aae2b786efe9e74becc07d,2020-04-24T20:00:00Z,1795,,189632,189632,189632,17,107,0,13592,2724,16316
20200424,IN,13680,61873,,,,621,,325,,,03de8bae789b8e1f51090efc98b257e70ec01402,2020-04-24T20:00:00Z,741,,75553,75553,75553,18,35,0,2872,641,3513
20200424,KS,2777,20811,,,457,,,,,,900ef54698b0559a064c07ec32eb20f834b5b266,2020-04-24T20:00:00Z,111,457,23588,23588,23588,20,-1,15,1975,295,2270
20200424,KY,3481,39363,,302,1115,163,570,,,1335,3970f63ef7035af81d9398932b013c132bef9490,2020-04-24T20:00:00Z,191,1115,42844,42844,42844,21,6,10,6661,108,6769
20200424,LA,26140,117576,,1697,,,,286,,14927,761eb87ac93499b5fb06a6e97831509ba059a93a,2020-04-24T20:00:00Z,1601,,143716,143716,143716,22,61,0,0,401,401
20200424,MA,50969,164244,,3847,4752,1034,,,,,53c1331a49e67ba4fa2e906460b840e66d8c6483,2020-04-24T20:00:00Z,2877,4752,215213,215213,215213,25,108,259,7920,2977,10897
20200424,MD,16616,68100,,1425,3618,547,,,,1108,ebd5ef92f9c25522834cf6c4f70473db25f58ad0,2020-04-24T20:00:00Z,798,3618,84716,84716,84716,24,50,141,3737,879,4616
20200424,ME,965,16784,,39,152,17,,7,,499,c7a47fb0ed98211cf2097f3a6b07693314af72f8,2020-04-24T20:00:00Z,47,152,17749,17749,17749,23,3,2,0,28,28
20200424,MI,36641,99655,,3022,,1176,,965,,3237,923220558245c03c017947c499c8fc1783dbc2d8,2020-04-24T20:00:00Z,3085,,136296,136296,136296,26,108,0,6625,1350,7975
20200424,MN,3185,50602,,278,756,111,281,,,1594,c5ce2838a0ba69d5ff19e9c7c90f569983b4f9b3,2020-04-24T20:00:00Z,221,756,53787,53787,53787,27,21,44,1996,243,2239
20200424,MO,6625,58582,,877,,,,,,,432e7f6c2db692492d977adee9b8e105c1a79c52,2020-04-24T20:00:00Z,262,,65207,65207,65207,29,44,0,5453,304,5757
20200424,MP,14,51,,,,,,,,11,47f92b8e1dfef312fe5135e5e74647abee147c50,2020-04-24T20:00:00Z,2,,65,65,65,69,0,0,0,0,0
20200424,MS,5434,50236,,586,970,148,,74,,,73144c02bd3cb13a6b64e64d9defc72c4595c7a4,2020-04-24T20:00:00Z,209,970,55670,55670,55670,28,8,24,0,281,281
20200424,MT,444,11683,,12,59,,,,,325,8c4ba70b117f00d2ba00a7f151047821957db57f,2020-04-24T20:00:00Z,14,59,12127,12127,12127,30,0,0,250,2,252
20200424,NC,8052,92532,,477,,,,,,,eb5de48c27ec8fc857469c70eaa10511a29576e2,2020-04-24T20:00:00Z,269,,100584,100584,100584,37,16,0,3955,444,4399
20200424,ND,748,16701,,17,67,,,,,285,3890e0e4d2886291332c57ca0a8fcf9338041230,2020-04-24T20:00:00Z,15,67,17449,17449,17449,38,0,2,1080,39,1119
20200424,NE,2124,16488,,,,,,,,,c18de36cb2defc78b7b566e2c2f5a111d2f27c0d,2020-04-24T20:00:00Z,47,,18612,18612,18612,31,2,0,941,311,1252
20200424,NH,1670,15139,424,92,218,,,,,551,14567594704ba326371b7cf3026e60c0d1227cca,2020-04-24T20:00:00Z,51,218,17233,16809,16809,33,3,5,715,82,797
20200424,NJ,102196,103766,,6847,,1933,,1487,,,faf3e71e884663da3255fb21eface8a0fbb0675e,2020-04-24T20:00:00Z,5617,,205962,205962,205962,34,249,0,3607,2207,5814
20200424,NM,2379,44184,,123,367,,,,,573,bd558092c97d55580677a4dee402fda0a4e35e4e,2020-04-24T20:00:00Z,78,367,46563,46563,46563,35,7,36,5162,169,5331
20200424,NV,4398,31794,,,,,,,,,d31ce3c60d63a831d401336bcc308933cc18df5f,2020-04-24T20:00:00Z,197,,36192,36192,36192,32,8,0,1253,190,1443
20200424,NY,271590,459066,,14258,60414,5016,,,,46156,8c8b938ac222cb1c860ab74555d0d6e0710763c6,2020-04-24T20:00:00Z,16162,60414,730656,730656,730656,36,422,1149,26606,8130,34736
20200424,OH,14581,92528,,,3053,,920,,,,34a0e895b9461e74bc985ce29bdbd2a08429ac08,2020-04-24T20:00:00Z,690,3053,107109,107109,107109,39,34,93,4345,439,4784
20200424,OK,3121,43019,,310,637,155,,,,1961,45eb43e3b66718cb54ab3ba16ff06633636cac4d,2020-04-24T20:00:00Z,188,637,46140,46140,46140,40,9,15,0,104,104
20200424,OR,2177,43315,,258,520,56,,29,,,996ff852af8a8e4293af5cbda7a30aae5c5c2e3a,2020-04-24T20:00:00Z,86,520,45492,45492,45492,41,3,8,1466,50,1516
20200424,PA,38652,147491,,2746,,,,679,,,da71f159cd15244f6531bc01d2a99839c380f182,2020-04-24T20:00:00Z,1492,,186143,186143,186143,42,71,0,5430,1599,7029
20200424,PR,1276,9313,1940,,,,,,,,cf7513dca75d6f6a4cdcabcf6d98e0025b40b927,2020-04-24T20:00:00Z,77,,12529,10589,10589,72,8,0,0,361,361
20200424,RI,6699,40558,,267,576,77,,48,,377,47724873281d1d1b01f776aed68c135bddab0703,2020-04-24T20:00:00Z,202,576,47257,47257,47257,44,13,0,2395,443,2838
20200424,SC,4917,39546,,,837,,,,,3317,cf04cfa9bafffa432f94988977a03941e3544354,2020-04-24T20:00:00Z,150,837,44463,44463,44463,45,0,0,0,0,0
20200424,SD,2040,12784,,61,124,,,,,1190,fe0f0713d07adde74acc0e3c70e19c3a547f8011,2020-04-24T20:00:00Z,10,124,14824,14824,14824,46,1,5,675,84,759
20200424,TN,8726,122602,,,808,,,,,4370,ff1cd14610486e269b9f1930e3710a3a2f625f40,2020-04-24T20:00:00Z,168,808,131328,131328,131328,47,-2,15,7768,460,8228
20200424,TX,22806,219741,,1674,,,,,,9156,96ecb2969e502271181b7c335c617bb543a74429,2020-04-24T20:00:00Z,593,,242547,242547,242547,48,32,0,16607,862,17469
20200424,UT,3782,80915,,,315,,,,,1252,37e48caa71b06a19b7f87b860a87a7384ef07d57,2020-04-24T20:00:00Z,39,315,84697,84697,84697,49,4,14,3900,170,4070
20200424,VA,11169,57846,487,1399,1837,379,,220,,1672,3f402e7509a8c6d530e6725517c7d6888f02a03a,2020-04-24T20:00:00Z,410,1837,69502,69015,69015,51,38,84,3955,542,4497
20200424,VI,54,642,35,,,,,,,50,014777707f67a49611620f95bcdcc4c646dcb32e,2020-04-24T20:00:00Z,3,,731,696,696,78,0,0,59,0,59
20200424,VT,827,13483,,32,,,,,,,4e15763bc9f58653bdcd1f50ac1adfe7ebf514ea,2020-04-24T20:00:00Z,44,,14310,14310,14310,50,1,0,456,2,458
20200424,WA,13297,161533,,551,,164,,,,,46f925587d10b0a54efab8bb208383696c130722,2020-04-24T20:00:00Z,659,,174830,174830,174830,53,5,0,2897,302,3199
20200424,WI,5356,54573,206,361,1353,143,346,,,,cd1c02eb6fa254fabc1c9046c62cf01460252fc0,2020-04-24T20:00:00Z,262,1353,60135,59929,59929,55,5,35,3117,304,3421
20200424,WV,988,28823,,97,,36,,19,,439,591be5be8c38d5498583029ebc11983c759fbe2f,2020-04-24T20:00:00Z,32,,29811,29811,29811,54,3,0,1885,21,1906
20200424,WY,349,7696,,16,54,,,,,321,1a890b6acca5a517e72bb6657dec64e367e60318,2020-04-24T20:00:00Z,7,54,8045,8045,8045,56,0,2,455,23,478
20200423,AK,337,11824,,42,,,,,,209,59a03ea91067d205ddc33b0e77890986c467ae17,2020-04-23T20:00:00Z,9,,12161,12161,12161,02,0,0,0,2,2
20200423,AL,5778,46863,,,768,,288,,170,,78a9b97c7fb690ae69dcfa0f2e6a789f0ca0171b,2020-04-23T20:00:00Z,197,768,52641,52641,52641,01,3,38,3568,313,3881
20200423,AR,2465,29125,,101,291,,,24,57,902,bd177e23b3ca561ac31a19a983ccf50f778418a8,2020-04-23T20:00:00Z,45,291,31590,31590,31590,05,3,0,1688,189,1877
20200423,AS,0,3,17,,,,,,,,7c31cc9e7b2d28fc0c28bc256c0b308db76eb64d,2020-04-23T20:00:00Z,,,20,3,3,60,0,0,0,0,0
20200423,AZ,5769,52928,,699,,305,,201,,1282,51879cc631415d5645d3798bf6a354bad9d85098,2020-04-23T20:00:00Z,249,,58697,58697,58697,04,20,0,1786,310,2096
20200423,CA,37369,444728,,4929,,1531,,,,,eccfc506140d6c27c2c6c46e6c69e5a874433028,2020-04-23T20:00:00Z,1469,,482097,482097,482097,06,115,0,14797,1973,16770
20200423,CO,10878,39767,,859,2123,,,,,,951c9b0fd52846205397a6106ad8599d53da1ad0,2020-04-23T20:00:00Z,508,2123,50645,50645,50645,08,22,120,1510,431,1941
20200423,CT,23100,48397,,1947,,,,,,,5992678999a7d5ef8b2297241fc9af3ab3db6207,2020-04-23T20:00:00Z,1639,,71497,71497,71497,09,95,0,948,631,1579
20200423,DC,3361,12569,,402,,120,,200,,648,72dcd05b81106507a4b294d05d6c1b9a7f54e24e,2020-04-23T20:00:00Z,139,,15930,15930,15930,11,12,0,273,155,428
20200423,DE,3308,13604,,290,,,,,,643,ac5dc066723ea288a993943ed710da099f74ef9a,2020-04-23T20:00:00Z,92,,16912,16912,16912,10,3,0,251,108,359
20200423,FL,28832,267876,1301,,4693,,,,,,3ba322cf9574a404507b53da1d1a3b614ebb7edf,2020-04-23T20:00:00Z,979,4693,298009,296708,296708,12,69,224,7558,523,8081
20200423,GA,21512,79550,,,4069,,,,,,35914be999993cf4648e58b6412ac0a59debca47,2020-04-23T20:00:00Z,872,4069,101062,101062,101062,13,36,110,6218,772,6990
20200423,GU,135,1180,,2,,,,,,126,33446da4ca15b06922f36ce426c3d6501257e857,2020-04-23T20:00:00Z,5,,1315,1315,1315,66,0,0,94,1,95
20200423,HI,592,25536,,,63,,,,,444,f9b8c542c68f9ac40215d0074fab036ab927832b,2020-04-23T20:00:00Z,12,63,26128,26128,26128,15,0,7,776,10,786
20200423,IA,3924,25338,,282,,102,,55,,1492,2f57b0c1c91300dcdcce90d1cf8e34677e2ccd34,2020-04-23T20:00:00Z,96,,29262,29262,29262,19,6,0,842,176,1018
20200423,ID,1802,16290,,,162,,60,,,767,b757b69da6b057e2b0dab77c9af64e77496ded45,2020-04-23T20:00:00Z,54,162,18092,18092,18092,16,3,4,326,36,362
20200423,IL,36934,136382,,4877,,1268,,766,,,c877cdfb8918f0fd0fef4f7e8fdc1533029089f7,2020-04-23T20:00:00Z,1688,,173316,173316,173316,17,123,0,7144,1826,8970
20200423,IN,13039,59001,,,,652,,333,,,41aa8a245965eec8c20014cab47e6b20f4c8d32e,2020-04-23T20:00:00Z,706,,72040,72040,72040,18,45,0,1969,601,2570
20200423,KS,2482,18836,,,442,,,,,,8914a9cc9531a63ffb3cf1c02d945d0667084924,2020-04-23T20:00:00Z,112,442,21318,21318,21318,20,2,10,844,271,1115
20200423,KY,3373,32702,,301,1105,161,564,,,1311,e2aacff8a5e9eabe7918b815ad4558585c306d6a,2020-04-23T20:00:00Z,185,1105,36075,36075,36075,21,14,29,2566,181,2747
20200423,LA,25739,117576,,1727,,,,274,,,1ad45a496a09b4651310c715c7c3f6d771121f01,2020-04-23T20:00:00Z,1540,,143315,143315,143315,22,67,0,0,481,481
20200423,MA,47992,156324,,3851,4493,1034,,,,,2b497a71d0fc88817b7016fb51edaede26c804fa,2020-04-23T20:00:00Z,2769,4493,204316,204316,204316,25,172,237,11535,3079,14614
20200423,MD,15737,64363,,1405,3477,515,,,,1040,99cd5fdf1a12129b3862f58f0c681ab83f0af3c5,2020-04-23T20:00:00Z,748,3477,80100,80100,80100,24,117,152,2609,962,3571
20200423,ME,937,16784,,42,150,18,,11,,485,6c869cbae85b6106924d5dc464b6681fa01d97bd,2020-04-23T20:00:00Z,44,150,17721,17721,17721,23,5,6,0,30,30
20200423,MI,35291,93030,,3611,,1148,,1027,,3237,1e1b7f955a01792c910e4e4aa917e2c08cc6c6bc,2020-04-23T20:00:00Z,2977,,128321,128321,128321,26,164,0,8771,1325,10096
20200423,MN,2942,48606,,268,712,104,274,,,1536,77ead2e737d28379a3c18e4ce8a3d643858858ef,2020-04-23T20:00:00Z,200,712,51548,51548,51548,27,21,52,1983,221,2204
20200423,MO,6321,53129,,884,,,,,,,48e48812ff001c374231449a834049dbba052d95,2020-04-23T20:00:00Z,218,,59450,59450,59450,29,10,0,1110,184,1294
20200423,MP,14,51,,,,,,,,11,f8895b560c75d346cec0fcd0b01b315dc33e5843,2020-04-23T20:00:00Z,2,,65,65,65,69,0,0,0,0,0
20200423,MS,5153,50236,,595,946,156,,78,,,d26dcf04ba8de0169951fbbc06275b175ad5e510,2020-04-23T20:00:00Z,201,946,55389,55389,55389,28,8,36,1295,259,1554
20200423,MT,442,11433,,13,59,,,,,306,3e1927838461f9d67a17151a1b875d7b32c5e049,2020-04-23T20:00:00Z,14,59,11875,11875,11875,30,0,0,289,3,292
20200423,NC,7608,88577,,486,,,,,,,bbf9bdc14956aaa478b0fb2f52cdb24cc7e80af2,2020-04-23T20:00:00Z,253,,96185,96185,96185,37,11,0,5461,388,5849
20200423,ND,709,15621,,18,65,,,,,269,7fc1a021491fdba4639bcc64f3fd6069ab8decd4,2020-04-23T20:00:00Z,15,65,16330,16330,16330,38,1,3,711,30,741
20200423,NE,1813,15547,,,,,,,,,f2fd230daa72e688681febd9ff6169824ff5dbdd,2020-04-23T20:00:00Z,45,,17360,17360,17360,31,7,0,590,91,681
20200423,NH,1588,14424,265,91,213,,,,,550,2209e432aa2d24a070e051a80b6edfc571c3df64,2020-04-23T20:00:00Z,48,213,16277,16012,16012,33,6,7,874,97,971
20200423,NJ,99989,100159,,7240,,1990,,1462,,,bacfc6e489570442eea13e5a50c80950924f48b6,2020-04-23T20:00:00Z,5368,,200148,200148,200148,34,305,0,4365,4124,8489
20200423,NM,2210,39022,,121,331,,,,,547,b2fe34c110d328badefbe2bc59e124a91496c1ad,2020-04-23T20:00:00Z,71,331,41232,41232,41232,35,6,25,217,138,355
20200423,NV,4208,30541,,,,,,,,,2c1813b9cfe100470c90d449bdd539fa36ce944a,2020-04-23T20:00:00Z,189,,34749,34749,34749,32,17,0,734,127,861
20200423,NY,263460,432460,,15021,59265,5016,,,,44244,9d05b5bc234a81e01ea48b6b048202fd9a70f947,2020-04-23T20:00:00Z,15740,59265,695920,695920,695920,36,438,1358,19694,6244,25938
20200423,OH,14142,88183,,,2960,,900,,,,df903b7ce15ac22749d5b6e985b304d3dfd5225f,2020-04-23T20:00:00Z,656,2960,102325,102325,102325,39,46,78,3794,533,4327
20200423,OK,3017,43019,,284,622,156,,,,1884,73483ad72dbf7359d6fd1100f76a5e6d346ff606,2020-04-23T20:00:00Z,179,622,46036,46036,46036,40,9,34,0,123,123
20200423,OR,2127,41849,,304,512,74,,36,,,a42174d07b916ab1e53bcfb9f972cd4352208b84,2020-04-23T20:00:00Z,83,512,43976,43976,43976,41,5,24,2723,68,2791
20200423,PA,37053,142061,,2750,,,,679,,,2ac8c703c54afb90d9b82d2b6e415c4ff5a5882b,2020-04-23T20:00:00Z,1421,,179114,179114,179114,42,-201,0,5789,1369,7158
20200423,PR,915,9313,1951,,,,,,,,bcd4a4a30d22306240afc42cba0e4c8382065ec3,2020-04-23T20:00:00Z,69,,12179,10228,10228,72,2,0,471,0,471
20200423,RI,6256,38163,,267,576,72,,45,,342,287d363ac81742fe94cd704d82b4061d37b17071,2020-04-23T20:00:00Z,189,576,44419,44419,44419,44,8,0,2282,415,2697
20200423,SC,4917,39546,,,837,,,,,3317,ad9c0d4b3f0603214bbfd86f321618fd3fe71293,2020-04-23T20:00:00Z,150,837,44463,44463,44463,45,10,0,1196,156,1352
20200423,SD,1956,12109,,58,119,,,,,1064,96707585cf451dd251e90bb5c7efd8bc85664d72,2020-04-23T20:00:00Z,9,119,14065,14065,14065,46,1,8,521,98,619
20200423,TN,8266,114834,,,793,,,,,4193,98c0d438a93613acd8a010874b94cdd4c459e889,2020-04-23T20:00:00Z,170,793,123100,123100,123100,47,4,18,7696,424,8120
20200423,TX,21944,203134,,1649,,,,,,8025,595c3ac676dde2fd5ad65d57f664bd3549aa03ac,2020-04-23T20:00:00Z,561,,225078,225078,225078,48,18,0,7420,875,8295
20200423,UT,3612,77015,,,301,,,,,1050,e522a322f86c92b93f6b7d8152dcb81a167b3f4d,2020-04-23T20:00:00Z,35,301,80627,80627,80627,49,1,13,4000,167,4167
20200423,VA,10627,53891,492,1379,1753,400,,249,,1567,01de09d9974c76207a644dc64bdb24ba34ff2ca1,2020-04-23T20:00:00Z,372,1753,65010,64518,64518,51,23,94,3379,361,3740
20200423,VI,54,583,31,,,,,,,48,8cdd69b69a346fa00fcbcaefd686f1f180dfcc01,2020-04-23T20:00:00Z,3,,668,637,637,78,0,0,0,0,0
20200423,VT,825,13027,,44,,,,,,,fb86e2e2da32b02fc73b0d9c6689dd325bf1a032,2020-04-23T20:00:00Z,43,,13852,13852,13852,50,3,0,388,2,390
20200423,WA,12995,158636,,544,,151,,,,,476f7dc780f31b395f1ed39396bee157740778bd,2020-04-23T20:00:00Z,654,,171631,171631,171631,53,7,0,3457,210,3667
20200423,WI,5052,51456,201,349,1318,146,342,,,,887d8ba88412dbf71f9991bb452a51cc602551a9,2020-04-23T20:00:00Z,257,1318,56709,56508,56508,55,11,16,1954,207,2161
20200423,WV,967,26938,,108,,44,,24,,380,68e08a56ec77bd4371a5b9f3d88fd511ceed31fe,2020-04-23T20:00:00Z,29,,27905,27905,27905,54,3,0,2041,28,2069
20200423,WY,326,7241,,,52,,,,,275,726fb1321e617cbd2ba7b1408f0a7c1d5aac14b4,2020-04-23T20:00:00Z,7,52,7567,7567,7567,56,1,0,-60,4,-56
20200422,AK,335,11824,,39,36,,,,,196,67838ce525ff91e697603d8a18cbd34dfee4bda2,2020-04-22T20:00:00Z,9,36,12159,12159,12159,02,0,0,1034,6,1040
20200422,AL,5465,43295,,,730,,288,,170,,30072566e40dbd50379cb264023c0557ca771763,2020-04-22T20:00:00Z,194,730,48760,48760,48760,01,17,31,0,234,234
20200422,AR,2276,27437,,97,291,,,23,57,863,2ca508f112fb6c88a1351199b82f167554e25d1e,2020-04-22T20:00:00Z,42,291,29713,29713,29713,05,-1,0,2223,49,2272
20200422,AS,0,3,17,,,,,,,,be2004b5531125c7d1afafb0f304da440c7c4353,2020-04-22T20:00:00Z,,,20,3,3,60,0,0,0,0,0
20200422,AZ,5459,51142,,664,,300,,195,,1265,c37cfe22570db99f0291554055f45f06541b3af3,2020-04-22T20:00:00Z,229,,56601,56601,56601,04,21,0,1241,208,1449
20200422,CA,35396,429931,,4984,,1551,,,,,773232f6cb8a7d915ce247a32f45b4f3723b638a,2020-04-22T20:00:00Z,1354,,465327,465327,465327,06,86,0,163092,2135,165227
20200422,CO,10447,38257,,851,2003,,,,,,3f7e7acba50a1ed4237da788ae570ba65071812a,2020-04-22T20:00:00Z,486,2003,48704,48704,48704,08,37,123,897,341,1238
20200422,CT,22469,47449,,1972,,,,,,,4a0dfde544802f68208579d8734b333cc4b9ea99,2020-04-22T20:00:00Z,1544,,69918,69918,69918,09,121,0,3617,2109,5726
20200422,DC,3206,12296,,402,,120,,69,,645,41dc68d78fc7c9cb9d59d5715dad29d717fd42f7,2020-04-22T20:00:00Z,127,,15502,15502,15502,11,15,0,455,108,563
20200422,DE,3200,13353,,269,,,,,,599,732f6952f3c5017dc17e8c792823028c2360c977,2020-04-22T20:00:00Z,89,,16553,16553,16553,10,7,0,-372,269,-103
20200422,FL,28309,260318,1258,,4469,,,,,,ff3403374f6ef6a6101f7f53793be4d41973c3f3,2020-04-22T20:00:00Z,910,4469,289885,288627,288627,12,54,234,10754,814,11568
20200422,GA,20740,73332,,,3959,,,,,,d19c77af4ab1e054fc09ae6d03f94e611d1f87fe,2020-04-22T20:00:00Z,836,3959,94072,94072,94072,13,37,180,5073,859,5932
20200422,GU,134,1086,,3,,2,,,,119,557df63373c44246af8793dab7b4f4fc970eff8b,2020-04-22T20:00:00Z,5,,1220,1220,1220,66,0,0,53,1,54
20200422,HI,582,24760,,,56,,,,,437,3e7bad690dd39f057ff77c1a3de466a04e750eb7,2020-04-22T20:00:00Z,12,56,25342,25342,25342,15,2,1,648,-2,646
20200422,IA,3748,24496,,272,,92,,57,,1428,852074c0ecbb6ace525096033c5b0251175dcb5d,2020-04-22T20:00:00Z,90,,28244,28244,28244,19,7,0,522,107,629
20200422,ID,1766,15964,,,158,,58,,,710,1c6afa273193b88f4ddc24cf3d2b5b020aae3fa0,2020-04-22T20:00:00Z,51,158,17730,17730,17730,16,3,1,40,30,70
20200422,IL,35108,129238,,4665,,1220,,747,,,0372392446bfb9441f1fc04ff3a7dfb8fc875317,2020-04-22T20:00:00Z,1565,,164346,164346,164346,17,97,0,7300,2049,9349
20200422,IN,12438,57032,,,,633,,334,,,926b8f7bb7554be9a6e99cd7e468e0caefaca4e4,2020-04-22T20:00:00Z,661,,69470,69470,69470,18,31,0,1865,341,2206
20200422,KS,2211,17992,,,432,,,,,,456014232e36fb91c21c21aa9febc3122214389e,2020-04-22T20:00:00Z,110,432,20203,20203,20203,20,3,13,916,186,1102
20200422,KY,3192,30136,,286,1076,165,558,,,1266,cc6b60504396551f42726b0ecf9d3cdc72b2c1a8,2020-04-22T20:00:00Z,171,1076,33328,33328,33328,21,17,17,366,142,508
20200422,LA,25258,117576,,1747,,,,287,,,19be1bd59dbf8234fbc24aaff741a97f9038a268,2020-04-22T20:00:00Z,1473,,142834,142834,142834,22,68,0,0,404,404
20200422,MA,44913,144789,,3890,4256,1050,,,,,cbede4bbb0f5c15021f0b5294ab3af36ade9847b,2020-04-22T20:00:00Z,2597,4256,189702,189702,189702,25,148,247,3345,1745,5090
20200422,MD,14775,61754,,1432,3325,527,,,,981,e26d6343fb1297e4af61be1c7aa39a69a27ac7fe,2020-04-22T20:00:00Z,631,3325,76529,76529,76529,24,47,167,2312,582,2894
20200422,ME,907,16784,,42,144,18,,10,,455,988383238139014683890477a7617bad2c218775,2020-04-22T20:00:00Z,39,144,17691,17691,17691,23,3,5,2708,19,2727
20200422,MI,33966,84259,,3305,,1350,,1065,,3237,f16af44eafa16d95c6c4089edf972beff6ec8271,2020-04-22T20:00:00Z,2813,,118225,118225,118225,26,113,0,0,999,999
20200422,MN,2721,46623,,240,660,107,262,,,1317,c229760eeaecd3e0f89a64b60dd55b0a5cc64e78,2020-04-22T20:00:00Z,179,660,49344,49344,49344,27,19,31,1493,154,1647
20200422,MO,6137,52019,,1001,,,,,,,35a73f53b0a0d35e6822d4bdc5b40d56f461659d,2020-04-22T20:00:00Z,208,,58156,58156,58156,29,19,0,840,196,1036
20200422,MP,14,51,,,,,,,,11,540e46fa4bb76c4ab5160d92985ce9eb860963cb,2020-04-22T20:00:00Z,2,,65,65,65,69,0,0,0,0,0
20200422,MS,4894,48941,,628,910,162,,86,,,103ca03e2c13f06e80906d32c0f9c08939836f62,2020-04-22T20:00:00Z,193,910,53835,53835,53835,28,10,52,1293,178,1471
20200422,MT,439,11144,,13,59,,,,,296,33bffc0beb1f1f60d5c069f46385261805790397,2020-04-22T20:00:00Z,14,59,11583,11583,11583,30,2,0,340,2,342
20200422,NC,7220,83116,,434,,,,,,,060d914673ad86ebfbe9f63da4016cf41bbcfb29,2020-04-22T20:00:00Z,242,,90336,90336,90336,37,29,0,6736,269,7005
20200422,ND,679,14910,,23,62,,,,,229,eaf19b04bac7a012792bdccdb062bca9d4a6c49d,2020-04-22T20:00:00Z,14,62,15589,15589,15589,38,1,8,567,35,602
20200422,NE,1722,14957,,,,,,,,,ff59643fc0fd1b8bd484f52955b851efc8b9a473,2020-04-22T20:00:00Z,38,,16679,16679,16679,31,5,0,233,74,307
20200422,NH,1491,13550,225,94,206,,,,,546,c4ac07e77350805afafeccd9476abfe068ddcfab,2020-04-22T20:00:00Z,42,206,15266,15041,15041,33,0,0,702,0,702
20200422,NJ,95865,95794,,7210,,1983,,1570,,,b551e40bb5a294b994122858cdd140c1f2b81fb1,2020-04-22T20:00:00Z,5063,,191659,191659,191659,34,310,0,3355,3478,6833
20200422,NM,2072,38805,,119,306,,,,,529,d0e86efadb91d97c2b5b691831cc63e878627ece,2020-04-22T20:00:00Z,65,306,40877,40877,40877,35,7,15,2021,101,2122
20200422,NV,4081,29807,,,,,,,,,78fe226417f91248f04a310d82d2cdf160283a81,2020-04-22T20:00:00Z,172,,33888,33888,33888,32,9,0,689,144,833
20200422,NY,257216,412766,,15599,57907,5016,,,,42308,e1c51be1081fe7981f43333d1f596c511ade90fc,2020-04-22T20:00:00Z,15302,57907,669982,669982,669982,36,474,1381,15131,5526,20657
20200422,OH,13609,84389,,,2882,,880,,,,4276a04e7d1b2091e0ed74fe01c290d625796ad6,2020-04-22T20:00:00Z,610,2882,97998,97998,97998,39,53,103,3400,359,3759
20200422,OK,2894,43019,,298,588,147,,,,1772,2363e500b22e951895202ea58f79e93bdbe14c66,2020-04-22T20:00:00Z,170,588,45913,45913,45913,40,6,27,1482,87,1569
20200422,OR,2059,39126,,302,488,67,,35,,,204c027327e97ea0cd4d1647f6ae8dc4169eeff0,2020-04-22T20:00:00Z,78,488,41185,41185,41185,41,0,17,0,57,57
20200422,PA,35684,136272,,2764,,,,685,,,ab66db4645ed0e5c0a0647501b04dc43b464edf2,2020-04-22T20:00:00Z,1622,,171956,171956,171956,42,58,0,3949,1156,5105
20200422,PR,915,8842,1954,,,,,,,,44e95a0d429cf5114529630c00ba4c8ff5c97ebc,2020-04-22T20:00:00Z,67,,11711,9757,9757,72,3,0,53,-383,-330
20200422,RI,5841,35881,,270,576,71,,44,,315,fca0bf6bfcb785246ac597dc53cbc3f6e533c7d4,2020-04-22T20:00:00Z,181,576,41722,41722,41722,44,10,0,2048,341,2389
20200422,SC,4761,38350,,,837,,,,,3317,0f5b22ad5d71ad37cc08168f14a40b2e5172e0d9,2020-04-22T20:00:00Z,140,837,43111,43111,43111,45,16,61,1512,322,1834
20200422,SD,1858,11588,,62,111,,,,,937,f3e2e8022d2e2795a47e8bcc27e3a93897c49814,2020-04-22T20:00:00Z,8,111,13446,13446,13446,46,0,11,528,103,631
20200422,TN,7842,107138,,,775,,,,,4012,f32b1e84f5167aa75a9e2d0fedd3c5926c50efa3,2020-04-22T20:00:00Z,166,775,114980,114980,114980,47,9,15,6350,448,6798
20200422,TX,21069,195714,,1678,,,,,,7341,0823a164a5f99725e4f3c6722033850131fa840c,2020-04-22T20:00:00Z,543,,216783,216783,216783,48,26,0,10511,873,11384
20200422,UT,3445,73015,,,288,,,,,970,2d2ef65991db156c73b1d97334160ea47f256998,2020-04-22T20:00:00Z,34,288,76460,76460,76460,49,2,11,3953,149,4102
20200422,VA,10266,50512,477,1374,1659,419,,244,,1497,037bcf15679a9c7577b6dc899eb73391f3f9dd63,2020-04-22T20:00:00Z,349,1659,61255,60778,60778,51,25,78,1788,636,2424
20200422,VI,54,583,31,,,,,,,48,923864d2c6383c6d09b2f5e3e3bb564945903f10,2020-04-22T20:00:00Z,3,,668,637,637,78,0,0,9,0,9
20200422,VT,823,12639,,37,,,,,,,341d0142a10600fcf751df27d23575fd214c7388,2020-04-22T20:00:00Z,40,,13462,13462,13462,50,0,0,346,5,351
20200422,WA,12785,155179,,543,,161,,,,,8edbff10174de8a84cc20321b4599160f03bcd64,2020-04-22T20:00:00Z,647,,167964,167964,167964,53,7,0,4162,235,4397
20200422,WI,4845,49502,229,355,1302,139,324,,,,2390095d515f94486dad5fa495f7f8eb4bf2640b,2020-04-22T20:00:00Z,246,1302,54576,54347,54347,55,4,50,1661,225,1886
20200422,WV,939,24897,,103,,41,,23,,330,9727ad867f50e9b9f694c029a9e261b446769dbd,2020-04-22T20:00:00Z,26,,25836,25836,25836,54,0,0,3048,25,3073
20200422,WY,322,7301,,19,52,,,,,254,66dd15128cd950b48a239380340d70a23272c16f,2020-04-22T20:00:00Z,6,52,7623,7623,7623,56,0,0,0,2,2
20200421,AK,329,10790,,42,36,,,,,168,10d6907c6ec12caa4a5896fc50c4a3f06c836c0c,2020-04-21T20:00:00Z,9,36,11119,11119,11119,02,0,0,987,8,995
20200421,AL,5231,43295,,,699,,260,,157,,15be9201bc9d81ab58bf59be774f06a82952cdf7,2020-04-21T20:00:00Z,177,699,48526,48526,48526,01,10,58,2420,206,2626
20200421,AR,2227,25214,,86,291,,,27,57,809,c06b4ad615195a2c20654842d3c404cb48159ee5,2020-04-21T20:00:00Z,43,291,27441,27441,27441,05,1,0,584,304,888
20200421,AS,0,3,17,,,,,,,,afa8b4a6d80b0cf70a2968a2a992a6a71043ef8e,2020-04-21T20:00:00Z,,,20,3,3,60,0,0,0,0,0
20200421,AZ,5251,49901,,637,,285,,181,,1155,4a69e8a6cc27cbb70acca9544164c6a14767ec94,2020-04-21T20:00:00Z,208,,55152,55152,55152,04,21,0,465,187,652
20200421,CA,33261,266839,,4886,,1502,,,,,130999e1dae6a15d665ea5cc4f161cd7681a5a73,2020-04-21T20:00:00Z,1268,,300100,300100,300100,06,60,0,7317,2283,9600
20200421,CO,10106,37360,,861,1880,,,,,,22187aac3cc890945d5c4dfbc2e48b512bf82d5c,2020-04-21T20:00:00Z,449,1880,47466,47466,47466,08,27,67,895,376,1271
20200421,CT,20360,43832,,1949,,,,,,,f39f1fb2973519f49a34aedc8a1765d0e03e75cc,2020-04-21T20:00:00Z,1423,,64192,64192,64192,09,92,0,841,545,1386
20200421,DC,3098,11841,,402,,120,,69,,636,75a46a86c32f291b33808cf89aebfe736e271561,2020-04-21T20:00:00Z,112,,14939,14939,14939,11,7,0,655,171,826
20200421,DE,2931,13725,,263,,,,,,565,aed23d700f3f936849e58824043aa8cedcb48ab1,2020-04-21T20:00:00Z,82,,16656,16656,16656,10,10,0,0,186,186
20200421,FL,27495,249564,1203,,4235,,,,,,9f821074949d5d6047e4448cf38da1ff4ef699a6,2020-04-21T20:00:00Z,856,4235,278262,277059,277059,12,50,225,9999,835,10834
20200421,GA,19881,68259,,,3779,,,,,,4cd0f63f74e65ce4fe77f7841f5fd68d9fd5a2f9,2020-04-21T20:00:00Z,799,3779,88140,88140,88140,13,66,229,2878,934,3812
20200421,GU,133,1033,,3,,2,,,,114,e1e6bf7e31b6ecdaa4fe52ac6b055bbeee1b3e62,2020-04-21T20:00:00Z,5,,1166,1166,1166,66,0,0,42,0,42
20200421,HI,584,24112,,,55,,,,,423,c24d2e957ec3c4227bf88c8223b8eb449d28aef1,2020-04-21T20:00:00Z,10,55,24696,24696,24696,15,0,3,517,4,521
20200421,IA,3641,23974,,214,,89,,60,,1293,9ccc924133e13cff1762c594b1db6ea8d487032a,2020-04-21T20:00:00Z,83,,27615,27615,27615,19,4,0,1313,482,1795
20200421,ID,1736,15924,,,157,,58,,,660,7256a7eac201794f186cb67fc6d3ae8e67561913,2020-04-21T20:00:00Z,48,157,17660,17660,17660,16,3,6,151,64,215
20200421,IL,33059,121938,,4776,,1226,,781,,,257205aa1fd354cb30d3f55ba5f8f56d0e715faf,2020-04-21T20:00:00Z,1468,,154997,154997,154997,17,119,0,5088,1551,6639
20200421,IN,12097,55167,,,,676,,368,,,d923aa798ebae153ddd35dc86b37e0ef673da7f5,2020-04-21T20:00:00Z,630,,67264,67264,67264,18,61,0,2214,411,2625
20200421,KS,2025,17076,,,419,,,,,,b5a3ebc0e46a44c9dc3ec83e1c65428096f38f6d,2020-04-21T20:00:00Z,107,419,19101,19101,19101,20,7,14,301,39,340
20200421,KY,3050,29770,,263,1059,147,582,,,1174,b63fcad8418ac13d0eb4b332c147714c2b1e339d,2020-04-21T20:00:00Z,154,1059,32820,32820,32820,21,6,0,158,90,248
20200421,LA,24854,117576,,1798,,,,297,,,9fd12aed6e2d0c1164da15bb2d997bafac142731,2020-04-21T20:00:00Z,1405,,142430,142430,142430,22,77,0,0,331,331
20200421,MA,43168,141444,,3977,4009,1040,,,,,1f8f8507c887086d55bb4f406f3de18c5c0e9531,2020-04-21T20:00:00Z,2449,4009,184612,184612,184612,25,146,137,5398,1752,7150
20200421,MD,14193,59442,,1433,3158,526,,,,930,d928ff0a8db82d249852a56a747a46b7085c7751,2020-04-21T20:00:00Z,584,3158,73635,73635,73635,24,68,144,1729,509,2238
20200421,ME,888,14076,,40,139,16,,8,,443,8dddf2b2c6af68e683803bf7b037e46f999eb44b,2020-04-21T20:00:00Z,36,139,14964,14964,14964,23,1,1,0,13,13
20200421,MI,32967,84259,,3357,,1346,,1107,,3237,799cb0263c02e9c25fc4f490ffe3823b1f184d5f,2020-04-21T20:00:00Z,2700,,117226,117226,117226,26,232,0,2461,967,3428
20200421,MN,2567,45130,,237,629,117,253,,,1254,1587a9753ec1e71fad13e5ed4c26f37409ab2260,2020-04-21T20:00:00Z,160,629,47697,47697,47697,27,17,27,750,97,847
20200421,MO,5941,51179,,1001,,,,,,,3bbec91451c5e9fcf1b50cffbba417ad675ab670,2020-04-21T20:00:00Z,189,,57120,57120,57120,29,12,0,973,134,1107
20200421,MP,14,51,,,,,,,,11,10f9265b9e76c116da07d29fbf55c56ecfd90e5f,2020-04-21T20:00:00Z,2,,65,65,65,69,0,0,0,0,0
20200421,MS,4716,47648,,548,858,146,,89,,,f9f79cd912be26a8aa5c3e2f11a09a99e4a3ea10,2020-04-21T20:00:00Z,183,858,52364,52364,52364,28,14,39,726,204,930
20200421,MT,437,10804,,14,59,,,,,273,38f1e6145db866e6eae026b84569358b8a052b59,2020-04-21T20:00:00Z,12,59,11241,11241,11241,30,2,2,186,4,190
20200421,NC,6951,76380,,427,,,,,,,8fa4e757ffff03abd933aeb93b47bd3a938257a9,2020-04-21T20:00:00Z,213,,83331,83331,83331,37,34,0,3660,187,3847
20200421,ND,644,14343,,17,54,,,,,214,0db523306c3b9caf0f6f06a7d891e5561afa0073,2020-04-21T20:00:00Z,13,54,14987,14987,14987,38,0,1,223,17,240
20200421,NE,1648,14724,,,,,,,,,cadd8d4ce3aa8615505fa04e80ceac585d1529fa,2020-04-21T20:00:00Z,33,,16372,16372,16372,31,5,0,518,174,692
20200421,NH,1491,12848,244,78,206,,,,,521,d9a7e24923af437b104565949b43d3c5a22816d4,2020-04-21T20:00:00Z,42,206,14583,14339,14339,33,1,8,122,99,221
20200421,NJ,92387,92439,,7594,,1930,,1501,,,e7abeea8698f39b4c754e9cb9a40c4e7f4daa693,2020-04-21T20:00:00Z,4753,,184826,184826,184826,34,376,0,3188,3581,6769
20200421,NM,1971,36784,,116,291,,,,,501,f96906d540264026ef1795afb8aac5375bf7cfb9,2020-04-21T20:00:00Z,58,291,38755,38755,38755,35,3,17,1587,126,1713
20200421,NV,3937,29118,,,,,,,,,e7ce94534f79a1964d8f76ed7aa4bd5673420d5b,2020-04-21T20:00:00Z,163,,33055,33055,33055,32,5,0,601,107,708
20200421,NY,251690,397635,,16044,56526,5016,,,,40482,2338652f8c524131214595ec3499bccf7396fd73,2020-04-21T20:00:00Z,14828,56526,649325,649325,649325,36,481,1338,11286,4178,15464
20200421,OH,13250,80989,,,2779,,838,,,,822843310ab3872aef275a097144d9e0dd86682d,2020-04-21T20:00:00Z,557,2779,94239,94239,94239,39,48,126,3069,734,3803
20200421,OK,2807,41537,,346,561,164,,,,1702,b537e80c977846fcf7e6b1115987151223748622,2020-04-21T20:00:00Z,164,561,44344,44344,44344,40,21,20,8571,127,8698
20200421,OR,2002,39126,,297,471,70,,35,,,3c4c05e8c1f3e79f04d3b608620a1c840fc57480,2020-04-21T20:00:00Z,78,471,41128,41128,41128,41,3,6,1037,46,1083
20200421,PA,34528,132323,,2743,,,,673,,,e8d43bb845371f9d38e1c3596ca0ddcd730756e5,2020-04-21T20:00:00Z,1564,,166851,166851,166851,42,360,0,2603,1296,3899
20200421,PR,1298,8789,1761,,,,,,,,fcf6f50813c81c72d8854ad6b98d208e7a8f1d5e,2020-04-21T20:00:00Z,64,,11848,10087,10087,72,1,0,303,46,349
20200421,RI,5500,33833,,271,576,67,,43,,315,18b3d53f8682ff567fc3f07e8a66e1b7e33cab7e,2020-04-21T20:00:00Z,171,576,39333,39333,39333,44,16,245,1843,410,2253
20200421,SC,4439,36838,,,776,,,,,2063,a6cab844e1e2a7b3478efa2fb21c544f1811ba15,2020-04-21T20:00:00Z,124,776,41277,41277,41277,45,4,0,735,62,797
20200421,SD,1755,11060,,65,100,,,,,824,992dc98887eb13afda521772d9999e3507038157,2020-04-21T20:00:00Z,8,100,12815,12815,12815,46,1,13,419,70,489
20200421,TN,7394,100788,,,760,,,,,3828,5ba03884448b10adc6a50ed0e1010abfcf498b54,2020-04-21T20:00:00Z,157,760,108182,108182,108182,47,5,30,7337,156,7493
20200421,TX,20196,185203,,1419,,,,,,6486,739a953d703356c070852d4c873827207ab43210,2020-04-21T20:00:00Z,517,,205399,205399,205399,48,22,0,14267,738,15005
20200421,UT,3296,69062,,,277,,,,,888,944b4791fd93c9696980641689ce71ef01189065,2020-04-21T20:00:00Z,32,277,72358,72358,72358,49,4,9,3964,83,4047
20200421,VA,9630,48724,477,1331,1581,403,,251,,1418,525c2beb6b8598aa8696fd32336b8e649da359eb,2020-04-21T20:00:00Z,324,1581,58831,58354,58354,51,24,81,979,640,1619
20200421,VI,54,574,35,,,,,,,48,054e65dc64000f399e63e2186fc0c2ccd18e1d41,2020-04-21T20:00:00Z,3,,663,628,628,78,0,0,20,1,21
20200421,VT,818,12293,,41,,,,,,,28712a2b60647846fc103651b782ff627be2708b,2020-04-21T20:00:00Z,40,,13111,13111,13111,50,2,0,128,2,130
20200421,WA,12550,151017,,503,,161,,,,,fb1d4941862e0a4ee01795553f8becb71e59f4ac,2020-04-21T20:00:00Z,640,,163567,163567,163567,53,11,0,4598,204,4802
20200421,WI,4620,47841,219,358,1252,137,324,,,,e9ffd1a1dcd6cd7776bc0e7d03204b1e6eabac5f,2020-04-21T20:00:00Z,242,1252,52680,52461,52461,55,12,41,1238,121,1359
20200421,WV,914,21849,,85,,42,,24,,330,d34d48ec6ad8964bd9d0424c7731b0e5d5d41257,2020-04-21T20:00:00Z,26,,22763,22763,22763,54,2,0,596,12,608
20200421,WY,320,7301,,19,52,,,,,237,229d05fbf3c4684fd09c2466f4cccd8e29a577cb,2020-04-21T20:00:00Z,6,52,7621,7621,7621,56,4,1,228,7,235
20200420,AK,321,9803,,46,36,,,,,161,1c99a7e1c363a89f2f8ab241524c88d328e3448f,2020-04-20T20:00:00Z,9,36,10124,10124,10124,02,0,0,227,2,229
20200420,AL,5025,40875,,,641,,260,,157,,30c15cf3832f06f00b16592718072b2f8c548ef4,2020-04-20T20:00:00Z,167,641,45900,45900,45900,01,13,0,0,188,188
20200420,AR,1923,24630,,93,291,,,24,57,749,1400a7da3fce5e813078b940af03430e86e35236,2020-04-20T20:00:00Z,42,291,26553,26553,26553,05,2,0,2202,142,2344
20200420,AS,0,3,17,,,,,,,,a7c4bff380f29737760fb7ce0ab2cecb89c6d188,2020-04-20T20:00:00Z,,,20,3,3,60,0,0,0,0,0
20200420,AZ,5064,49436,,637,,285,,181,,1155,c9850364cfb5a53d0e9ea8d7bf56fb68b7810895,2020-04-20T20:00:00Z,187,,54500,54500,54500,04,3,0,1375,135,1510
20200420,CA,30978,259522,,4674,,1480,,,,,41576d2aea97b9aeda709ef2fc0ca31cedad7b7a,2020-04-20T20:00:00Z,1208,,290500,290500,290500,06,42,0,8955,645,9600
20200420,CO,9730,36465,,874,1813,,,,,,44b06613b46ed33221077ce6b0eafc3ad972717b,2020-04-20T20:00:00Z,422,1813,46195,46195,46195,08,11,16,1292,297,1589
20200420,CT,19815,42991,,1919,,,,,,,48cfc5676164821e66c31464dc4489db83b53cfd,2020-04-20T20:00:00Z,1331,,62806,62806,62806,09,245,0,2328,2265,4593
20200420,DC,2927,11186,,402,,120,,69,,630,ba1352bb1343d135719500198fb5285f4cf02312,2020-04-20T20:00:00Z,105,,14113,14113,14113,11,9,0,280,134,414
20200420,DE,2745,13725,,256,,,,,,495,eb8aefc88630769f3f3713ae9863d989c4155192,2020-04-20T20:00:00Z,72,,16470,16470,16470,10,5,0,1469,207,1676
20200420,FL,26660,239565,1104,,4010,,,,,,48713e4b862f27a7754d18ed675b070c79ed41b3,2020-04-20T20:00:00Z,806,4010,267329,266225,266225,12,25,80,9482,664,10146
20200420,GA,18947,65381,,,3550,,,,,,52bbf3b141deb058e8e4c3c95d60c677879c8497,2020-04-20T20:00:00Z,733,3550,84328,84328,84328,13,46,86,3749,646,4395
20200420,GU,133,991,,3,,2,,,,112,d3cc796bda2181c4beff41042751382967b6296f,2020-04-20T20:00:00Z,5,,1124,1124,1124,66,0,0,48,0,48
20200420,HI,580,23595,,,52,,,,,414,f86f0830219bde224a6f3177e795b563a7e523aa,2020-04-20T20:00:00Z,10,52,24175,24175,24175,15,1,1,699,6,705
20200420,IA,3159,22661,,214,,91,,58,,1235,b5492a5df365f18995800ea856c8df68284b7367,2020-04-20T20:00:00Z,79,,25820,25820,25820,19,4,0,1013,257,1270
20200420,ID,1672,15773,,,151,,53,,,585,5b4507852c8be04b3979dd2b1c5150270ecc7985,2020-04-20T20:00:00Z,45,151,17445,17445,17445,16,1,0,572,4,576
20200420,IL,31508,116850,,4599,,1239,,757,,,a7cde33ab8ab9bd3b8a8701a731bea46c1895dbc,2020-04-20T20:00:00Z,1349,,148358,148358,148358,17,59,0,3889,1151,5040
20200420,IN,11686,52953,,,,669,,353,,,464f563cfbea566a0f09415f44711f25b1c8e361,2020-04-20T20:00:00Z,569,,64639,64639,64639,18,7,0,3021,476,3497
20200420,KS,1986,16775,,,405,,,,,,8a4c6c22b95af6ad13d6f74e821750e2b3a9ad13,2020-04-20T20:00:00Z,100,405,18761,18761,18761,20,8,15,494,137,631
20200420,KY,2960,29612,,274,1059,155,534,,,1174,24fd02d223bedfc30658c7616f6607de13542820,2020-04-20T20:00:00Z,148,1059,32572,32572,32572,21,4,0,94,253,347
20200420,LA,24523,117576,,1794,,,,332,,,6582b5d51a3083441560e329643a398040adee2d,2020-04-20T20:00:00Z,1328,,142099,142099,142099,22,32,0,0,595,595
20200420,MA,41416,136046,,3872,3872,987,,,,,d47247b88cfe88e126137b9f2123631fa231bcd0,2020-04-20T20:00:00Z,2303,3872,177462,177462,177462,25,157,83,6751,1596,8347
20200420,MD,13684,57713,,,3014,,,,,917,f8ad78c1b5a28e1553fc763631f9daa83e4977f3,2020-04-20T20:00:00Z,516,3014,71397,71397,71397,24,30,128,2652,854,3506
20200420,ME,875,14076,,39,138,16,,9,,414,0b77d62611e8535de65897d5d3364e85b3b48204,2020-04-20T20:00:00Z,35,138,14951,14951,14951,23,1,2,0,8,8
20200420,MI,32000,81798,,3374,,1346,,1102,,3237,392ae0c020c21dbbc1b892209cceb53cf9870110,2020-04-20T20:00:00Z,2468,,113798,113798,113798,26,77,0,3561,576,4137
20200420,MN,2470,44380,,237,602,126,241,,,1202,30d5ab7a9755878cf6bf27605a060a04dceb2f8b,2020-04-20T20:00:00Z,143,602,46850,46850,46850,27,9,28,1020,114,1134
20200420,MO,5807,50206,,873,,,,,,,4af4d88f885569d2f6257445a4dfeeca5944a5c1,2020-04-20T20:00:00Z,177,,56013,56013,56013,29,1,0,1964,140,2104
20200420,MP,14,51,,,,,,,,11,d1a10e0647bc614d31772b798ad25e7657071f90,2020-04-20T20:00:00Z,2,,65,65,65,69,0,0,9,0,9
20200420,MS,4512,46922,,548,819,146,,89,,,b83b01e3c5b28f2744892025a35a818eadc4d161,2020-04-20T20:00:00Z,169,819,51434,51434,51434,28,10,11,12131,238,12369
20200420,MT,433,10618,,19,57,,,,,243,43b620f2e8e6847b386bcc5c1c26b00bf629c5ef,2020-04-20T20:00:00Z,10,57,11051,11051,11051,30,0,2,153,0,153
20200420,NC,6764,72720,,373,,,,,,,5be41a497b5b5d214e51ac349c5e29a1ddbd443e,2020-04-20T20:00:00Z,179,,79484,79484,79484,37,7,0,441,271,712
20200420,ND,627,14120,,17,53,,,,,189,a91cac8977af5b41f3177b1df9d02e5cc48b1c40,2020-04-20T20:00:00Z,13,53,14747,14747,14747,38,3,2,1075,42,1117
20200420,NE,1474,14206,,,,,,,,,81b5f8ee0ee4fef36e9ad19133ee77eb59e10667,2020-04-20T20:00:00Z,28,,15680,15680,15680,31,0,0,918,187,1105
20200420,NH,1392,12726,298,79,198,,,,,521,7de4c492da4e4977587cbd0351972d0a63921b2e,2020-04-20T20:00:00Z,41,198,14416,14118,14118,33,3,6,644,50,694
20200420,NJ,88806,89251,,6986,,2018,,1594,,,475f85db6197c72804957a10154695964ecb1734,2020-04-20T20:00:00Z,4377,,178057,178057,178057,34,175,0,3864,3505,7369
20200420,NM,1845,35197,,103,274,,,,,487,6bce6cdfad3d7f7d56cda6e86127c1cdf1582674,2020-04-20T20:00:00Z,55,274,37042,37042,37042,35,2,16,363,47,410
20200420,NV,3830,28517,,,,,,,,,6597d6167cd367d35368d50b4f763775bf3fc8ae,2020-04-20T20:00:00Z,158,,32347,32347,32347,32,3,0,647,102,749
20200420,NY,247512,386349,,16103,55188,5016,,,,39085,4521a0110cede8ff0dda456d1e80ba441cc4c5f9,2020-04-20T20:00:00Z,14347,55188,633861,633861,633861,36,478,1379,11580,4726,16306
20200420,OH,12516,77920,,,2653,,798,,,,7ec883d7476955c4012c40d78cbd4bbbfd32e0ba,2020-04-20T20:00:00Z,509,2653,90436,90436,90436,39,38,88,2223,1224,3447
20200420,OK,2680,32966,,307,541,136,,,,1614,c1c68e1a81370eb7d4eeef17f88b8385c3223ff0,2020-04-20T20:00:00Z,143,541,35646,35646,35646,40,3,0,0,81,81
20200420,OR,1956,38089,,303,465,74,,35,,,c1e439a175412090f4a043eefba3e2754e477cd6,2020-04-20T20:00:00Z,75,465,40045,40045,40045,41,1,9,961,46,1007
20200420,PA,33232,129720,,2701,,,,659,,,b93e1d0f1b270a69f742a0992ff0924bf498fd39,2020-04-20T20:00:00Z,1204,,162952,162952,162952,42,92,0,3150,948,4098
20200420,PR,1252,8486,1895,,,,,,,,f9af3f76cd935a4b930bed17b1a1f1498e456936,2020-04-20T20:00:00Z,63,,11633,9738,9738,72,1,0,206,39,245
20200420,RI,5090,31990,,272,331,62,,45,,267,7eeca6d20edcdd054bea6d6dd4e6bfbe76f74dcd,2020-04-20T20:00:00Z,155,331,37080,37080,37080,44,5,0,1997,384,2381
20200420,SC,4377,36103,,,776,,,,,2063,f5e68b7b953689577424337933c68d8101e4ca7a,2020-04-20T20:00:00Z,120,776,40480,40480,40480,45,0,0,0,0,0
20200420,SD,1685,10641,0,,87,,,,,709,543469daaca0f0e8a222eb3a9f588834b1d9a6bf,2020-04-20T20:00:00Z,7,87,12326,12326,12326,46,0,13,214,50,264
20200420,TN,7238,93451,,,730,,,,,3575,27a1a741ebcaa1665c87ecac9c56d22915c7e7f5,2020-04-20T20:00:00Z,152,730,100689,100689,100689,47,4,6,3423,168,3591
20200420,TX,19458,170936,,1411,,,,,,5706,aa618d940c111264f2522c4cfeae1275aee43b81,2020-04-20T20:00:00Z,495,,190394,190394,190394,48,18,0,7149,535,7684
20200420,UT,3213,65098,,,268,,,,,776,d7ce1632b3287fa512ade724a644335c0a1cdcf5,2020-04-20T20:00:00Z,28,268,68311,68311,68311,49,1,9,4612,144,4756
20200420,VA,8990,47745,468,1296,1500,396,,237,,1324,2ea7ba60d3c4cf97b3aeeb0bdd023eb3482e6bc9,2020-04-20T20:00:00Z,300,1500,57203,56735,56735,51,23,78,1549,453,2002
20200420,VI,53,554,18,,,,,,,48,a28571d6bba244a615bedfe60519ae3388f419b5,2020-04-20T20:00:00Z,3,,625,607,607,78,0,0,6,0,6
20200420,VT,816,12165,,49,,,,,,15,9f5e1896b278870fc9a50fbb682e6f8cc927a6f2,2020-04-20T20:00:00Z,38,,12981,12981,12981,50,0,0,251,4,255
20200420,WA,12346,146419,,403,,122,,,,,f539e2961c803d7155ce5e50a3faa2422ac12a47,2020-04-20T20:00:00Z,629,,158765,158765,158765,53,14,0,4211,200,4411
20200420,WI,4499,46603,237,406,1211,168,307,,,,3f68df6dae55c0dc7e23cad0c5c95cd51aeb6298,2020-04-20T20:00:00Z,230,1211,51339,51102,51102,55,10,21,1280,153,1433
20200420,WV,902,21253,,77,,37,,23,,290,9cf42f04bb516ad4d992e2e34b14bb506ace0786,2020-04-20T20:00:00Z,24,,22155,22155,22155,54,6,0,2085,39,2124
20200420,WY,313,7073,,19,51,,,,,233,7051d0f8ffb99101d5f51760a38f9161ea6bd4e4,2020-04-20T20:00:00Z,2,51,7386,7386,7386,56,0,1,101,4,105
20200419,AK,319,9576,,37,36,,,,,153,a55d5f5198d699a8859e16fc9fa49cbecbc61939,2020-04-19T20:00:00Z,9,36,9895,9895,9895,02,0,0,235,5,240
20200419,AL,4837,40875,,,641,,260,,157,,e120fdc84c91ed23d5f4a2a00e930fbf90f652b3,2020-04-19T20:00:00Z,154,641,45712,45712,45712,01,8,21,2992,182,3174
20200419,AR,1781,22428,,88,291,,,25,57,721,26854a8543b5740ca16b32215f7349ffc12aed4d,2020-04-19T20:00:00Z,40,291,24209,24209,24209,05,2,0,26,42,68
20200419,AS,0,3,17,,,,,,,,ae71dad66ccc8f5c3aaeafe4f292e04499664e5d,2020-04-19T20:00:00Z,,,20,3,3,60,0,0,0,0,0
20200419,AZ,4929,48061,,631,,283,,187,,994,33b8b85aadbce892fe140ca6c9c2cf3275f0e845,2020-04-19T20:00:00Z,184,,52990,52990,52990,04,7,0,1735,210,1945
20200419,CA,30333,250567,7200,4731,,1457,,,,,6497f09e42ab49264d37a27c55e3858737d2204a,2020-04-19T20:00:00Z,1166,,288100,280900,280900,06,94,0,19864,1370,21234
20200419,CO,9433,35173,,874,1797,,,,,,30b797e974be7b9e0190a948977948fa7954192b,2020-04-19T20:00:00Z,411,1797,44606,44606,44606,08,20,42,913,386,1299
20200419,CT,17550,40663,,1938,,,,,,,9eb73b754fac498c79f5eecf0d740580044c13b1,2020-04-19T20:00:00Z,1086,,58213,58213,58213,09,50,0,2010,741,2751
20200419,DC,2793,10906,,313,,105,,79,,622,0afdb625281746e8bc0258458e6c11dd29cb69d7,2020-04-19T20:00:00Z,96,,13699,13699,13699,11,5,0,304,127,431
20200419,DE,2538,12256,,249,,,,,,466,206aa57312ec65e2c5fe68147d10b55829f2e153,2020-04-19T20:00:00Z,67,,14794,14794,14794,10,6,0,562,215,777
20200419,FL,25996,230083,1179,,3930,,,,,,9134ab1468fc864b0074346757d5fe0627ef37e5,2020-04-19T20:00:00Z,781,3930,257258,256079,256079,12,27,88,8825,727,9552
20200419,GA,18301,61632,,,3464,,,,,,4f81acfbb704b29fa81c86366d17e1125118df19,2020-04-19T20:00:00Z,687,3464,79933,79933,79933,13,14,44,5093,632,5725
20200419,GU,133,943,,6,,2,,,,112,3e3391d058aac190c531b1de4b6b2ce9b4eb7f18,2020-04-19T20:00:00Z,5,,1076,1076,1076,66,0,0,0,0,0
20200419,HI,574,22896,,,51,,,,,410,29fb1c3ee4a32fd0dc935059219095f7cbd5626a,2020-04-19T20:00:00Z,9,51,23470,23470,23470,15,0,3,1106,21,1127
20200419,IA,2902,21648,,198,,86,,54,,1171,82c26fb3e410a7d8aca341442728861b6f948759,2020-04-19T20:00:00Z,75,,24550,24550,24550,19,1,0,1214,389,1603
20200419,ID,1668,15201,,,151,,53,,,520,b6ed09b610f63b8964e71a17c94d2fae3f585ef4,2020-04-19T20:00:00Z,44,151,16869,16869,16869,16,1,0,247,13,260
20200419,IL,30357,112961,,4314,,1196,,749,,,171fdba34c699b38cd99d9993a0c20b5a859abc3,2020-04-19T20:00:00Z,1290,,143318,143318,143318,17,31,0,4717,1197,5914
20200419,IN,11210,49932,,,,649,,342,,,5528169e11d016a0a904789cbfc475f00682c329,2020-04-19T20:00:00Z,562,,61142,61142,61142,18,17,0,3700,569,4269
20200419,KS,1849,16281,,,390,,,,,,ed8dd64285c21138b232f1ab7fac90b4041ec9ea,2020-04-19T20:00:00Z,92,390,18130,18130,18130,20,6,7,395,59,454
20200419,KY,2707,29518,,274,1059,155,534,,,1174,294401486731fa47c293d1a07099bc6abe64d708,2020-04-19T20:00:00Z,144,1059,32225,32225,32225,21,7,51,1444,185,1629
20200419,LA,23928,117576,,1748,,,,349,,,f39da3758743c982ec8f2c6a323d32041c56dd86,2020-04-19T20:00:00Z,1296,,141504,141504,141504,22,29,0,3157,348,3505
20200419,MA,39820,129295,,3789,3789,987,,,,,387d9011cf331dc271e6ab1728e7cda36729b2cd,2020-04-19T20:00:00Z,2146,3789,169115,169115,169115,25,163,61,4691,2293,6984
20200419,MD,12830,55061,,,2886,,,,,914,67e2b09c0defce78f91f1938bfd9be7452ae881e,2020-04-19T20:00:00Z,486,2886,67891,67891,67891,24,23,129,1999,522,2521
20200419,ME,867,14076,,46,136,18,,9,,393,2ee56143f665f6eef6c7c7bf2d1b233c7ccefc29,2020-04-19T20:00:00Z,34,136,14943,14943,14943,23,2,0,0,20,20
20200419,MI,31424,78237,,3403,,1344,,1115,,3237,b3a1319a97d980ef71e08c1e9112f84ce2382a88,2020-04-19T20:00:00Z,2391,,109661,109661,109661,26,83,0,9301,633,9934
20200419,MN,2356,43360,,228,574,116,226,,,1160,c46d9c7e491debd22437fd9e1fbffe0c11a965be,2020-04-19T20:00:00Z,134,574,45716,45716,45716,27,13,13,1305,143,1448
20200419,MO,5667,48242,,875,,,,,,,847abdacfffe186deb9e5f69ba2de46e4a0f46ce,2020-04-19T20:00:00Z,176,,53909,53909,53909,29,1,0,0,150,150
20200419,MP,14,42,4,,,,,,,9,d9899c4db95fdfc1b466f0df099bd5e4d73cd24b,2020-04-19T20:00:00Z,2,,60,56,56,69,0,0,0,0,0
20200419,MS,4274,34791,,,808,138,,79,,,56b97ccde77eed01f684728fc5aee81aa4cd2251,2020-04-19T20:00:00Z,159,808,39065,39065,39065,28,7,26,0,300,300
20200419,MT,433,10465,,18,55,,,,,243,01531efd541c443e1080cfb6e95eebb7dd6b2052,2020-04-19T20:00:00Z,10,55,10898,10898,10898,30,0,0,322,7,329
20200419,NC,6493,72279,,465,,,,,,,33bb942114706fa830c9ff3bd5c0736ee8c5a648,2020-04-19T20:00:00Z,172,,78772,78772,78772,37,8,0,2208,353,2561
20200419,ND,585,13045,,15,51,,,,,189,c24fc5d7f1683d70f5c4b362ca03d131da90a4a3,2020-04-19T20:00:00Z,10,51,13630,13630,13630,38,1,4,610,57,667
20200419,NE,1287,13288,,,,,,,,,626331acb95da822b8543edb30d772eb6a727e02,2020-04-19T20:00:00Z,28,,14575,14575,14575,31,4,0,749,149,898
20200419,NH,1342,12082,316,85,192,,,,,513,2228387ecb96872f72ce39a4189efd28cf4616a9,2020-04-19T20:00:00Z,38,192,13740,13424,13424,33,1,2,517,55,572
20200419,NJ,85301,85387,,7494,,1940,,1628,,,bfacf58505686a7f6016e248759561bb29c71824,2020-04-19T20:00:00Z,4202,,170688,170688,170688,34,132,0,4271,3881,8152
20200419,NM,1798,34834,,92,258,,,,,465,45b0a25516b7d3002fe45c7522626bd3af59c125,2020-04-19T20:00:00Z,53,258,36632,36632,36632,35,2,16,932,87,1019
20200419,NV,3728,27870,,,,,,,,,dc7b0bb39e382412167e1696b5a5df37b9e90c90,2020-04-19T20:00:00Z,155,,31598,31598,31598,32,4,0,745,102,847
20200419,NY,242786,374769,,16213,53809,5016,,,,37596,7a7705ac79635821d2f4379011556f23274d3686,2020-04-19T20:00:00Z,13869,53809,617555,617555,617555,36,507,1384,14969,6054,21023
20200419,OH,11292,75697,,,2565,,765,,,,4cd095edc621321b7eaeb621d8e388ef842c6363,2020-04-19T20:00:00Z,471,2565,86989,86989,86989,39,20,46,6878,1353,8231
20200419,OK,2599,32966,,307,541,136,,,,1575,a6d29945e0f5ebbbf59fd16df1594b1519748563,2020-04-19T20:00:00Z,140,541,35565,35565,35565,40,1,0,0,29,29
20200419,OR,1910,37128,,290,456,74,,37,,,ec661c9d973bf39cbdb160e1460ee6576ad075e0,2020-04-19T20:00:00Z,74,456,39038,39038,39038,41,2,7,1389,66,1455
20200419,PA,32284,126570,,2634,,,,657,,,6e7208747c844734f6c1a7e4baaec23c97ffc391,2020-04-19T20:00:00Z,1112,,158854,158854,158854,42,276,0,3674,1215,4889
20200419,PR,1213,8280,1839,,,,,,,,a721603971d92c485f34bfcc042df1eee7d98b29,2020-04-19T20:00:00Z,62,,11332,9493,9493,72,2,0,225,95,320
20200419,RI,4706,29993,,278,331,66,,37,,244,9665fc9398589b5d582473ae54d28cadb76f2a6a,2020-04-19T20:00:00Z,150,331,34699,34699,34699,44,13,0,1658,215,1873
20200419,SC,4377,36103,,,776,,,,,2633,7131f56d8c3cca28acea564234b76af6ff0824c7,2020-04-19T20:00:00Z,120,776,40480,40480,40480,45,1,0,1516,131,1647
20200419,SD,1635,10427,0,,74,,,,,646,3f65890db33d32f46a90ea34281347b33a146882,2020-04-19T20:00:00Z,7,74,12062,12062,12062,46,0,6,309,93,402
20200419,TN,7070,90028,,,724,,,,,3344,60d2f99d4e111f558462b9ff68cd65e6e71c7621,2020-04-19T20:00:00Z,148,724,97098,97098,97098,47,3,5,6204,308,6512
20200419,TX,18923,163787,,1471,,,,,,5334,0fc49b2c1df281f3fedfbacd2f2010c5221109ed,2020-04-19T20:00:00Z,477,,182710,182710,182710,48,24,0,5808,663,6471
20200419,UT,3069,60486,,,259,,,,,679,5fef949ff5b5a3b616e0f7af426750ffeabbdf46,2020-04-19T20:00:00Z,27,259,63555,63555,63555,49,2,8,3473,138,3611
20200419,VA,8537,46196,499,1319,1422,388,,231,,1267,2c57acf155ca215593af4e21a3d82a98d0f1a240,2020-04-19T20:00:00Z,277,1422,55232,54733,54733,51,19,126,2318,484,2802
20200419,VI,53,548,22,,,,,,,48,8a1ae5c337b88d929c1347d2d99cee0960020aea,2020-04-19T20:00:00Z,3,,623,601,601,78,0,0,158,0,158
20200419,VT,812,11914,,53,,,,,,15,0fd8206e283903ce9d079d7a99dc577628487dca,2020-04-19T20:00:00Z,38,,12726,12726,12726,50,0,0,151,9,160
20200419,WA,12146,142208,,586,,193,,,,,f6689bf6da912f65d1520273b075171292e8a1ca,2020-04-19T20:00:00Z,615,,154354,154354,154354,53,17,0,1399,259,1658
20200419,WI,4346,45323,248,397,1190,162,307,,,,7b769f633fc7090da95857b59e02c6b58d946863,2020-04-19T20:00:00Z,220,1190,49917,49669,49669,55,9,14,1361,147,1508
20200419,WV,863,19168,,72,,37,,25,,265,b84ada6c6a8233ff6d204c06b6db3dad4dc4ffb8,2020-04-19T20:00:00Z,18,,20031,20031,20031,54,2,0,513,78,591
20200419,WY,309,6972,,19,50,,,,,227,e267dd2b218ec12a6da6575976293932c0b3eda9,2020-04-19T20:00:00Z,2,50,7281,7281,7281,56,0,0,755,4,759
20200418,AK,314,9341,,39,36,,,,,147,e01d04c1608f52dc596ef6e9cde32427d3da59b7,2020-04-18T20:00:00Z,9,36,9655,9655,9655,02,0,0,200,5,205
20200418,AL,4655,37883,,,620,,247,,148,,db9e6bd49bb8fa0b75862eebb624fdb77a579372,2020-04-18T20:00:00Z,146,620,42538,42538,42538,01,2,26,4565,125,4690
20200418,AR,1739,22402,,86,291,,,22,57,703,eec8a2490a89622aa7130d38b8fc3a8d59be09b7,2020-04-18T20:00:00Z,38,291,24141,24141,24141,05,1,291,603,44,647
20200418,AS,0,3,17,,,,,,,,bf4a96d3c81bf1b9837fdc965967117ba4b3c5c8,2020-04-18T20:00:00Z,,,20,3,3,60,0,0,0,0,0
20200418,AZ,4719,46326,,566,,285,,178,,539,a4301cbdf289563b0e77dc0b34c1c06d33036d08,2020-04-18T20:00:00Z,177,,51045,51045,51045,04,8,0,1603,212,1815
20200418,CA,28963,230703,7200,4936,,1490,,,,,a9c31277a9b1ab3427316de11ad64f4b127fd51e,2020-04-18T20:00:00Z,1072,,266866,259666,259666,06,87,0,6617,1435,8052
20200418,CO,9047,34260,,843,1755,,,,,,26ac73ae2504d808bf4c0f1332d68cdfd91640db,2020-04-18T20:00:00Z,391,1755,43307,43307,43307,08,17,62,1105,372,1477
20200418,CT,16809,38653,,1946,,,,,,,256fef2f9d456903a1c8c6006831e589d3ebb8d3,2020-04-18T20:00:00Z,1036,,55462,55462,55462,09,0,0,0,0,0
20200418,DC,2666,10602,,313,,105,,79,,608,d3a2a3fcd66b3b4757fcce3a46615e70fb6509ee,2020-04-18T20:00:00Z,91,,13268,13268,13268,11,5,0,435,190,625
20200418,DE,2323,11694,,224,,,,,,423,463423f890b6020e5c40a82cd608f9aea6573a31,2020-04-18T20:00:00Z,61,,14017,14017,14017,10,0,0,0,0,0
20200418,FL,25269,221258,0,,3842,,,,,,2176200a41dd3f01171fa85299fdc0f7ab3f3a90,2020-04-18T20:00:00Z,754,3842,246527,246527,246527,12,55,177,10540,1150,11690
20200418,GA,17669,56539,,,3420,,,,,,2565bc253000e62f29b0da78e7eba4ac12e912f2,2020-04-18T20:00:00Z,673,3420,74208,74208,74208,13,23,96,2049,475,2524
20200418,GU,133,943,,6,,2,,,,110,f9a1678647521cb473ee754bf295c9ff0615db98,2020-04-18T20:00:00Z,5,,1076,1076,1076,66,0,0,3,0,3
20200418,HI,553,21790,,,48,,,,,390,258ad5f1ea6322a617a09ed88785f16e4ea4cc26,2020-04-18T20:00:00Z,9,48,22343,22343,22343,15,0,3,474,12,486
20200418,IA,2513,20434,,193,,84,,51,,1095,98ef5b0bf163139ee1c1b53a0ee004255777072b,2020-04-18T20:00:00Z,74,,22947,22947,22947,19,10,0,974,181,1155
20200418,ID,1655,14954,,,151,,53,,,453,a3d02ffb5a444e736635ba7d7c87c48d9e118f29,2020-04-18T20:00:00Z,43,151,16609,16609,16609,16,2,3,380,46,426
20200418,IL,29160,108244,,4340,,1192,,740,,,c66c5c73ef01e154c6f70ccc1c7399c17cbb9b11,2020-04-18T20:00:00Z,1259,,137404,137404,137404,17,125,0,5656,1585,7241
20200418,IN,10641,46232,,,,663,,360,,,4057af437d8aeeb997c248711046a829ad8666a7,2020-04-18T20:00:00Z,545,,56873,56873,56873,18,26,0,1601,487,2088
20200418,KS,1790,15886,,,383,,,,,,d9fb96d86b079b9e15d116e72c7aa0faed677a63,2020-04-18T20:00:00Z,86,383,17676,17676,17676,20,2,8,690,85,775
20200418,KY,2522,28074,,360,1008,227,514,,,979,274eaebc9b0a7226236683c1d7a64ec3c2955df9,2020-04-18T20:00:00Z,137,1008,30596,30596,30596,21,8,37,756,93,849
20200418,LA,23580,114419,,1761,,,,347,,,55ce37dc6547f8caa1cc8430bdfc20cc29521e86,2020-04-18T20:00:00Z,1267,,137999,137999,137999,22,54,0,5550,462,6012
20200418,MA,37527,124604,,3728,3728,987,,,,,bf7e33a4342e8cf71edddce940c548b20a33b103,2020-04-18T20:00:00Z,1983,3728,162131,162131,162131,25,161,-28,7409,2402,9811
20200418,MD,12308,53062,,,2757,,,,,771,cbf14419d163fef946e49fd13a76a857f2b73129,2020-04-18T20:00:00Z,463,2757,65370,65370,65370,24,38,145,2625,736,3361
20200418,ME,847,14076,,49,136,20,,12,,382,e7214ce4f707e1e8a635a3cf38e984c564a2d534,2020-04-18T20:00:00Z,32,136,14923,14923,14923,23,3,3,0,20,20
20200418,MI,30791,68936,,3634,,1423,,1203,,3237,2e6c124c6e344d492ce72890f839c4c2aae2f299,2020-04-18T20:00:00Z,2308,,99727,99727,99727,26,81,0,0,768,768
20200418,MN,2213,42055,,239,561,111,215,,,1118,bf427777ae6442c2e6294bd777fbbd7a87b2abae,2020-04-18T20:00:00Z,121,561,44268,44268,44268,27,10,43,1073,142,1215
20200418,MO,5517,48242,,875,,,,,,,00d835600fd20e8d0680a8afccf5b922d8348b2c,2020-04-18T20:00:00Z,175,,53759,53759,53759,29,10,0,1808,234,2042
20200418,MP,14,42,4,,,,,,,9,f6bcb3d42df33c91ed6a0f7dd767a1ed1dbf28a8,2020-04-18T20:00:00Z,2,,60,56,56,69,0,0,0,1,1
20200418,MS,3974,34791,,,782,154,,99,,,a83198e0f902783d50e3de2e926f3e705e309b0b,2020-04-18T20:00:00Z,152,782,38765,38765,38765,28,12,46,0,181,181
20200418,MT,426,10143,,17,55,,,,,234,2dc43c83d8c0ed53e1a880a5851671c68d19cd3d,2020-04-18T20:00:00Z,10,55,10569,10569,10569,30,2,1,321,4,325
20200418,NC,6140,70071,,388,,,,,,,c37a91deaaad48e58705312e38a6baff928948af,2020-04-18T20:00:00Z,164,,76211,76211,76211,37,12,0,2949,281,3230
20200418,ND,528,12435,,13,47,,,,,183,aad568c873238b5cd64027dc33dca766482518fc,2020-04-18T20:00:00Z,9,47,12963,12963,12963,38,0,0,532,89,621
20200418,NE,1138,12539,,,,,,,,,430b7e2f83f537185b3964052441c2626a845b1d,2020-04-18T20:00:00Z,24,,13677,13677,13677,31,0,0,501,72,573
20200418,NH,1287,11565,174,86,190,,,,,468,f605fea50f3ee8b194a5f37bf56e5329c0426eee,2020-04-18T20:00:00Z,37,190,13026,12852,12852,33,0,0,144,0,144
20200418,NJ,81420,81116,,7718,,2024,,1641,,,2c98aa87acbdcab2efa4ff30b0cc10d21f35c62c,2020-04-18T20:00:00Z,4070,,162536,162536,162536,34,230,0,2134,2953,5087
20200418,NM,1711,33902,,96,242,,,,,382,f4530150b6e41cb8496c6cf81e6826498a882d79,2020-04-18T20:00:00Z,51,242,35613,35613,35613,35,7,12,1011,114,1125
20200418,NV,3626,27125,,,,,,,,,0463c7b5460ccaf3d387f017181f7808535a9fd4,2020-04-18T20:00:00Z,151,,30751,30751,30751,32,9,0,887,102,989
20200418,NY,236732,359800,,16967,52425,5016,,,,35458,c7154fc39242cbfac6658e69f9ed8de5c7e07924,2020-04-18T20:00:00Z,13362,52425,596532,596532,596532,36,540,1917,16219,7090,23309
20200418,OH,9939,68819,,,2519,,760,,,,b530d1c09134ce67159aca29d4d468956372c5ee,2020-04-18T20:00:00Z,451,2519,78758,78758,78758,39,33,95,0,1081,1081
20200418,OK,2570,32966,,307,541,136,,,,1515,252c6e812512bcc3b4ecc69984d32a38511b15be,2020-04-18T20:00:00Z,139,541,35536,35536,35536,40,3,13,1811,105,1916
20200418,OR,1844,35739,,290,449,74,,37,,,b64d78255c9b7f2dcb0331cd990d010ddf9c0390,2020-04-18T20:00:00Z,72,449,37583,37583,37583,41,2,22,1203,59,1262
20200418,PA,31069,122896,,2613,,,,660,,,2120d7fe1eced33687fa2242ca4e2d72e225dc88,2020-04-18T20:00:00Z,836,,153965,153965,153965,42,80,0,4964,1628,6592
20200418,PR,1118,8055,1760,,,,,,,,ebd310b1cbea796276b9c627a79eb874b6e3dac3,2020-04-18T20:00:00Z,60,,10933,9173,9173,72,2,0,191,50,241
20200418,RI,4491,28335,,255,331,67,,43,,217,5aac9cd94170d771d8fd18f5442bf86b4327834e,2020-04-18T20:00:00Z,137,331,32826,32826,32826,44,19,0,1751,314,2065
20200418,SC,4246,34587,,,776,,,,,2633,fbc074dd4bb4e3e76c02cac6dffa09c08417b088,2020-04-18T20:00:00Z,119,776,38833,38833,38833,45,10,101,2234,315,2549
20200418,SD,1542,10118,1,,68,,,,,552,63e408f45e4b88e187c2ebb6b015764586d5ae05,2020-04-18T20:00:00Z,7,68,11661,11660,11660,46,0,5,467,131,598
20200418,TN,6762,83824,,,719,,,,,3234,d775321820b86101ebf8a3437f125acfcc909d18,2020-04-18T20:00:00Z,145,719,90586,90586,90586,47,3,8,3140,173,3313
20200418,TX,18260,157979,,1321,,,,,,4806,21eb573f5111b59ca48c587165ac1b22e4dc74e4,2020-04-18T20:00:00Z,453,,176239,176239,176239,48,25,0,5814,889,6703
20200418,UT,2931,57013,,,251,,,,,565,543bc8845f617c2fc7fdf1c0b5baca4a71413e4e,2020-04-18T20:00:00Z,25,251,59944,59944,59944,49,2,7,4047,126,4173
20200418,VA,8053,43878,486,1307,1296,398,,230,,1228,0ba994d2be950ed6b9023307d6ed059b6be70d6a,2020-04-18T20:00:00Z,258,1296,52417,51931,51931,51,27,75,2372,562,2934
20200418,VI,53,390,35,,,,,,,46,671d457b1cf63196b9c46ef63410e667b8117957,2020-04-18T20:00:00Z,3,,478,443,443,78,1,0,17,2,19
20200418,VT,803,11763,,56,,,,,,15,36960d6661dba9cc126639823445d0cfbcd55a3f,2020-04-18T20:00:00Z,38,,12566,12566,12566,50,3,0,426,24,450
20200418,WA,11887,140809,,518,,155,,,,,647d092b7e27d899a961051c127d859edf8fa4c3,2020-04-18T20:00:00Z,598,,152696,152696,152696,53,13,0,2038,214,2252
20200418,WI,4199,43962,229,361,1176,135,307,,,,c8533bced41a10a9ce61ad9d9def36404b71d154,2020-04-18T20:00:00Z,211,1176,48390,48161,48161,55,6,23,1597,154,1751
20200418,WV,785,18655,,83,,40,,27,,255,a75aca4c21fff87eb0ae0f470119102cf9033ec1,2020-04-18T20:00:00Z,16,,19440,19440,19440,54,3,0,728,31,759
20200418,WY,305,6217,,19,50,,,,,206,be9193c6ea5170561593d1cbbd0bd8ec3c02ccdc,2020-04-18T20:00:00Z,2,50,6522,6522,6522,56,0,7,86,9,95
20200417,AK,309,9141,,,36,,,,,128,c3c164894704f8aebee11fc4f6ad0bc28ccd9bcd,2020-04-17T20:00:00Z,9,36,9450,9450,9450,02,0,1,706,9,715
20200417,AL,4530,33318,,,594,,247,,148,,45dcb973e5afc9f133feabe69f3dd9bee397039d,2020-04-17T20:00:00Z,144,594,37848,37848,37848,01,11,41,1272,185,1457
20200417,AR,1695,21799,,83,,,,21,,593,00867f9f13791928c5808e7a74ea2b0977d4156b,2020-04-17T20:00:00Z,37,,23494,23494,23494,05,0,0,744,75,819
20200417,AS,0,3,17,,,,,,,,90ca343d5718470453e1b9cee714cd1df362e638,2020-04-17T20:00:00Z,,,20,3,3,60,0,0,0,0,0
20200417,AZ,4507,44723,,566,,285,,178,,539,fb9ae32e3ee2c773d7e1d5128b796e95fe258990,2020-04-17T20:00:00Z,169,,49230,49230,49230,04,19,0,1559,273,1832
20200417,CA,27528,224086,7200,4892,,1484,,,,,0848a86720c79066de7797bb7080a731c9a49879,2020-04-17T20:00:00Z,985,,258814,251614,251614,06,95,0,3868,1346,5214
20200417,CO,8675,33155,,858,1693,,,,,,7bfd6ed89a0f9cc44bd6bd15e24dbe0b2f78465d,2020-04-17T20:00:00Z,374,1693,41830,41830,41830,08,17,57,902,395,1297
20200417,CT,16809,38653,,1946,,,,,,,937ae531cbd43b25e4861134fd7b1c3d108019b8,2020-04-17T20:00:00Z,1036,,55462,55462,55462,09,65,0,1415,925,2340
20200417,DC,2476,10167,,313,,105,,79,,573,324321d343090fa89ad61fc4763554ddaf591b02,2020-04-17T20:00:00Z,86,,12643,12643,12643,11,5,0,367,126,493
20200417,DE,2323,11694,,224,,,,,,423,fa6c14a855f5d451c0d2917f1fa32b0be9c906cb,2020-04-17T20:00:00Z,61,,14017,14017,14017,10,9,0,419,248,667
20200417,FL,24119,210718,1285,,3665,,,,,,8a55e8a0ee83d8d7159d1859c7f34038d348c42c,2020-04-17T20:00:00Z,699,3665,236122,234837,234837,12,53,205,14367,1222,15589
20200417,GA,17194,54490,,,3324,,,,,,cf9cb75a5ed95172d0970a1fb552b6b3aeee75b3,2020-04-17T20:00:00Z,650,3324,71684,71684,71684,13,63,216,2220,1525,3745
20200417,GU,133,940,,6,,2,,,,97,e3904158a19bac50a6ad9085d932784f38087a97,2020-04-17T20:00:00Z,5,,1073,1073,1073,66,0,0,70,0,70
20200417,HI,541,21316,,,45,,,,,374,65fd57da094ad148b31cf321853505cad29cf13b,2020-04-17T20:00:00Z,9,45,21857,21857,21857,15,0,0,1146,11,1157
20200417,IA,2332,19460,,183,,88,,52,,1007,743c17c0be91e3dcd96023a0b17550b906833fd6,2020-04-17T20:00:00Z,64,,21792,21792,21792,19,4,0,926,191,1117
20200417,ID,1609,14574,,,148,,51,,,390,f668581521143edad8f8ab891e5a5c833811e568,2020-04-17T20:00:00Z,41,148,16183,16183,16183,16,0,5,330,22,352
20200417,IL,27575,102588,,4454,,1196,,777,,,aed86e4a64aa42a61dd9b9d90b80ddc6f0f8f313,2020-04-17T20:00:00Z,1134,,130163,130163,130163,17,62,0,5732,1842,7574
20200417,IN,10154,44631,,,,638,,417,,,fb891b635ab79ac5879b853cd6f286a95af310ec,2020-04-17T20:00:00Z,519,,54785,54785,54785,18,42,0,3058,612,3670
20200417,KS,1705,15196,,,375,,,,,,7b4bfcfe6666776c87956a66fe9418794c69a39e,2020-04-17T20:00:00Z,84,375,16901,16901,16901,20,4,16,662,117,779
20200417,KY,2429,27318,,477,971,333,506,,,956,959ae2f4da8c8312c664905ee46889190838e629,2020-04-17T20:00:00Z,129,971,29747,29747,29747,21,7,164,1285,138,1423
20200417,LA,23118,108869,,1868,,,,363,,,e81028ceb787333a5d374df0bbc6e18dee65512e,2020-04-17T20:00:00Z,1213,,131987,131987,131987,22,57,0,4815,586,5401
20200417,MA,35125,117195,,3756,3756,987,,,,,ebea2296b092cd5078d75b58475053bbab2d02b7,2020-04-17T20:00:00Z,1822,3756,152320,152320,152320,25,155,30,7097,2633,9730
20200417,MD,11572,50437,,,2612,,,,,736,dc86a5af2a6ca80e088e2e808f6cc34a9a5cfcce,2020-04-17T20:00:00Z,425,2612,62009,62009,62009,24,33,161,2378,788,3166
20200417,ME,827,14076,,55,133,28,,8,,352,0d4df50e7aab010ceeaf7b19f540dad2653da0e7,2020-04-17T20:00:00Z,29,133,14903,14903,14903,23,2,3,0,31,31
20200417,MI,30023,68936,,3674,,1428,,1167,,629,d06230acbb65a805506492581bba6e586293d304,2020-04-17T20:00:00Z,2227,,98959,98959,98959,26,134,0,3913,760,4673
20200417,MN,2071,40982,,223,518,106,202,,,1066,5733dd18761393e8548530c42a910ad330964388,2020-04-17T20:00:00Z,111,518,43053,43053,43053,27,17,43,1219,159,1378
20200417,MO,5283,46434,,1043,,,,,,,0455d0d245866e7d682abab839b2bd17ceea0edb,2020-04-17T20:00:00Z,165,,51717,51717,51717,29,13,0,897,172,1069
20200417,MP,13,42,4,,,,,,,,5d1e30c8e3fde663e5fbe35f229964ef81e56f79,2020-04-17T20:00:00Z,2,,59,55,55,69,0,0,15,0,15
20200417,MS,3793,34791,,,736,154,,99,,,be3208b4f3448e30b365470dbe34fd2a5ba5cd32,2020-04-17T20:00:00Z,140,736,38584,38584,38584,28,11,54,0,169,169
20200417,MT,422,9822,,21,54,,,,,233,dcf104975fe661e77fdee7292f708972ddb7704a,2020-04-17T20:00:00Z,8,54,10244,10244,10244,30,1,2,301,7,308
20200417,NC,5859,67122,,429,,,,,,,36c22ac0ce8eb3827d8f24b776cd22bd31759e27,2020-04-17T20:00:00Z,152,,72981,72981,72981,37,21,0,1670,394,2064
20200417,ND,439,11903,,16,47,,,,,172,8ebc1913ded71278974a8df56e399b01f3967ba7,2020-04-17T20:00:00Z,9,47,12342,12342,12342,38,0,2,592,46,638
20200417,NE,1066,12038,,,,,,,,,702131468cb79aacf355dfbccdebdd04ece74fee,2020-04-17T20:00:00Z,24,,13104,13104,13104,31,3,0,696,114,810
20200417,NH,1287,11421,174,74,190,,,,,455,b50f444c0fe2cf7ed5056d353436c1e4e873fcec,2020-04-17T20:00:00Z,37,190,12882,12708,12708,33,5,12,394,148,542
20200417,NJ,78467,78982,,8011,,1961,,1594,,,7722a23203ac41ff398af795fcc2094c7bd24cde,2020-04-17T20:00:00Z,3840,,157449,157449,157449,34,322,0,2469,3150,5619
20200417,NM,1597,32891,,90,230,,,,,353,26835a1513b9e3079e2a32db9346f8a0485e1247,2020-04-17T20:00:00Z,44,230,34488,34488,34488,35,8,15,981,113,1094
20200417,NV,3524,26238,,,,,,,,,3c0f7214c9269e3f1b5a0e0880e540abee1e0183,2020-04-17T20:00:00Z,142,,29762,29762,29762,32,5,0,1108,203,1311
20200417,NY,229642,343581,,17116,50508,5059,,,,33392,da59d24337656b65ecdf2aed3d9b83c92b8887dd,2020-04-17T20:00:00Z,12822,50508,573223,573223,573223,36,630,1973,15286,7358,22644
20200417,OH,8858,68819,,,2424,,740,,,,366867b8710ccb4873954bcf3720e21dd872cc38,2020-04-17T20:00:00Z,418,2424,77677,77677,77677,39,29,93,2393,444,2837
20200417,OK,2465,31155,,325,528,155,,,,1331,603ffb4b425ba80e433b8ba7de9827da0e6ecfa6,2020-04-17T20:00:00Z,136,528,33620,33620,33620,40,5,0,2613,108,2721
20200417,OR,1785,34536,,301,427,69,,41,,,88ad63feef7a476846b281e7a5ca0d06f5a2b9bf,2020-04-17T20:00:00Z,70,427,36321,36321,36321,41,6,13,1334,49,1383
20200417,PA,29441,117932,,2603,,,,661,,,7753812f0b3fd92934a49267cfdee8d8704d2188,2020-04-17T20:00:00Z,756,,147373,147373,147373,42,49,0,4197,1706,5903
20200417,PR,1068,7864,1478,,,,,,,,2679d31cdf8d9a2bfe948e85ac5ab1ff133a8ffc,2020-04-17T20:00:00Z,58,,10410,8932,8932,72,2,0,549,25,574
20200417,RI,4177,26584,,252,331,62,,43,,196,c63aa5aaf5bfd7ac7c785015118a59aae01aa1bb,2020-04-17T20:00:00Z,118,331,30761,30761,30761,44,13,0,2358,339,2697
20200417,SC,3931,32353,,,675,,,,,,1831fa1707525e22e14e5bd9c3004469a2a5db12,2020-04-17T20:00:00Z,109,675,36284,36284,36284,45,2,0,1276,275,1551
20200417,SD,1411,9651,0,,63,,,,,457,ab6d709096e5bc28e2d2b8e89f43ed3dda957bcf,2020-04-17T20:00:00Z,7,63,11062,11062,11062,46,0,8,412,100,512
20200417,TN,6589,80684,,,711,,,,,3017,14d476e6bb2b3510a4bd87e166ee3fd62ea61bbc,2020-04-17T20:00:00Z,142,711,87273,87273,87273,47,1,20,1897,327,2224
20200417,TX,17371,152165,,1522,,,,,,4190,8623aff77e66ba45458a1b0a3bd58bdf7003ffa3,2020-04-17T20:00:00Z,428,,169536,169536,169536,48,35,0,10073,916,10989
20200417,UT,2805,52966,,,244,,,,,443,e4d62921a010ad39f3d55f9106fcd9e0803a7648,2020-04-17T20:00:00Z,23,244,55771,55771,55771,49,2,6,5971,122,6093
20200417,VA,7491,41506,499,1308,1221,400,,224,,1110,ff7ccb63ac538a9363756f8828b0f638e720c076,2020-04-17T20:00:00Z,231,1221,49496,48997,48997,51,23,107,1951,602,2553
20200417,VI,51,373,34,,,,,,,46,d7c7429bb77548894a0b2ec5bdb55b2b75c80c25,2020-04-17T20:00:00Z,2,,458,424,424,78,1,0,16,0,16
20200417,VT,779,11337,,32,,,,,,15,9e438cc9be758290e0a6f4a230c492d486348ddd,2020-04-17T20:00:00Z,35,,12116,12116,12116,50,0,0,598,11,609
20200417,WA,11673,138771,,622,,195,,,,,1bedbece22219d159f20fc58daa00945038ae1ae,2020-04-17T20:00:00Z,585,,150444,150444,150444,53,14,0,4020,330,4350
20200417,WI,4045,42365,198,361,1153,141,306,348,,,c9ef889d54f4bfde0ead54b94940b942c3470029,2020-04-17T20:00:00Z,205,1153,46608,46410,46410,55,8,32,1391,170,1561
20200417,WV,754,17927,,85,,34,,24,,223,ad31b1e4321ce885951bf5265875a40b6bb326a5,2020-04-17T20:00:00Z,13,,18681,18681,18681,54,0,0,360,15,375
20200417,WY,296,6131,,19,43,,,,,148,642a8ad48c6d39a9b280ab3d557e5b93916c72ca,2020-04-17T20:00:00Z,2,43,6427,6427,6427,56,0,0,0,0,0
20200416,AK,300,8435,,,35,,,,,110,42353f78693987154276c7c482342a46ec11c180,2020-04-16T20:00:00Z,9,35,8735,8735,8735,02,0,1,64,7,71
20200416,AL,4345,32046,,,553,,227,,137,,bc8d87a6ade709e9ed0c8824e73dff454277a85f,2020-04-16T20:00:00Z,133,553,36391,36391,36391,01,12,28,2082,232,2314
20200416,AR,1620,21055,,85,,,,21,,548,95e15a426548163accca607e39e7c97a7e229f6e,2020-04-16T20:00:00Z,37,,22675,22675,22675,05,4,0,790,51,841
20200416,AS,0,3,17,,,,,,,,614a57a963d84c55c40b863aaf08221f68f0387c,2020-04-16T20:00:00Z,,,20,3,3,60,0,0,0,0,0
20200416,AZ,4234,43164,,578,,278,,188,,460,1a168d4509dfc562564670fbcf91399c32b0981a,2020-04-16T20:00:00Z,150,,47398,47398,47398,04,8,0,1816,272,2088
20200416,CA,26182,220218,13200,5031,,1568,,,,,5dcfd2b30974d93b8a73329bff070f19d3c6b04f,2020-04-16T20:00:00Z,890,,259600,246400,246400,06,69,0,28156,1758,29914
20200416,CO,8280,32253,,859,1636,,,,,,5ab00d24748f984e874dbb1cec5d4e0baa5bc875,2020-04-16T20:00:00Z,357,1636,40533,40533,40533,08,28,80,614,339,953
20200416,CT,15884,37238,,1926,,,,,,,1bb94dbdf022f3759ed20948cdbc345e04c11271,2020-04-16T20:00:00Z,971,,53122,53122,53122,09,103,0,1850,1129,2979
20200416,DC,2350,9800,,313,,105,,79,,552,100abd89bf88d9f88b0684c7fd04cc5c47fdbb60,2020-04-16T20:00:00Z,81,,12150,12150,12150,11,9,0,472,153,625
20200416,DE,2075,11275,,209,,,,,,378,dd363b6c3c0463e2a6e649df8585db9df967656e,2020-04-16T20:00:00Z,52,,13350,13350,13350,10,6,0,187,61,248
20200416,FL,22897,196351,1325,,3460,,,,,,06c954c644a662900c772814ef2f221fa53f2cfb,2020-04-16T20:00:00Z,646,3460,220573,219248,219248,12,37,116,5353,386,5739
20200416,GA,15669,52270,,,3108,,,,,,8aaf9eeaa61c479d5fbdec370b859848240cbb24,2020-04-16T20:00:00Z,587,3108,67939,67939,67939,13,35,186,3167,682,3849
20200416,GU,133,870,,9,,,,,,86,41b049f4b9301c716507dd67d19e8d448dde28f4,2020-04-16T20:00:00Z,5,,1003,1003,1003,66,0,0,27,0,27
20200416,HI,530,20170,,,45,,,,,359,e33b0740a6789b0e6c49839355dc5383946c7e82,2020-04-16T20:00:00Z,9,45,20700,20700,20700,15,0,0,884,13,897
20200416,IA,2141,18534,,175,,84,,48,,987,811a574b1b6eb83be03e008db2fb01e26663f57a,2020-04-16T20:00:00Z,60,,20675,20675,20675,19,7,0,660,146,806
20200416,ID,1587,14244,,,143,,46,,,,2760055f6b99a310921a9e6d1a2ed07aae6c7b81,2020-04-16T20:00:00Z,41,143,15831,15831,15831,16,2,2,310,123,433
20200416,IL,25733,96856,,4423,,1248,,797,,,23ce0bf16b1ad45da236bf0f2008ea9c7690fa8f,2020-04-16T20:00:00Z,1072,,122589,122589,122589,17,124,0,4520,1140,5660
20200416,IN,9542,41573,,,,696,,426,,,2927dc0fb6c1d5ce0ee783aad32fe18025ac0c3d,2020-04-16T20:00:00Z,477,,51115,51115,51115,18,41,0,2132,587,2719
20200416,KS,1588,14534,,,359,,,,,,f575d83d57c7f02002f57572833006ef35cd7045,2020-04-16T20:00:00Z,80,359,16122,16122,16122,20,4,17,1360,94,1454
20200416,KY,2291,26033,,412,807,252,367,,,862,cf873721a2821eccf77c5806ad0e9bf84eead44a,2020-04-16T20:00:00Z,122,807,28324,28324,28324,21,7,120,546,81,627
20200416,LA,22532,104054,,1914,,,,396,,,6ae3a5f7f0b1e1a5c00710d1a5571702dfbff14c,2020-04-16T20:00:00Z,1156,,126586,126586,126586,22,53,0,4077,581,4658
20200416,MA,32492,110098,,3726,3726,973,,,,,b99c877b1097918d5664ea3191a134d9ab550430,2020-04-16T20:00:00Z,1667,3726,142590,142590,142590,25,165,89,7308,2522,9830
20200416,MD,10784,48059,,,2451,,,,,736,d56e3e4ce6ef5676611c0e85ddcb6285cc9b16f3,2020-04-16T20:00:00Z,392,2451,58843,58843,58843,24,43,220,2328,752,3080
20200416,ME,796,14076,,47,130,20,,7,,333,be0574a2f960338b2bd6f86c05096a5e3efe7620,2020-04-16T20:00:00Z,27,130,14872,14872,14872,23,3,4,0,26,26
20200416,MI,29263,65023,,3809,,1447,,1211,,617,fc2f4153662699af6660687292deea26fb89bd6f,2020-04-16T20:00:00Z,2093,,94286,94286,94286,26,172,0,3385,1204,4589
20200416,MN,1912,39763,,213,475,103,188,,,1020,b833be00de318500a4f0801f2a296db180d26ee7,2020-04-16T20:00:00Z,94,475,41675,41675,41675,27,7,30,1330,103,1433
20200416,MO,5111,45537,,1043,,,,,,,53b0c28902cfc5e79cd3ef99c641acc23be5c41c,2020-04-16T20:00:00Z,152,,50648,50648,50648,29,5,0,1420,216,1636
20200416,MP,13,27,7,,,,,,,,7d544f5f807e9f8c276238d3a04583cea4a44be8,2020-04-16T20:00:00Z,2,,47,40,40,69,0,0,0,0,0
20200416,MS,3624,34791,,,682,154,,99,,,5717e19e747db660898e4565434b15677e31d469,2020-04-16T20:00:00Z,129,682,38415,38415,38415,28,7,37,0,264,264
20200416,MT,415,9521,,21,52,,,,,218,99cabfac3936ec988dc0c385d4bee214e6ecb79e,2020-04-16T20:00:00Z,7,52,9936,9936,9936,30,0,1,342,11,353
20200416,NC,5465,65452,,452,,,,,,,a2c94ae3b889dfdf1066125f7d3d2876e246863a,2020-04-16T20:00:00Z,131,,70917,70917,70917,37,14,0,2748,342,3090
20200416,ND,393,11311,,14,45,,,,,163,7c3e7659bc28e4b0d83b64339e64eb138aa67867,2020-04-16T20:00:00Z,9,45,11704,11704,11704,38,0,1,359,28,387
20200416,NE,952,11342,,,,,,,,,8b2863e154a48cb4ef39054af406ec77527e3bd7,2020-04-16T20:00:00Z,21,,12294,12294,12294,31,1,0,514,51,565
20200416,NH,1139,11027,121,70,178,,,,,365,6397ebd7f9ef6f49d37c39a9cd815134cc8c6cec,2020-04-16T20:00:00Z,32,178,12287,12166,12166,33,0,0,0,0,0
20200416,NJ,75317,76513,,8224,,2014,,1645,,,8f04a2a6fb4ff0d2e41da80b7bca3da6ae2279ff,2020-04-16T20:00:00Z,3518,,151830,151830,151830,34,362,0,3522,4287,7809
20200416,NM,1484,31910,,90,215,,,,,353,e5c87a0fafb5269e348f0ecb57470090ffb7e441,2020-04-16T20:00:00Z,36,215,33394,33394,33394,35,0,34,467,77,544
20200416,NV,3321,25130,,,,,,,,,d6b686120e1dfc653a79c73a2e541bc0063949c6,2020-04-16T20:00:00Z,137,,28451,28451,28451,32,6,0,686,110,796
20200416,NY,222284,328295,,17735,48535,5091,,,,30800,3548aab49404f89bcf09758dc663763f13de98a1,2020-04-16T20:00:00Z,12192,48535,550579,550579,550579,36,606,1996,16062,8505,24567
20200416,OH,8414,66426,,,2331,,707,,,,d2f0dea6e94f7fef69d41e2dbbead2143d030efd,2020-04-16T20:00:00Z,389,2331,74840,74840,74840,39,28,94,2665,623,3288
20200416,OK,2357,28542,,236,528,163,,,,1240,34565e51b7a75892769360e0777101a5ee4a420b,2020-04-16T20:00:00Z,131,528,30899,30899,30899,40,8,18,1586,94,1680
20200416,OR,1736,33202,,307,414,89,,43,,,7687b415f103f263c88274f27175bd5f223e0fcf,2020-04-16T20:00:00Z,64,414,34938,34938,34938,41,6,13,1514,73,1587
20200416,PA,27735,113735,,2512,,,,675,,,3451836d13d960a278308c0a8bc877668376fda8,2020-04-16T20:00:00Z,707,,141470,141470,141470,42,60,0,2641,1245,3886
20200416,PR,1043,7315,1465,,,,,,,,0f1b0b0eccfdaeeafea3a6c037a304b113bb219d,2020-04-16T20:00:00Z,56,,9823,8358,8358,72,5,0,490,69,559
20200416,RI,3838,24226,,245,331,61,,43,,182,bb544990f7c3e3da791f26108024f6657594c9c3,2020-04-16T20:00:00Z,105,331,28064,28064,28064,44,18,0,1858,309,2167
20200416,SC,3656,31077,,,675,,,,,,4f595f8157dc108d79c5c84582734e32cad3cfe9,2020-04-16T20:00:00Z,107,675,34733,34733,34733,45,0,0,0,0,0
20200416,SD,1311,9239,2,,55,,,,,373,acf65b2256b92f503485645dfd2318e10c6517d8,2020-04-16T20:00:00Z,7,55,10552,10550,10550,46,1,4,548,143,691
20200416,TN,6262,78787,,,691,,,,,2786,eaf32844c68a683d76188caaa701c09a801e5a95,2020-04-16T20:00:00Z,141,691,85049,85049,85049,47,6,28,3970,183,4153
20200416,TX,16455,142092,,1459,,,,,,3677,f5a1a7a1a57afbec5a59835798a8bafb84e8d661,2020-04-16T20:00:00Z,393,,158547,158547,158547,48,29,0,5774,963,6737
20200416,UT,2683,46995,,,238,,,,,357,4c78de52111a12808864cd3f24c4421ed0ed2e16,2020-04-16T20:00:00Z,21,238,49678,49678,49678,49,1,17,1923,141,2064
20200416,VA,6889,39555,537,1337,1114,427,,238,,951,eae55eac787f3e4c2e73870cc66c941eb81919a5,2020-04-16T20:00:00Z,208,1114,46981,46444,46444,51,13,66,1886,389,2275
20200416,VI,51,357,35,,,,,,,46,143c5d6649137d1edc42de6a5dd0031c456f3d4f,2020-04-16T20:00:00Z,1,,443,408,408,78,0,0,26,0,26
20200416,VT,768,10739,,58,,,,,,15,1ea60000d2e949646925602b03e1fd49dd2bfeef,2020-04-16T20:00:00Z,35,,11507,11507,11507,50,5,0,417,9,426
20200416,WA,11343,134751,,595,,196,,,,,07af54dd55a69469820af90db350c7eb11c84e8f,2020-04-16T20:00:00Z,571,,146094,146094,146094,53,20,0,3923,243,4166
20200416,WI,3875,40974,218,394,1121,147,299,,,,b489f85e57a1a10a130ad9b1a778b36f397c01ab,2020-04-16T20:00:00Z,197,1121,45067,44849,44849,55,15,30,1648,154,1802
20200416,WV,739,17567,,85,,34,,24,,223,05b379c922d4696ed601bea890c1897fb79d5174,2020-04-16T20:00:00Z,13,,18306,18306,18306,54,3,0,613,37,650
20200416,WY,296,6131,,19,43,,,,,148,e5c5dc72231ac86d9fbfe8b9c6bd9ee605b3943c,2020-04-16T20:00:00Z,2,43,6427,6427,6427,56,0,0,89,9,98
20200415,AK,293,8371,,,34,,,,,106,673f84f2ad0944b787570c22a3fa5081f0dee21a,2020-04-15T20:00:00Z,9,34,8664,8664,8664,02,0,2,308,8,316
20200415,AL,4113,29964,,,525,,219,,134,,b67f0835fabad299a3701a2e6ba8f3214f60186b,2020-04-15T20:00:00Z,121,525,34077,34077,34077,01,11,32,723,237,960
20200415,AR,1569,20265,,83,130,,43,26,39,489,3d44b421c28add57d694ce93d5d4fb0c52b4f1f1,2020-04-15T20:00:00Z,33,130,21834,21834,21834,05,3,0,614,89,703
20200415,AS,0,3,17,,,,,,,,8e1b2a94a99618ad907f782452421342c293290e,2020-04-15T20:00:00Z,,,20,3,3,60,0,0,0,0,0
20200415,AZ,3962,41348,,590,,286,,202,,385,cced5a2b57e0eb8fe4113e4fc7de313b92761598,2020-04-15T20:00:00Z,142,,45310,45310,45310,04,11,0,1058,156,1214
20200415,CA,24424,192062,13200,5163,,1175,,,,,07566a23b8d837a8af05eb08dd1bbc9beabd8fef,2020-04-15T20:00:00Z,821,,229686,216486,216486,06,63,0,13192,1086,14278
20200415,CO,7941,31639,,878,1556,,,,,,178915c7cf54d7841b476b3396ad50ac5e2fade6,2020-04-15T20:00:00Z,329,1556,39580,39580,39580,08,21,63,588,250,838
20200415,CT,14755,35388,,1908,,,,,,,2d22b602de0610e18d57043cc51080f8edba9a01,2020-04-15T20:00:00Z,868,,50143,50143,50143,09,197,0,3536,766,4302
20200415,DC,2197,9328,,313,,105,,79,,530,40f095fc5893e7b59e1156d52eef137249615c15,2020-04-15T20:00:00Z,72,,11525,11525,11525,11,5,0,102,139,241
20200415,DE,2014,11088,,208,,,,,,354,16da060a7231775a11a6c916d60f30170d958dec,2020-04-15T20:00:00Z,46,,13102,13102,13102,10,5,0,545,253,798
20200415,FL,22511,190998,1335,,3344,,,,,,f8fa87d0742465433075ca7eaf8ea8118844a595,2020-04-15T20:00:00Z,609,3344,214844,213509,213509,12,72,284,9185,1144,10329
20200415,GA,14987,49103,,,2922,,,,,,cae9735f50c95ddb53ba6d92a2f2b3fcddd93e6c,2020-04-15T20:00:00Z,552,2922,64090,64090,64090,13,51,153,1531,764,2295
20200415,GU,133,843,,9,,2,,2,,73,855d9a48ffb5261d0ae9474ce1137deb6bbfbcc4,2020-04-15T20:00:00Z,5,,976,976,976,66,0,0,32,0,32
20200415,HI,517,19286,,,45,,,,,333,a714a697aec8c9b1f06e2418ad98376f9995f6cf,2020-04-15T20:00:00Z,9,45,19803,19803,19803,15,0,1,370,13,383
20200415,IA,1995,17874,,171,,78,,43,,908,325bab5cc4423ccded984dc754f6627f5de425ef,2020-04-15T20:00:00Z,53,,19869,19869,19869,19,4,0,888,96,984
20200415,ID,1464,13934,,,141,,43,,,,47b70ce8d525ccfe2bdcc36bf60c815557d3ef29,2020-04-15T20:00:00Z,39,141,15398,15398,15398,16,6,6,273,11,284
20200415,IL,24593,92336,,4283,,1189,,796,,,0c46a8e1185cbf2da83f959bc450567d3e657902,2020-04-15T20:00:00Z,948,,116929,116929,116929,17,80,0,4967,1346,6313
20200415,IN,8955,39441,,,,737,,422,,,2e66ab2081462fe7175b10cf71954f89ee0bd970,2020-04-15T20:00:00Z,436,,48396,48396,48396,18,48,0,1951,428,2379
20200415,KS,1494,13174,,,342,,,,,,741290e76dc8a96f228e1b1f0265839274c1bb2f,2020-04-15T20:00:00Z,76,342,14668,14668,14668,20,7,15,453,68,521
20200415,KY,2210,25487,,305,687,137,263,,,653,7a9d1b012f945c1b95c8ae33f3e74905cb97db2c,2020-04-15T20:00:00Z,115,687,27697,27697,27697,21,11,14,852,162,1014
20200415,LA,21951,99977,,1943,,,,425,,,4867cbef72b802351bee7b6a64aeb28b6cf873ea,2020-04-15T20:00:00Z,1103,,121928,121928,121928,22,90,0,3073,433,3506
20200415,MA,29970,102790,,3637,3637,973,,,,,0f53efb56c9b5dcb3bedc9ec7dd29c39c3c13c00,2020-04-15T20:00:00Z,1502,3637,132760,132760,132760,25,173,21,3970,1861,5831
20200415,MD,10032,45731,,,2231,,,,,607,21fc0ecd1c9792f868faec7e483042e4a31d3ce3,2020-04-15T20:00:00Z,349,2231,55763,55763,55763,24,47,109,1470,560,2030
20200415,ME,770,14076,,48,126,22,,9,,305,e9cf94b8fa7dbbd5ae8f4d19a59dc0e95f68bb69,2020-04-15T20:00:00Z,24,126,14846,14846,14846,23,4,2,2468,36,2504
20200415,MI,28059,61638,,3918,,1468,,1212,,452,c15ad5c7dee7ddd892a0f92c12ece0400b55d4a7,2020-04-15T20:00:00Z,1921,,89697,89697,89697,26,153,0,2413,1058,3471
20200415,MN,1809,38433,,197,445,93,175,,,940,f1171cb80ab97afa1d029dfd356d4615dc88bfb7,2020-04-15T20:00:00Z,87,445,40242,40242,40242,27,8,40,887,114,1001
20200415,MO,4895,44117,,1024,,,,,,,6e4be90622adf587d625b5751989a07a554a11af,2020-04-15T20:00:00Z,147,,49012,49012,49012,29,14,0,825,209,1034
20200415,MP,13,27,7,,,,,,,,9e4313b445ebbe0b16760b3bbee331ae6401250e,2020-04-15T20:00:00Z,2,,47,40,40,69,0,0,0,0,0
20200415,MS,3360,34791,,,645,154,,99,,,d05e5d2b8e752c0ad1a46b77af0cacd196370dd3,2020-04-15T20:00:00Z,122,645,38151,38151,38151,28,11,49,0,273,273
20200415,MT,404,9179,,21,51,,,,,209,93ecb003f2a23275e2e681d720654a0a2ceabaf8,2020-04-15T20:00:00Z,7,51,9583,9583,9583,30,0,1,344,5,349
20200415,NC,5123,62704,,431,,,,,,,5f92fc6275e53ffc256dcd7aef4ea36d732744f7,2020-04-15T20:00:00Z,117,,67827,67827,67827,37,9,0,2689,99,2788
20200415,ND,365,10952,,13,44,,,,,142,7560537f4933cf30f04500c5b9fa651e3eb9487b,2020-04-15T20:00:00Z,9,44,11317,11317,11317,38,0,2,377,24,401
20200415,NE,901,10828,,,,,,,,,d32127075c9d4b81935ccbceef63e04783cd46e6,2020-04-15T20:00:00Z,20,,11729,11729,11729,31,2,0,342,30,372
20200415,NH,1139,11027,121,70,178,,,,,365,015c02d79a187cd5e8069e8e8b56675ef3310118,2020-04-15T20:00:00Z,32,178,12287,12166,12166,33,9,26,437,119,556
20200415,NJ,71030,72991,,8270,,1980,,1705,,,a1d3be61faebbecb0fb2d8564b474468f1ffdd78,2020-04-15T20:00:00Z,3156,,144021,144021,144021,34,351,0,2041,2206,4247
20200415,NM,1407,31443,,87,181,,,,,340,c2a768159fbeb43c1952ca1b95b6da166f99514d,2020-04-15T20:00:00Z,36,181,32850,32850,32850,35,5,0,818,62,880
20200415,NV,3211,24444,,,,,,,,,982c76668c33c42b936979ce9d53140cf470e47d,2020-04-15T20:00:00Z,131,,27655,27655,27655,32,11,0,871,123,994
20200415,NY,213779,312233,,18535,46539,5225,,,,28004,14cd7089d1a89e5fed0fa3295b434240d02d6c87,2020-04-15T20:00:00Z,11586,46539,526012,526012,526012,36,752,2253,15298,11571,26869
20200415,OH,7791,63761,,,2237,,677,,,,ea6e49b055a0ca5556581c489b1856a532675634,2020-04-15T20:00:00Z,361,2237,71552,71552,71552,39,37,81,3040,638,3678
20200415,OK,2263,26956,,194,510,107,,,,1115,8a12432d26cb2221b2f83b98d44a24500c54d06c,2020-04-15T20:00:00Z,123,510,29219,29219,29219,40,15,22,871,79,950
20200415,OR,1663,31688,,305,401,95,,43,,,c6fed9f1fa421f55707f0ddac96736083ab45ee8,2020-04-15T20:00:00Z,58,401,33351,33351,33351,41,3,20,958,30,988
20200415,PA,26490,111094,,2395,,,,668,,,4318df239342730ed7c96fe01174f84b229181cf,2020-04-15T20:00:00Z,647,,137584,137584,137584,42,63,0,2808,1145,3953
20200415,PR,974,6825,1410,,,,,,,,43474cb427471e7c540223732e9e98269c0e2af1,2020-04-15T20:00:00Z,51,,9209,7799,7799,72,6,0,541,51,592
20200415,RI,3529,22368,,229,331,54,,44,,168,505c2312cd82df0fdf0f7f2f0985489df7125f75,2020-04-15T20:00:00Z,87,331,25897,25897,25897,44,7,0,2719,278,2997
20200415,SC,3656,31077,,,675,,,,,,a2abbb9b0fcf19b2af159e4a2079f4942aa3d7ac,2020-04-15T20:00:00Z,107,675,34733,34733,34733,45,10,0,758,103,861
20200415,SD,1168,8691,0,,51,,,,,329,56f54f4b46df7451d1557a1535094be9d8b7334e,2020-04-15T20:00:00Z,6,51,9859,9859,9859,46,0,6,383,180,563
20200415,TN,6079,74817,,,663,,,,,2196,2e637ff36a1861115fbebf8ec944d2c97aa82f70,2020-04-15T20:00:00Z,135,663,80896,80896,80896,47,11,30,1809,256,2065
20200415,TX,15492,136318,,1538,,,,,,3150,fd169f5a78bd0ac684499791a5ba2f0ee8318a26,2020-04-15T20:00:00Z,364,,151810,151810,151810,48,46,0,4475,868,5343
20200415,UT,2542,45072,,,221,,,,,218,f1de11bfb56f8f39c4440f1921363b342a5826da,2020-04-15T20:00:00Z,20,221,47614,47614,47614,49,1,8,1008,130,1138
20200415,VA,6500,37669,496,1298,1048,394,,234,,752,7dc829337ed6386ccc773e2f04348f2c7b7a0dbb,2020-04-15T20:00:00Z,195,1048,44665,44169,44169,51,41,1048,1077,329,1406
20200415,VI,51,331,35,,,,,,,44,95049b7539010144345654f7a3f6cbe6efbe462f,2020-04-15T20:00:00Z,1,,417,382,382,78,0,0,5,0,5
20200415,VT,759,10322,,63,,,,,,15,1669256ed2aed8d9f91b715cbbee0c6f85bc77f2,2020-04-15T20:00:00Z,30,,11081,11081,11081,50,1,0,489,7,496
20200415,WA,11100,130828,,645,,194,,,,,8eb3a372ac77e5d3251e6b05d7c17844fd55e7b0,2020-04-15T20:00:00Z,551,,141928,141928,141928,53,9,0,3719,311,4030
20200415,WI,3721,39326,280,406,1091,163,290,,,,d5c12eba567acf1c9e2ee2b9aa915afee64342cb,2020-04-15T20:00:00Z,182,1091,43327,43047,43047,55,12,42,1329,166,1495
20200415,WV,702,16954,,82,164,36,73,23,50,211,b18a653a4338aadc65598d0fcd0af46e08167006,2020-04-15T20:00:00Z,10,164,17656,17656,17656,54,1,0,556,62,618
20200415,WY,287,6042,,,43,,,,,129,5b2e779c0acd3bd8a1d72c7473eacb87867e6039,2020-04-15T20:00:00Z,2,43,6329,6329,6329,56,1,0,353,12,365
20200414,AK,285,8063,,,32,,,,,98,5315a4f1841f006de941785d317d4bb3057063e2,2020-04-14T20:00:00Z,9,32,8348,8348,8348,02,1,0,510,8,518
20200414,AL,3876,29241,,,493,,210,,132,,fdef67fc2526eb4972bb573db30ce225d2ac391e,2020-04-14T20:00:00Z,110,493,33117,33117,33117,01,11,36,3793,142,3935
20200414,AR,1480,19651,,81,130,,43,29,39,427,907ec6f1eeb2bdbc47087e6f29f8dd66d4e03d99,2020-04-14T20:00:00Z,30,130,21131,21131,21131,05,0,0,257,70,327
20200414,AS,0,3,17,,,,,,,,185c50b581ff3a04f08affd4eb6d8739e5f920fa,2020-04-14T20:00:00Z,,,20,3,3,60,0,0,0,0,0
20200414,AZ,3806,40290,,580,,286,,216,,249,7afc2afc97a6d3d4ee3cc637067272a2584445f8,2020-04-14T20:00:00Z,131,,44096,44096,44096,04,9,0,645,104,749
20200414,CA,23338,178870,13200,5163,,1552,,,,,1f65c8b2d5328790f9cbedda2bfe2325921ed07a,2020-04-14T20:00:00Z,758,,215408,202208,202208,06,71,0,10336,990,11326
20200414,CO,7691,31051,,888,1493,,,,,,066997c17f87cf08fc0d8b0e79f82164d05cfcb0,2020-04-14T20:00:00Z,308,1493,38742,38742,38742,08,4,21,1201,7,1208
20200414,CT,13989,31852,,1779,,,,,,,78f6969207143e30d7e31c57727060aa6dceb19d,2020-04-14T20:00:00Z,671,,45841,45841,45841,09,69,0,924,608,1532
20200414,DC,2058,9226,,295,,95,,31,,518,dafa456b34fa9ba6b89253015b782876f6cbefe1,2020-04-14T20:00:00Z,67,,11284,11284,11284,11,14,0,247,103,350
20200414,DE,1761,10543,,204,,,,,,277,0b4aa321c592c1b78fe25c7303b5c9ff0bd9eaf2,2020-04-14T20:00:00Z,41,,12304,12304,12304,10,6,0,348,136,484
20200414,FL,21367,181813,1275,,3060,,,,,,b577561bc8ed7135d1d5f86319c7618eb4d7e8d7,2020-04-14T20:00:00Z,537,3060,204455,203180,203180,12,54,227,6207,766,6973
20200414,GA,14223,47572,,,2769,,,,,,e98314a9ad82070e5aab98fae3a637052d835ecd,2020-04-14T20:00:00Z,501,2769,61795,61795,61795,13,37,180,3866,908,4774
20200414,GU,133,811,,13,,2,,2,,66,9f4b7ba625876b5201ec7e671fe751651e1e2a5c,2020-04-14T20:00:00Z,5,,944,944,944,66,0,0,41,0,41
20200414,HI,504,18916,,,44,,,,,315,e01e426d6c9851f6dff5ffdfb923dd0b2ccfa9e6,2020-04-14T20:00:00Z,9,44,19420,19420,19420,15,0,0,571,5,576
20200414,IA,1899,16986,,163,,73,,41,,741,ebcf272676e4b8542c2534292aab391679f1a075,2020-04-14T20:00:00Z,49,,18885,18885,18885,19,6,0,0,189,189
20200414,ID,1453,13661,,,135,,38,,,,777ef89768a10db7c9c8a2399853b4b909947c6e,2020-04-14T20:00:00Z,33,135,15114,15114,15114,16,6,3,206,27,233
20200414,IL,23247,87369,,4283,,1189,,796,,,193239d8b51a59855b00a55edee15ee316951607,2020-04-14T20:00:00Z,868,,110616,110616,110616,17,74,0,3626,1222,4848
20200414,IN,8527,37490,,,,721,,435,,,b69228298ef925c76acd39e5442c5bcc0d3f60d0,2020-04-14T20:00:00Z,388,,46017,46017,46017,18,38,0,1187,291,1478
20200414,KS,1426,12721,,,327,,,,,,bda44e265aa550daef73afb7ebc3569012d9df95,2020-04-14T20:00:00Z,69,327,14147,14147,14147,20,7,18,233,50,283
20200414,KY,2048,24635,,299,673,136,259,,,629,2b7342b70a38c752c22a13316b8d1e0a23e4ad2a,2020-04-14T20:00:00Z,104,673,26683,26683,26683,21,7,6,732,85,817
20200414,LA,21518,96904,,1977,,,,436,,,9b6c1ac221a66ad81a99cc1b339c9508902561d8,2020-04-14T20:00:00Z,1013,,118422,118422,118422,22,129,0,9829,502,10331
20200414,MA,28109,98820,,3616,3616,,,,,,bb29429e898609deac00b1417c2bc388fe4fdf7c,2020-04-14T20:00:00Z,1329,3616,126929,126929,126929,25,118,131,3320,1315,4635
20200414,MD,9472,44261,,,2122,,,,,607,2e95981d2f117826eb9aa5b28b4816a376ce9284,2020-04-14T20:00:00Z,302,2122,53733,53733,53733,24,40,147,1446,536,1982
20200414,ME,734,11608,,58,124,21,,9,,292,07611c393a61a586a42b1766b55713cde98bf804,2020-04-14T20:00:00Z,20,124,12342,12342,12342,23,1,0,0,36,36
20200414,MI,27001,59225,,3910,,1497,,1235,,452,2f9554ed2cfa321ae23a7feb3e0e69139276697b,2020-04-14T20:00:00Z,1768,,86226,86226,86226,26,166,0,2216,1366,3582
20200414,MN,1695,37546,,177,405,75,155,,,909,582ed8cc017fc1db3291ebb7cb62aa9ba87408fe,2020-04-14T20:00:00Z,79,405,39241,39241,39241,27,9,44,769,45,814
20200414,MO,4686,43292,,1041,,,,,,,4f05ef3a06d242a9732b6cffbf6a78bcf81f4925,2020-04-14T20:00:00Z,133,,47978,47978,47978,29,19,0,2252,298,2550
20200414,MP,13,27,7,,,,,,,,a825a7fc1d8625af08be8708a47baf7916020de0,2020-04-14T20:00:00Z,2,,47,40,40,69,0,0,0,2,2
20200414,MS,3087,34791,,,596,154,,99,,,956818cd92a3e7624c9d5b71ccc385f74c294bea,2020-04-14T20:00:00Z,111,596,37878,37878,37878,28,13,47,6749,145,6894
20200414,MT,399,8835,,24,50,,,,,197,fc436784be7707d945e86cb69153f25edaa5b085,2020-04-14T20:00:00Z,7,50,9234,9234,9234,30,0,3,131,5,136
20200414,NC,5024,60015,,418,,,,,,,25b8ebc740c6a41636dcd7006640fa333d730ee5,2020-04-14T20:00:00Z,108,,65039,65039,65039,37,22,0,1443,208,1651
20200414,ND,341,10575,,13,42,,,,,138,aebdbc20ca0b8176e70cdf76eb4121decf48183e,2020-04-14T20:00:00Z,9,42,10916,10916,10916,38,1,2,125,10,135
20200414,NE,871,10486,,,,,,,,,2a5e766de0b445c7f853572fbc5148b7ab52824b,2020-04-14T20:00:00Z,18,,11357,11357,11357,31,1,0,328,57,385
20200414,NH,1020,10590,25,72,152,,,,,249,a319f3c068f24a5e63d20b17ba8de4a3df3174b9,2020-04-14T20:00:00Z,23,152,11635,11610,11610,33,0,0,368,35,403
20200414,NJ,68824,70950,,8185,,2051,,1626,,,ad30f78b85ddfe5a8b36f19576395a501bb3d39a,2020-04-14T20:00:00Z,2805,,139774,139774,139774,34,362,0,6065,4240,10305
20200414,NM,1345,30625,,87,181,,,,,304,1ea50b47aeebd4b2d54a4f9eb5a54ebe59b81e96,2020-04-14T20:00:00Z,31,181,31970,31970,31970,35,5,181,1355,100,1455
20200414,NV,3088,23573,,,,,,,,,84edea65ba96938737a829b8879e09cdb21897fd,2020-04-14T20:00:00Z,120,,26661,26661,26661,32,6,0,1080,117,1197
20200414,NY,202208,296935,,18697,44286,5225,,,,25589,466fb5c4b5d55c7c16dce6af3cffa46054a97b5d,2020-04-14T20:00:00Z,10834,44286,499143,499143,499143,36,778,1649,13609,7177,20786
20200414,OH,7153,60721,,,2156,,654,,,,5563ce4cc048b615be4620e733469f6d2471b34f,2020-04-14T20:00:00Z,324,2156,67874,67874,67874,39,50,123,2584,178,2762
20200414,OK,2184,26085,,194,488,107,,,,1060,ad6efc671514f779a7ccf3bfde09ed25ac56da73,2020-04-14T20:00:00Z,108,488,28269,28269,28269,40,9,31,5295,115,5410
20200414,OR,1633,30730,,311,381,88,,44,,,0c9baedd69ce60c44de18753cb549c293194d646,2020-04-14T20:00:00Z,55,381,32363,32363,32363,41,2,12,1193,49,1242
20200414,PA,25345,108286,,2317,,,,675,,,01a6ae891224a47f84ff9b40c7a77eaddcd245be,2020-04-14T20:00:00Z,584,,133631,133631,133631,42,60,0,2693,1146,3839
20200414,PR,923,6284,1322,,,,,,,,416f53bbee917cbd5e0bccfba96b673ad5d98cb5,2020-04-14T20:00:00Z,45,,8529,7207,7207,72,0,0,324,20,344
20200414,RI,3251,19649,,213,331,48,,,,135,100fdd28f2a198c44f8475616daa554985d0fc15,2020-04-14T20:00:00Z,80,331,22900,22900,22900,44,7,0,1964,275,2239
20200414,SC,3553,30319,,,675,,,,,,b94c2f7d81c3145ed3927482fb441c1f24f64a37,2020-04-14T20:00:00Z,97,675,33872,33872,33872,45,15,179,2213,234,2447
20200414,SD,988,8308,0,,45,,,,,261,633f2e47635d660194aed76366c88094e21f2f42,2020-04-14T20:00:00Z,6,45,9296,9296,9296,46,0,1,174,120,294
20200414,TN,5823,73008,,,633,,,,,1969,44227e48a2f27f48600c51aeecc0ca4cb23464bf,2020-04-14T20:00:00Z,124,633,78831,78831,78831,47,15,54,2423,213,2636
20200414,TX,14624,131843,,1409,,,,,,2580,8dc9304f7eab3e5e43e2e6466c0e0a4a6d729443,2020-04-14T20:00:00Z,318,,146467,146467,146467,48,31,0,12523,718,13241
20200414,UT,2412,44064,,,213,,,,,218,b371027ae74241bec0dac952659857e3af0b88d7,2020-04-14T20:00:00Z,19,213,46476,46476,46476,49,1,12,640,49,689
20200414,VA,6171,36592,469,1282,,422,,276,,721,2356538f4c6deef4a2077015f365e0578fc8a7a1,2020-04-14T20:00:00Z,154,,43232,42763,42763,51,5,0,938,424,1362
20200414,VI,51,326,23,,,,,,,44,facae52660ca43c775c83bd24ccbfcaad65b267c,2020-04-14T20:00:00Z,1,,400,377,377,78,0,0,4,0,4
20200414,VT,752,9833,,64,,,,,,15,061b7b60b1af06764026b91889bc830546a1947f,2020-04-14T20:00:00Z,29,,10585,10585,10585,50,1,0,215,4,219
20200414,WA,10789,127109,,387,,98,,,,,8b57b4491941f7bab9f9a5636bf704501e3ac8e5,2020-04-14T20:00:00Z,542,,137898,137898,137898,53,16,0,3828,202,4030
20200414,WI,3555,37997,277,432,1049,161,283,,,,7a5f920f1bcc93e475c2a8662cb23daac46aa584,2020-04-14T20:00:00Z,170,1049,41829,41552,41552,55,16,56,1228,127,1355
20200414,WV,640,16398,,87,164,38,73,25,50,147,fdba0b7e2f9ca5d0216104868608ec2443bb58d8,2020-04-14T20:00:00Z,9,164,17038,17038,17038,54,0,0,369,14,383
20200414,WY,275,5689,,,43,,,,,140,569247545c3e5e81d159451c48da2af5143aa092,2020-04-14T20:00:00Z,1,43,5964,5964,5964,56,0,2,0,0,0
20200413,AK,277,7553,,,32,,,,,85,67560e7c63366eea20aa9e68ec2f1d41b712ce9a,2020-04-13T20:00:00Z,8,32,7830,7830,7830,02,0,1,-213,5,-208
20200413,AL,3734,25448,,,457,,189,,119,,fa960b1ff153c2babf5a49ba770f497397565eba,2020-04-13T20:00:00Z,99,457,29182,29182,29182,01,6,20,7390,209,7599
20200413,AR,1410,19394,,74,130,,43,28,39,391,babc64d1c0a349d46b8b6acb6d58ae86d81a931a,2020-04-13T20:00:00Z,30,130,20804,20804,20804,05,3,0,952,130,1082
20200413,AS,0,3,,,,,,,,,126d68a7fa8062e651ab412124fc1136d7cba009,2020-04-13T20:00:00Z,,,3,3,3,60,0,0,0,0,0
20200413,AZ,3702,39645,,525,,286,,195,,,0ce3933cdbea79fb6bb942023171da802a935825,2020-04-13T20:00:00Z,122,,43347,43347,43347,04,7,0,1075,163,1238
20200413,CA,22348,168534,13200,3015,,1178,,,,,aa396d040ac6c94b3d80e0f82bfb7a57cf2eb4d1,2020-04-13T20:00:00Z,687,,204082,190882,190882,06,36,0,0,554,554
20200413,CO,7684,29850,,842,1472,,,,,,c1524362540b43dfbb856c0e11dcdba123b64be0,2020-04-13T20:00:00Z,304,1472,37534,37534,37534,08,30,96,1870,791,2661
20200413,CT,13381,30928,,1760,,,,,,,c71d686a95c48387544bce6a9fbeba963f66f34f,2020-04-13T20:00:00Z,602,,44309,44309,44309,09,48,0,1743,1346,3089
20200413,DC,1955,8979,,295,,95,,31,,507,ef361e87bc64c70ef055a6e97fa41b9f0da370ed,2020-04-13T20:00:00Z,53,,10934,10934,10934,11,3,0,214,80,294
20200413,DE,1625,10195,,201,,,,,,213,f7f84986055ab03b462b21ea11cc6ea24aacf9c7,2020-04-13T20:00:00Z,35,,11820,11820,11820,10,2,0,571,146,717
20200413,FL,20601,175606,1789,,2833,,,,,,5fe41e1e2a1be283194c989166518cf5d80303ee,2020-04-13T20:00:00Z,483,2833,197996,196207,196207,12,18,61,12208,1246,13454
20200413,GA,13315,43706,,,2589,,,,,,d0deb48e89f93932727868c6d10d2f651f8efc64,2020-04-13T20:00:00Z,464,2589,57021,57021,57021,13,31,84,1705,863,2568
20200413,GU,133,770,,12,,2,,2,,58,a50aa8b671df15e66b31e347fb6794ab66720cbe,2020-04-13T20:00:00Z,5,,903,903,903,66,0,0,77,0,77
20200413,HI,499,18345,,,44,,6,,2,310,54e5a0f2d498944226791b8f435fce69e44256e0,2020-04-13T20:00:00Z,9,44,18844,18844,18844,15,1,0,863,13,876
20200413,IA,1710,16986,,142,,70,,41,,741,8d7ec2ae1e1870221675951d652464cfc0a22796,2020-04-13T20:00:00Z,43,,18696,18696,18696,19,2,0,981,123,1104
20200413,ID,1426,13455,,,132,,38,,,,3734e946519c646c233e93adb5afa4fe1e45abcc,2020-04-13T20:00:00Z,27,132,14881,14881,14881,16,0,1,554,19,573
20200413,IL,22025,83743,,3680,,1166,,821,,,77d9c32803a4b81b867134206c0118eccce7c35f,2020-04-13T20:00:00Z,794,,105768,105768,105768,17,74,0,3860,1173,5033
20200413,IN,8236,36303,,,,740,,459,,,923393ceb4fd69f45c83176518953b957dc59e39,2020-04-13T20:00:00Z,350,,44539,44539,44539,18,7,0,1742,308,2050
20200413,KS,1376,12488,,,309,,,,,,d1e24b154340c63d12d49325cd6925ef2b57c9da,2020-04-13T20:00:00Z,62,309,13864,13864,13864,20,6,11,572,39,611
20200413,KY,1963,23903,,289,667,136,256,,,607,68d8821e644d265098d60ae69248fa3f4ccec80b,2020-04-13T20:00:00Z,97,667,25866,25866,25866,21,3,208,1176,123,1299
20200413,LA,21016,87075,,2134,,,,461,,,41f0e163c98a2af797eedef51a39016330e66076,2020-04-13T20:00:00Z,884,,108091,108091,108091,22,44,0,3625,421,4046
20200413,MA,26794,95500,,3485,3485,,,,,,16f08fcd47641c13aa2f6abcc5bcdb3660404b96,2020-04-13T20:00:00Z,1211,3485,122294,122294,122294,25,155,971,4037,1413,5450
20200413,MD,8936,42815,,,1975,,,,,603,f9a5a804498e6bd539f46271022967a0ecb0ed72,2020-04-13T20:00:00Z,262,1975,51751,51751,51751,24,27,115,1276,711,1987
20200413,ME,698,11608,,22,124,,,,,273,a49d6c928981fe2e87c948002d33bb30477dc086,2020-04-13T20:00:00Z,19,124,12306,12306,12306,23,0,4,5520,65,5585
20200413,MI,25635,57009,,3986,,1570,,1365,,447,66c92c8befd3220371550c8729f82fa8d7a17a3a,2020-04-13T20:00:00Z,1602,,82644,82644,82644,26,115,0,2210,997,3207
20200413,MN,1650,36777,,157,361,74,146,,,842,58b6311ace3e68e769980be6addd27758f367182,2020-04-13T20:00:00Z,70,361,38427,38427,38427,27,0,0,977,29,1006
20200413,MO,4388,41040,,988,,,,,,,48de0f7d502836ea55ad90341d91104f716ea7ed,2020-04-13T20:00:00Z,114,,45428,45428,45428,29,4,0,0,228,228
20200413,MP,11,27,9,,,,,,,,280aea9a94f99710bfa80e49afa6f4b533e0872e,2020-04-13T20:00:00Z,2,,47,38,38,69,0,0,0,0,0
20200413,MS,2942,28042,,,549,124,,84,,,6869fbdb314470af627e647ba339e869756a8298,2020-04-13T20:00:00Z,98,549,30984,30984,30984,28,2,1,9410,161,9571
20200413,MT,394,8704,,21,47,,,,,171,1ee9635f3af084d2b1703ac61739fd9440358304,2020-04-13T20:00:00Z,7,47,9098,9098,9098,30,1,0,178,7,185
20200413,NC,4816,58572,,313,,,,,,,813a9cb064e17ff6e72219744f027f5088392253,2020-04-13T20:00:00Z,86,,63388,63388,63388,37,5,0,953,296,1249
20200413,ND,331,10450,,13,40,,,,,127,74ba42bdde7f9eefc5627f7c42c8f940763bbc2b,2020-04-13T20:00:00Z,8,40,10781,10781,10781,38,0,1,408,23,431
20200413,NE,814,10158,,,,,,,,,dca6111ee5fb521097ef8b27743c224713cc5092,2020-04-13T20:00:00Z,17,,10972,10972,10972,31,0,0,258,23,281
20200413,NH,985,10222,125,,152,,,,,239,4c755414bd724a745f7c748ed32bd161be48e6a5,2020-04-13T20:00:00Z,23,152,11332,11207,11207,33,0,6,226,56,282
20200413,NJ,64584,64885,,7781,,1886,,1611,,,f10013846bdebee508305109342406d19382e1b7,2020-04-13T20:00:00Z,2443,,129469,129469,129469,34,93,0,0,2734,2734
20200413,NM,1245,29270,,80,,,,,,295,2b1efe12b5e1e2732ca1c703e1b1d85dac4ae8c9,2020-04-13T20:00:00Z,26,,30515,30515,30515,35,6,0,1752,71,1823
20200413,NV,2971,22493,,,,,,,,,9dc1eb61a67199b2b083862e2949d04b07670a87,2020-04-13T20:00:00Z,114,,25464,25464,25464,32,2,0,718,135,853
20200413,NY,195031,283326,,18825,42637,5156,,,,23887,019ad7be06dac51063f01cd1181d27bca5e553ce,2020-04-13T20:00:00Z,10056,42637,478357,478357,478357,36,671,43,10419,6337,16756
20200413,OH,6975,58137,,,2033,,613,,,,fed2c54bfbaa53e982b6d3a6d9018362e8227a75,2020-04-13T20:00:00Z,274,2033,65112,65112,65112,39,21,85,1498,371,1869
20200413,OK,2069,20790,,383,457,191,,,,865,4191ae6166d8548c2596587043111b10ac96c6c2,2020-04-13T20:00:00Z,99,457,22859,22859,22859,40,3,11,0,99,99
20200413,OR,1584,29537,,321,369,96,,50,,,b512824791533724a49c30378f83ab6c5f8f440c,2020-04-13T20:00:00Z,53,369,31121,31121,31121,41,1,10,1306,57,1363
20200413,PA,24199,105593,,2243,,,,669,,,d3f878ae067f662c5425d813556e38963ac10e24,2020-04-13T20:00:00Z,524,,129792,129792,129792,42,17,0,3536,1366,4902
20200413,PR,903,5960,1288,,,,,,,,2e02e70aac0ed14a854e5bf23ecc53dc59ee0fce,2020-04-13T20:00:00Z,45,,8151,6863,6863,72,1,0,141,6,147
20200413,RI,2976,17685,,197,331,50,,26,,135,c8feb721e136d0a52f133a66a069ffbb7e80691d,2020-04-13T20:00:00Z,73,331,20661,20661,20661,44,10,331,0,311,311
20200413,SC,3319,28106,,,496,,,,,,e39bcc755d0cc87ba9446729a4a1241d4fee6776,2020-04-13T20:00:00Z,82,496,31425,31425,31425,45,0,0,0,0,0
20200413,SD,868,8134,0,,44,,,,,207,d6fdd504a7297a9ad1ec09a772f7cd53ad90d099,2020-04-13T20:00:00Z,6,44,9002,9002,9002,46,0,1,311,138,449
20200413,TN,5610,70585,,,579,,,,,1671,4798bcbacd867bc269aac274fc75fc9fd32df2cb,2020-04-13T20:00:00Z,109,579,76195,76195,76195,47,8,12,5216,302,5518
20200413,TX,13906,119320,,1176,,,,,,2269,6f951cbd8c25986d844e2e30c3718cb9cfea2fbc,2020-04-13T20:00:00Z,287,,133226,133226,133226,48,16,0,8271,422,8693
20200413,UT,2363,43424,,,201,,,,,218,9da0e13ad75b4e608cac7956fda03bd19ba2d526,2020-04-13T20:00:00Z,18,201,45787,45787,45787,49,0,6,1493,60,1553
20200413,VA,5747,35654,473,1238,,428,,302,,,e6cfda1e1cbf4242dfa8c853d239fdd36d5a6381,2020-04-13T20:00:00Z,149,,41874,41401,41401,51,8,0,943,473,1416
20200413,VI,51,322,2,,,,,,,43,7d5d9e075195e6ae339cf80c000fc025bfebca71,2020-04-13T20:00:00Z,1,,375,373,373,78,0,0,23,0,23
20200413,VT,748,9618,,33,,,,,,15,14051825f769b3fefa36f69aef7735081ba73a3d,2020-04-13T20:00:00Z,28,,10366,10366,10366,50,1,0,504,21,525
20200413,WA,10587,123281,,527,,166,,,,,6eb661fe6f74bc111ce6d0564240982a266653b7,2020-04-13T20:00:00Z,526,,133868,133868,133868,53,17,0,3748,189,3937
20200413,WI,3428,36769,273,442,993,175,264,,,,e47a161cb51e95ae954f5980da5ab396b503ce05,2020-04-13T20:00:00Z,154,993,40470,40197,40197,55,10,19,853,87,940
20200413,WV,626,16029,,95,164,43,73,23,50,85,5b88cfc537cbb6ce7e4cf00b79567df0989146aa,2020-04-13T20:00:00Z,9,164,16655,16655,16655,54,1,164,383,15,398
20200413,WY,275,5689,,,41,,,,,138,925408d55d0948b12058c56e5c0acd2eb3b0f93d,2020-04-13T20:00:00Z,1,41,5964,5964,5964,56,1,1,491,14,505
20200412,AK,272,7766,,,31,,,,,66,5f686eece203e247c3bfb219c664517920d7c141,2020-04-12T20:00:00Z,8,31,8038,8038,8038,02,0,0,291,15,306
20200412,AL,3525,18058,,,437,,189,,119,,a10003b9814203ba98d289480736cff0b00b4009,2020-04-12T20:00:00Z,93,437,21583,21583,21583,01,2,35,0,334,334
20200412,AR,1280,18442,,74,130,,43,30,39,367,6c7bd80088061ed07c0e558496324807bfdba9e0,2020-04-12T20:00:00Z,27,130,19722,19722,19722,05,3,0,1090,54,1144
20200412,AS,0,3,2,,,,,,,,30bdeb66442be44960060acf5492b2203bbe4112,2020-04-12T20:00:00Z,,,5,3,3,60,0,0,0,0,0
20200412,AZ,3539,38570,,,,,,,,,994b2dd7ad7e22da1720b4f9eaf7248665bcd81a,2020-04-12T20:00:00Z,115,,42109,42109,42109,04,7,0,1433,146,1579
20200412,CA,21794,168534,13200,5234,,1539,,,,,5838b65659424b8a88297f99ccedb9b0e03fcd2e,2020-04-12T20:00:00Z,651,,203528,190328,190328,06,42,0,15930,2322,18252
20200412,CO,6893,27980,,822,1376,,,,,,0fa95fe61d44d2f0fa042d032b241cb63b065710,2020-04-12T20:00:00Z,274,1376,34873,34873,34873,08,24,64,1837,383,2220
20200412,CT,12035,29185,,1654,,,,,,,b380ea3514025b20c074c69d84faaec7884c8c82,2020-04-12T20:00:00Z,554,,41220,41220,41220,09,60,0,864,525,1389
20200412,DC,1875,8765,,,,,,,,493,b4e91978eb47e7033efd60c57d4172799b67fd77,2020-04-12T20:00:00Z,50,,10640,10640,10640,11,3,0,504,97,601
20200412,DE,1479,9624,,190,,,,,,191,bf0ecd2e46ae83a0346eac035f0390a92efcb46e,2020-04-12T20:00:00Z,33,,11103,11103,11103,10,0,0,0,0,0
20200412,FL,19355,163398,1297,,2772,,,,,,9d192350c4b0bd28255957587d7d0c5092a28934,2020-04-12T20:00:00Z,465,2772,184050,182753,182753,12,27,111,8959,861,9820
20200412,GA,12452,42001,,,2505,,,,,,f93274bf897baa6e636ffc45d10d3f8eb44e92e1,2020-04-12T20:00:00Z,433,2505,54453,54453,54453,13,5,26,2445,293,2738
20200412,GU,133,693,,13,,2,,2,,58,4ec282f20356475c9133bfb60102022c15aad197,2020-04-12T20:00:00Z,5,,826,826,826,66,0,0,0,0,0
20200412,HI,486,17482,,,44,,6,,2,300,3026c07fbaa81d7abacb2ad47b32a51871d4c485,2020-04-12T20:00:00Z,8,44,17968,17968,17968,15,0,1,416,21,437
20200412,IA,1587,16005,,129,,55,,30,,674,4407491152515f135951ac47a81a3814b6c138dd,2020-04-12T20:00:00Z,41,,17592,17592,17592,19,7,0,383,77,460
20200412,ID,1407,12901,,,131,,38,,,,254b387c2694a6e2b909c2c1d5054533175d4851,2020-04-12T20:00:00Z,27,131,14308,14308,14308,16,2,3,533,11,544
20200412,IL,20852,79883,,3680,,1166,,821,,,5a6cd05b5f034e0c094981d6ca2071b6a682dee2,2020-04-12T20:00:00Z,720,,100735,100735,100735,17,43,0,6914,1672,8586
20200412,IN,7928,34561,,,,820,,497,,,6178539b82f582e8df334647211d512ba72a35f9,2020-04-12T20:00:00Z,343,,42489,42489,42489,18,13,0,2781,493,3274
20200412,KS,1337,11916,,,298,,,,,,c4a60f6d5288d83f3490a787e3237b364c7392ef,2020-04-12T20:00:00Z,56,298,13253,13253,13253,20,1,5,841,69,910
20200412,KY,1840,22727,,271,459,105,177,,,464,6a8b7894876f6171b2c15fa85528a3cddfabb26e,2020-04-12T20:00:00Z,94,459,24567,24567,24567,21,4,0,132,147,279
20200412,LA,20595,83450,,2084,,,,458,,,9aeab99aa0ac14c1c095c7a5aae3603eda67156a,2020-04-12T20:00:00Z,840,,104045,104045,104045,22,34,0,6549,581,7130
20200412,MA,25381,91463,,2514,2514,,,,,,df21d72ccafef7fa484bafec808afa9e242bb6d8,2020-04-12T20:00:00Z,1056,2514,116844,116844,116844,25,110,7,5348,2615,7963
20200412,MD,8225,41539,,,1860,,,,,456,0babcfcedb910d559fde4cb1251327b93972eb14,2020-04-12T20:00:00Z,235,1860,49764,49764,49764,24,29,151,1995,531,2526
20200412,ME,633,6088,,,120,,,,,266,47d53b7fbb72db4bbf66fcb824f6a43854bbbd72,2020-04-12T20:00:00Z,19,120,6721,6721,6721,23,0,6,0,17,17
20200412,MI,24638,54799,,3636,,1582,,1441,,433,541b02d2376d6434e90cd4b0a59ecdfbbe1426bb,2020-04-12T20:00:00Z,1487,,79437,79437,79437,26,95,0,2778,645,3423
20200412,MN,1621,35800,,157,361,74,146,,,842,8ba9bf84ed5e038d18ac77d2852976ce3d191e5b,2020-04-12T20:00:00Z,70,361,37421,37421,37421,27,6,21,1823,194,2017
20200412,MO,4160,41040,,988,,,,,,,e664370ad9aea932c140ade5241b33ec518dfef6,2020-04-12T20:00:00Z,110,,45200,45200,45200,29,1,0,1892,136,2028
20200412,MP,11,27,9,,,,,,,,8735c3e28769f9480af353e26d1dca6841d381e8,2020-04-12T20:00:00Z,2,,47,38,38,69,0,0,0,0,0
20200412,MS,2781,18632,,,548,,,,,,2a98ff7258f13e78385d1b59663ed3c26b5183a0,2020-04-12T20:00:00Z,96,548,21413,21413,21413,28,3,20,0,139,139
20200412,MT,387,8526,,22,47,,,,,169,b26f0da0367eed75b13c3113713e19c2b29cc66e,2020-04-12T20:00:00Z,6,47,8913,8913,8913,30,0,1,322,10,332
20200412,NC,4520,57619,,331,,,,,,,630a0bdaed60fd2d71c5d94a21689a3ee8707bde,2020-04-12T20:00:00Z,81,,62139,62139,62139,37,1,0,1538,208,1746
20200412,ND,308,10042,,12,39,,,,,121,13b6bda9e45c4c68f8a91973100e3d5550a53110,2020-04-12T20:00:00Z,8,39,10350,10350,10350,38,1,3,255,15,270
20200412,NE,791,9900,,,,,,,,,0e4aa19def436c0ea5e28399ed5e83844613e39a,2020-04-12T20:00:00Z,17,,10691,10691,10691,31,0,0,615,91,706
20200412,NH,929,9996,119,,146,,,,,236,570c39e24c2b30f639d27733a214cee15192ff5e,2020-04-12T20:00:00Z,23,146,11044,10925,10925,33,1,12,388,44,432
20200412,NJ,61850,64885,,7604,,1914,,1644,,,ecb690eaa50b5a250895aa6d678f5381632ffd26,2020-04-12T20:00:00Z,2350,,126735,126735,126735,34,167,0,2843,3699,6542
20200412,NM,1174,27518,,78,,,,18,,235,4c46aa8b48ded5f0b8333dc9014314d918b06528,2020-04-12T20:00:00Z,20,,28692,28692,28692,35,1,0,1511,83,1594
20200412,NV,2836,21775,,282,,,,,,,7a4c2725a28bced1bb827cd35f1a5e59044c09a7,2020-04-12T20:00:00Z,112,,24611,24611,24611,32,10,0,888,136,1024
20200412,NY,188694,272907,,18707,42594,5198,,,,23887,c34e542369716ac96cf4d5c56a0b44894e6a356f,2020-04-12T20:00:00Z,9385,42594,461601,461601,461601,36,758,1915,12385,8236,20621
20200412,OH,6604,56639,,,1948,,595,,,,0bc5957f5991dc69c64f03e3c7e2e18be0a1601d,2020-04-12T20:00:00Z,253,1948,63243,63243,63243,39,6,89,2418,417,2835
20200412,OK,1970,20790,,383,446,191,,,,865,acebfb6a2f63dbae55b283b6eb9f79172ec9ec7c,2020-04-12T20:00:00Z,96,446,22760,22760,22760,40,2,0,0,102,102
20200412,OR,1527,28231,,295,359,81,,52,,,343ee0136caa7bac5fbaee7bd25ebc6d63b83179,2020-04-12T20:00:00Z,52,359,29758,29758,29758,41,4,21,2378,156,2534
20200412,PA,22833,102057,,2097,,,,649,,,07324fe7599e52f854acb0b27a19898fd30f90df,2020-04-12T20:00:00Z,507,,124890,124890,124890,42,13,0,3559,1178,4737
20200412,PR,897,5819,1251,,,,,,,,7ca4fd5cd8955f51e2f92c346c060be1f0a2967c,2020-04-12T20:00:00Z,44,,7967,6716,6716,72,2,0,236,109,345
20200412,RI,2665,17685,,201,,50,,26,,35,d847efc166112ef05e650276fcb510a617db4ddb,2020-04-12T20:00:00Z,63,,20350,20350,20350,44,7,0,1827,316,2143
20200412,SC,3319,28106,,,496,,,,,,044250266baeb0dc046c839a6fea392ad5d6fd48,2020-04-12T20:00:00Z,82,496,31425,31425,31425,45,2,0,1220,112,1332
20200412,SD,730,7823,0,,43,,,,,197,62f16b2fc12b94655a06c6ad9a65d192f8932a5b,2020-04-12T20:00:00Z,6,43,8553,8553,8553,46,0,10,445,104,549
20200412,TN,5308,65369,,,567,,,,,1504,4d9171393648095a093ae412c55c5ab9fac65158,2020-04-12T20:00:00Z,101,567,70677,70677,70677,47,0,11,3655,194,3849
20200412,TX,13484,111049,,1338,,,,,,2014,3ae759108fcc149585565c0d6c9c9aa338cf0c50,2020-04-12T20:00:00Z,271,,124533,124533,124533,48,17,0,3077,923,4000
20200412,UT,2303,41931,,,195,,,,,,2ed0a5b83fb1172a55311e320b688ef899102994,2020-04-12T20:00:00Z,18,195,44234,44234,44234,49,0,5,1591,97,1688
20200412,VA,5274,34711,521,751,,734,,294,,,95dbe378dabc930e6bef597168fd0fea0642bed1,2020-04-12T20:00:00Z,141,,40506,39985,39985,51,11,0,1789,197,1986
20200412,VI,51,299,20,3,,,,,,43,75a5e96c1cb0af90daf332a0e1ad218b519c6ccb,2020-04-12T20:00:00Z,1,,370,350,350,78,0,0,0,0,0
20200412,VT,727,9114,,34,,,,,,15,317bf42eca48bc513b07ec021dbb66bbe8228721,2020-04-12T20:00:00Z,27,,9841,9841,9841,50,2,0,567,16,583
20200412,WA,10398,119533,,642,,191,,,,,fc1ca69028b5c2ccee29105887f7f16266458b3f,2020-04-12T20:00:00Z,509,,129931,129931,129931,53,15,0,1297,236,1533
20200412,WI,3341,35916,,442,974,179,261,,,,b6c52db7f98867be6533207bd5925f1d2606039d,2020-04-12T20:00:00Z,144,974,39257,39257,39257,55,7,24,1236,128,1364
20200412,WV,611,15646,,81,,36,,24,,83,e1c4f53acb2ff1cdc76c7f0b1b69d8d4853c6b69,2020-04-12T20:00:00Z,8,,16257,16257,16257,54,3,0,771,34,805
20200412,WY,261,5198,,,40,,,,,137,2a6cd1a98f43d43820dfb2d7cb95355af66c516b,2020-04-12T20:00:00Z,0,40,5459,5459,5459,56,0,3,0,0,0
20200411,AK,257,7475,,,31,,,,,63,a8d36e9ce19edaeaac989881abf96fc74196efba,2020-04-11T20:00:00Z,8,31,7732,7732,7732,02,1,3,289,11,300
20200411,AL,3191,18058,,,402,,,,,,1fc42a3d2389569b3fd60bf6c3ba8d7c35c5a378,2020-04-11T20:00:00Z,91,402,21249,21249,21249,01,11,34,0,223,223
20200411,AR,1226,17352,,86,130,,43,33,39,340,c89b6d79b846a7e0c95039ef4e098653cea76566,2020-04-11T20:00:00Z,24,130,18578,18578,18578,05,1,0,1403,55,1458
20200411,AS,0,3,2,,,,,,,,e3996e19f3dfdc280692ed786367458686df63ed,2020-04-11T20:00:00Z,,,5,3,3,60,0,0,0,0,0
20200411,AZ,3393,37137,,,,,,,,,ee23e7459fb43965ff718c5ef4d8a2a807359399,2020-04-11T20:00:00Z,108,,40530,40530,40530,04,11,0,2515,281,2796
20200411,CA,19472,152604,13200,5236,,1591,,,,,d1eef75994ad1a7d659936e05ced31e584362f04,2020-04-11T20:00:00Z,609,,185276,172076,172076,06,68,0,7213,0,7213
20200411,CO,6510,26143,,841,1312,,,,,,cd0a888338567f3e8184b9d4eab6812f09d776be,2020-04-11T20:00:00Z,250,1312,32653,32653,32653,08,0,0,0,0,0
20200411,CT,11510,28321,,1593,,,,,,,e8de5e9127276977194f6ce3aa078c1d4bfac16b,2020-04-11T20:00:00Z,494,,39831,39831,39831,09,46,0,2571,972,3543
20200411,DC,1778,8261,,,,,,,,447,7adff028478102fb7be713729b35aeef9dacf359,2020-04-11T20:00:00Z,47,,10039,10039,10039,11,9,0,566,118,684
20200411,DE,1479,9624,,190,,,,,,191,fb09c90df852cd85214cc24b799df37f71e52f87,2020-04-11T20:00:00Z,33,,11103,11103,11103,10,10,0,-791,153,-638
20200411,FL,18494,154439,1418,,2661,,,,,,556eff0dd57a9b72146fc86e7822a3b142ea4371,2020-04-11T20:00:00Z,438,2661,174351,172933,172933,12,48,174,9140,963,10103
20200411,GA,12159,39556,,,2479,,,,,,06b53fa7eb6c28f644aa6beac82e353c65a7cd9c,2020-04-11T20:00:00Z,428,2479,51715,51715,51715,13,12,128,4892,676,5568
20200411,GU,133,693,,14,,2,,2,,58,5f26927fab3a35e0b2477043b2004ec19028dea1,2020-04-11T20:00:00Z,5,,826,826,826,66,1,0,31,3,34
20200411,HI,465,17066,,,43,,6,,2,284,6a84740bf5d92867954153fb11dd79b51db0d3cd,2020-04-11T20:00:00Z,8,43,17531,17531,17531,15,2,1,1359,23,1382
20200411,IA,1510,15622,,118,,55,,30,,585,6e736638a93bc8f376fbcb65eda72923cfd30259,2020-04-11T20:00:00Z,34,,17132,17132,17132,19,3,0,1057,122,1179
20200411,ID,1396,12368,,,128,,35,,,,2a4968fc9c46df1aa8970de03b88a4ff10098182,2020-04-11T20:00:00Z,25,128,13764,13764,13764,16,1,1,627,43,670
20200411,IL,19180,72969,,3680,,1166,,821,,,d2f4bc346d1388c9600d41903a16bab576cb0fb7,2020-04-11T20:00:00Z,677,,92149,92149,92149,17,81,0,3329,1293,4622
20200411,IN,7435,31780,,,,820,,497,,,7660759d9c736b25312a708f6706d27a10c69c3b,2020-04-11T20:00:00Z,330,,39215,39215,39215,18,30,0,3647,528,4175
20200411,KS,1268,11075,,,293,,,,,,e95fd55dfdd68260274d86129c167f566658f1d8,2020-04-11T20:00:00Z,55,293,12343,12343,12343,20,5,19,827,102,929
20200411,KY,1693,22595,,271,459,105,177,,,464,49f90f03874fb86940f115d5680768de7a5ec5dc,2020-04-11T20:00:00Z,90,459,24288,24288,24288,21,0,0,0,0,0
20200411,LA,20014,76901,,2067,,,,470,,,644d819f726bea7ac3131764e77319d0958664a5,2020-04-11T20:00:00Z,806,,96915,96915,96915,22,51,0,3874,761,4635
20200411,MA,22766,86115,,2507,2507,,,,,,f009a6551fd289668763ef37af8fc6ba40eb38e6,2020-04-11T20:00:00Z,946,2507,108881,108881,108881,25,114,72,4551,1888,6439
20200411,MD,7694,39544,,,1709,,,,,431,f895c4448a93a8b4556faabc3b387ee307377004,2020-04-11T20:00:00Z,206,1709,47238,47238,47238,24,35,296,2064,726,2790
20200411,ME,616,6088,,,114,,,,,256,394a794fce881dd00fc98ecefbe1f4eb3e829ae3,2020-04-11T20:00:00Z,19,114,6704,6704,6704,23,2,3,0,30,30
20200411,MI,23993,52021,,3636,,1582,,1441,,595,3d03b637d24856390bec64766587db8137e39c61,2020-04-11T20:00:00Z,1392,,76014,76014,76014,26,111,0,2760,1210,3970
20200411,MN,1427,33977,,145,340,69,138,,,793,cd31725bf7239aabd805a7b5ba66f24d247a6a4a,2020-04-11T20:00:00Z,64,340,35404,35404,35404,27,7,23,1419,91,1510
20200411,MO,4024,39148,,506,,,,,,,ad1a0aa2494f6e2a7f6677d7051ef8ec83d71034,2020-04-11T20:00:00Z,109,,43172,43172,43172,29,13,0,2207,225,2432
20200411,MP,11,27,9,,,,,,,,a6b93f8944bc4e65251189c2dce27586265374da,2020-04-11T20:00:00Z,2,,47,38,38,69,0,0,0,0,0
20200411,MS,2642,18632,,,528,,,,,,13130297b1d7ae26a372b7badcf50d038370b77e,2020-04-11T20:00:00Z,93,528,21274,21274,21274,28,11,46,0,173,173
20200411,MT,377,8204,,21,46,,,,,169,d7001c3f70e70180eeddca7303c5d1f5b43d79bf,2020-04-11T20:00:00Z,6,46,8581,8581,8581,30,0,5,272,12,284
20200411,NC,4312,56081,,362,,,,,,,7da4a0c4d29d52802578786c23cf1cc40c0b7a5b,2020-04-11T20:00:00Z,80,,60393,60393,60393,37,6,0,2344,404,2748
20200411,ND,293,9787,,10,36,,,,,119,3f0ea0abba907cbabd93287478b8828e27daa409,2020-04-11T20:00:00Z,7,36,10080,10080,10080,38,1,0,457,15,472
20200411,NE,700,9285,,,,,,,,,89e40d06d159df3bc9c1778c7af0ce11d51294ec,2020-04-11T20:00:00Z,17,,9985,9985,9985,31,2,0,566,65,631
20200411,NH,885,9608,93,,134,,,,,234,f81faf4a7cd08487f4dee5871b604340144c37b7,2020-04-11T20:00:00Z,22,134,10586,10493,10493,33,1,10,469,66,535
20200411,NJ,58151,62042,,7618,,1746,,1650,,,10b137d9c127d722126d306ada0677121f0c8e5a,2020-04-11T20:00:00Z,2183,,120193,120193,120193,34,251,0,3107,3563,6670
20200411,NM,1091,26007,,75,,,,18,,235,ecbde1158d88583b1442f9da74ccd91095e61d2e,2020-04-11T20:00:00Z,19,,27098,27098,27098,35,0,0,0,0,0
20200411,NV,2700,20887,,282,,,,,,,b2c1d98549beb7f6a25f914ba45f9e5344ad192b,2020-04-11T20:00:00Z,102,,23587,23587,23587,32,16,0,722,116,838
20200411,NY,180458,260522,,18654,40679,5009,,,,22025,361c16745f9be4bc650b0fa0ebaabc36edad3d47,2020-04-11T20:00:00Z,8627,40679,440980,440980,440980,36,783,1861,13149,9946,23095
20200411,OH,6187,54221,,,1859,,572,,,,653b0637956dae24b08d87da57bfaca2dfbff9a3,2020-04-11T20:00:00Z,247,1859,60408,60408,60408,39,16,104,1526,351,1877
20200411,OK,1868,20790,,383,446,191,,,,865,f6e31080079bb3b55beac5b3cd00638a769d3c9d,2020-04-11T20:00:00Z,94,446,22658,22658,22658,40,6,18,420,74,494
20200411,OR,1371,25853,,140,338,58,,46,,,cc27c7f6db1c726f33a81e8a595fe2c3d34e08d0,2020-04-11T20:00:00Z,48,338,27224,27224,27224,41,4,12,1547,50,1597
20200411,PA,21655,98498,,2115,,,,639,,,707c8ca592c2cb6865085b84acfa61765e56ae2c,2020-04-11T20:00:00Z,494,,120153,120153,120153,42,78,0,5458,1676,7134
20200411,PR,788,5583,1332,,,,,,,,49a43ec077cb42785a932e1bb08e765e31dc86a4,2020-04-11T20:00:00Z,42,,7703,6371,6371,72,3,0,462,63,525
20200411,RI,2349,15858,,183,,50,,26,,35,3b26580e535b35400119bfdaf286449fbeaf2c90,2020-04-11T20:00:00Z,56,,18207,18207,18207,44,7,0,3577,334,3911
20200411,SC,3207,26886,,,496,,,,,,c00baa6c5ebcac7c6ac51403bb3ea2705db0f834,2020-04-11T20:00:00Z,80,496,30093,30093,30093,45,8,0,1768,142,1910
20200411,SD,626,7378,2,,33,,,,,189,45590554a2f8dc468a998428879eea2c8744acbf,2020-04-11T20:00:00Z,6,33,8006,8004,8004,46,0,4,267,90,357
20200411,TN,5114,61714,,,556,,,,,1386,fd78d9f797ce808abb10194c7e10937b8ec2d11d,2020-04-11T20:00:00Z,101,556,66828,66828,66828,47,3,20,3777,252,4029
20200411,TX,12561,107972,,1514,,,,,,1617,535058cfb921109397033e463e8f8ea64bf1c3e2,2020-04-11T20:00:00Z,254,,120533,120533,120533,48,28,0,3925,890,4815
20200411,UT,2206,40340,,,190,,,,,,aed7ede8563fb5e0601845af9649cc018e08d406,2020-04-11T20:00:00Z,18,190,42546,42546,42546,49,1,7,1680,104,1784
20200411,VA,5077,32922,517,1252,,709,,283,,,48ece2c7bbb4be59fff46938cd10e3d81c72664a,2020-04-11T20:00:00Z,130,,38516,37999,37999,51,9,0,1972,568,2540
20200411,VI,51,299,20,3,,,,,,43,846737287140472645be46cb0d3cf5fbab03815b,2020-04-11T20:00:00Z,1,,370,350,350,78,0,0,26,1,27
20200411,VT,711,8547,,77,,,,,,15,44686c86db46ac9e0ed3fd3c5ec0b243858060d8,2020-04-11T20:00:00Z,25,,9258,9258,9258,50,1,0,994,32,1026
20200411,WA,10162,118236,,649,,191,,,,,9d80c8f91002a36236988c784171b025e4d9e5bc,2020-04-11T20:00:00Z,494,,128398,128398,128398,53,18,0,1840,221,2061
20200411,WI,3213,34680,,444,950,179,257,,,,2d6d4254f4b1570432ae547a2251bd22f16e1f2c,2020-04-11T20:00:00Z,137,950,37893,37893,37893,55,9,46,1455,145,1600
20200411,WV,577,14875,,85,,40,,22,,63,b5a667f02d5fa2f0312950c94e2cff983a5ab75d,2020-04-11T20:00:00Z,5,,15452,15452,15452,54,0,0,874,23,897
20200411,WY,261,5198,,,37,,,,,129,ec8a322ffba1a10858e7b2e45c9d6febda25d776,2020-04-11T20:00:00Z,0,37,5459,5459,5459,56,0,0,462,8,470
20200410,AK,246,7186,,,28,,,,,55,f72f6232f47812a602059afa4d5f4d698726aa3b,2020-04-10T20:00:00Z,7,28,7432,7432,7432,02,0,1,198,11,209
20200410,AL,2968,18058,,,368,,,,,,deabcc53c679be6f942df9ba423a0d262ce45c5c,2020-04-10T20:00:00Z,80,368,21026,21026,21026,01,6,35,0,199,199
20200410,AR,1171,15949,,86,130,,43,33,39,312,eed9ef5b44313459b1b49ca25a50a47df14fbc20,2020-04-10T20:00:00Z,23,130,17120,17120,17120,05,2,0,2117,52,2169
20200410,AS,0,3,2,,,,,,,,f380a4ca829f914ba3535ed117102abc8fe7d43c,2020-04-10T20:00:00Z,0,,5,3,3,60,0,0,0,0,0
20200410,AZ,3112,34622,,,,,,,,,f3ba26485902411adb8738870f9588c6ca100e6b,2020-04-10T20:00:00Z,97,,37734,37734,37734,04,8,0,462,94,556
20200410,CA,19472,145391,13900,2897,,1145,,,,,7b7f43add244dd0beac30179ffa9cc26c01ac4cd,2020-04-10T20:00:00Z,541,,178763,164863,164863,06,49,0,200,1163,1363
20200410,CO,6510,26143,,842,1312,,,,,,1f6196416d9b1623ae28c2a62688d8a097987cdd,2020-04-10T20:00:00Z,250,1312,32653,32653,32653,08,57,150,2599,855,3454
20200410,CT,10538,25750,,1562,,,,,,,d837fdb36f289a47f704866efa7a975c6fd57275,2020-04-10T20:00:00Z,448,,36288,36288,36288,09,68,0,2032,754,2786
20200410,DC,1660,7695,,,,,,,,426,7c6bf62e6c19aaa7b50946ee18cb701683abd073,2020-04-10T20:00:00Z,38,,9355,9355,9355,11,6,0,494,137,631
20200410,DE,1326,10415,,181,,,,,,177,f85cebdacc98a38f07d28833e92b016fa4dc8afd,2020-04-10T20:00:00Z,23,,11741,11741,11741,10,0,0,1732,119,1851
20200410,FL,17531,145299,1411,,2487,,,,,,0437d8adf77ea12d3a32f324bb51546af79a8b71,2020-04-10T20:00:00Z,390,2487,164241,162830,162830,12,36,219,9114,1167,10281
20200410,GA,11483,34664,,,2351,,,,,,a86c13bf50abbedc6518f8959043eee9283da498,2020-04-10T20:00:00Z,416,2351,46147,46147,46147,13,37,192,4145,917,5062
20200410,GU,130,662,,14,,2,,2,,41,c1c7a10a9b4263aa04238ac704dc651de9a5dfdd,2020-04-10T20:00:00Z,4,,792,792,792,66,0,0,69,2,71
20200410,HI,442,15707,,,42,,6,,2,251,11d1477448eb2f3b1d0cd776a1cf18b0ed78e85f,2020-04-10T20:00:00Z,6,42,16149,16149,16149,15,1,0,391,7,398
20200410,IA,1388,14565,,125,,55,,30,,506,cf06ef7ea2ce1c10bdedb84bdcc11451814ee3e1,2020-04-10T20:00:00Z,31,,15953,15953,15953,19,2,0,862,118,980
20200410,ID,1353,11741,,,127,,33,,,,09f5794bcc50d38e9cd2132a6c3eddd78da2a208,2020-04-10T20:00:00Z,24,127,13094,13094,13094,16,6,14,442,121,563
20200410,IL,17887,69640,,3680,,1166,,821,,,a611c14568ede32f626296251d9f95268c6a975f,2020-04-10T20:00:00Z,596,,87527,87527,87527,17,68,0,5205,1465,6670
20200410,IN,6907,28133,,,,820,,497,,,bc9eede1aa2efa612414d45c0f39ffa6e2d174dd,2020-04-10T20:00:00Z,300,,35040,35040,35040,18,55,0,2351,556,2907
20200410,KS,1166,10248,,,274,,,,,,d86d82fbef79b76de7b6bb09a5b536cf6f40b3d0,2020-04-10T20:00:00Z,50,274,11414,11414,11414,20,8,11,579,60,639
20200410,KY,1693,22595,,271,459,105,177,,,464,d38ee043d21f9d9bec3e400d81df4c1ac102c33b,2020-04-10T20:00:00Z,90,459,24288,24288,24288,21,17,459,2140,347,2487
20200410,LA,19253,73027,,2054,,,,479,,,16c20b191b25b668f0647db33d5c34aa2808544a,2020-04-10T20:00:00Z,755,,92280,92280,92280,22,53,0,4391,970,5361
20200410,MA,20878,81564,,2435,2435,,,,,,e76faf99900c6141c9bf87b0dcda0adb9b8fb341,2020-04-10T20:00:00Z,832,2435,102442,102442,102442,25,107,133,5418,2035,7453
20200410,MD,6968,37480,,,1413,,,,,397,3a611c353715227700aaf71149af9a15a62ac7c2,2020-04-10T20:00:00Z,171,1413,44448,44448,44448,24,33,65,2136,783,2919
20200410,ME,586,6088,,,111,,,,,246,edcc463ba06ffef28da371e9fd40e073ac48d5a9,2020-04-10T20:00:00Z,17,111,6674,6674,6674,23,1,6,0,26,26
20200410,MI,22783,49261,,3823,,1663,,1394,,56,98994da86c7132b2f2f83b0cc20710255565f6d1,2020-04-10T20:00:00Z,1281,,72044,72044,72044,26,205,0,3711,1279,4990
20200410,MN,1336,32558,,143,317,64,131,,,732,b0ce47b8d2c469ae70f548dda74437ae58ac5c93,2020-04-10T20:00:00Z,57,317,33894,33894,33894,27,7,24,1506,94,1600
20200410,MO,3799,36941,,568,,,,,,,a7977b08cbff8551ece14b94762e1df5c225dbac,2020-04-10T20:00:00Z,96,,40740,40740,40740,29,19,0,1986,260,2246
20200410,MP,11,27,9,,,,,,,,a01de0528870e6505c5107d4906b0e1cf768b55a,2020-04-10T20:00:00Z,2,,47,38,38,69,0,0,0,0,0
20200410,MS,2469,18632,,,482,,,,,,267b52d12346a2d87ec4ce44f602440d51099037,2020-04-10T20:00:00Z,82,482,21101,21101,21101,28,6,41,0,209,209
20200410,MT,365,7932,,29,41,,,,,165,17d4382671100d496c21cd8670c9afc03144c70d,2020-04-10T20:00:00Z,6,41,8297,8297,8297,30,0,5,426,11,437
20200410,NC,3908,53737,,423,,,,,,,eaf63c7099f9715b6d487305c238aac2b9a20e3d,2020-04-10T20:00:00Z,74,,57645,57645,57645,37,9,0,9579,257,9836
20200410,ND,278,9330,,13,36,,,,,105,9994e28867ec9ac2df5ad6da0d17c0da3c58e955,2020-04-10T20:00:00Z,6,36,9608,9608,9608,38,1,2,609,9,618
20200410,NE,635,8719,,,,,,,,,142d1f81156a102997f1db5e3ca7c20ddceaa655,2020-04-10T20:00:00Z,15,,9354,9354,9354,31,1,0,603,68,671
20200410,NH,819,9139,155,,124,,,,,234,989460ace7ce2a2284f1442d60b994abfcb6176d,2020-04-10T20:00:00Z,21,124,10113,9958,9958,33,3,6,376,31,407
20200410,NJ,54588,58935,,7570,,1679,,1663,,682,a416d702cd805b6a6da57f4770c93b3df78c267b,2020-04-10T20:00:00Z,1932,,113523,113523,113523,34,232,0,2770,3561,6331
20200410,NM,1091,26007,,73,,,,18,,217,b17728fffb713e971580bc824240a489bfffa008,2020-04-10T20:00:00Z,19,,27098,27098,27098,35,3,0,3065,226,3291
20200410,NV,2584,20165,,282,,,,,,,6e8507d77f69509a31c92ce4ea3327b88c4e9706,2020-04-10T20:00:00Z,86,,22749,22749,22749,32,6,0,850,128,978
20200410,NY,170512,247373,,18569,38818,4908,,,,20249,b9f6747819f23a6d4d2caddb7dab2b4568f829f4,2020-04-10T20:00:00Z,7844,38818,417885,417885,417885,36,777,2242,15761,10575,26336
20200410,OH,5836,52695,,,1755,,548,,,,38d222fadd867ea8c8b8342f3d8858953fbba4bd,2020-04-10T20:00:00Z,231,1755,58531,58531,58531,39,18,143,2222,324,2546
20200410,OK,1794,20370,,186,428,122,,,,790,d3fba58c0192f4eb15ae8ee5cadb0776f6186eba,2020-04-10T20:00:00Z,88,428,22164,22164,22164,40,8,13,1775,110,1885
20200410,OR,1321,24306,,146,326,66,,54,,,9633f2a24e6dc4e0e6cff39ca519a0e65b239880,2020-04-10T20:00:00Z,44,326,25627,25627,25627,41,0,0,0,0,0
20200410,PA,19979,93040,,2072,,,,611,,,fe2ff10aeb9a7872a49c0e8b849e73c32c36f285,2020-04-10T20:00:00Z,416,,113019,113019,113019,42,78,0,5666,1751,7417
20200410,PR,725,5121,1392,,,,,,,,aca519d0dea20a8d0eaee68b47274458c9e8e179,2020-04-10T20:00:00Z,39,,7238,5846,5846,72,6,0,418,42,460
20200410,RI,2015,12281,,169,,45,,26,,35,8b13c275050c994b155faf9675b601fb8ca82113,2020-04-10T20:00:00Z,49,,14296,14296,14296,44,6,0,1599,288,1887
20200410,SC,3065,25118,,,496,,,,,,92199aa30fd4dd5ad130bdf4df1fc753f5dc6f57,2020-04-10T20:00:00Z,72,496,28183,28183,28183,45,5,255,543,273,816
20200410,SD,536,7111,,,29,,,,,177,b87f4b357ef2f9c892ea11a46c8820b5430b192c,2020-04-10T20:00:00Z,6,29,7647,7647,7647,46,0,2,411,89,500
20200410,TN,4862,57937,,,536,,,,,1145,e4ac457d8b0b17da3e94311a37cdebdae2178807,2020-04-10T20:00:00Z,98,536,62799,62799,62799,47,4,31,2722,228,2950
20200410,TX,11671,104047,,1532,,,,,,1366,586fa304b254a11f480c37372834cb32ceaf4aea,2020-04-10T20:00:00Z,226,,115718,115718,115718,48,27,0,8143,1441,9584
20200410,UT,2102,38660,,,183,,,,,,9922f7bcadc14b7394b2c54e39cc1916b6e9044c,2020-04-10T20:00:00Z,17,183,40762,40762,40762,49,4,15,2263,126,2389
20200410,VA,4509,30950,521,1238,772,457,,287,,,4e73ce5191e84abcc39961e9a5b2f31bbdeb628b,2020-04-10T20:00:00Z,121,772,35980,35459,35459,51,12,87,1966,467,2433
20200410,VI,50,273,45,3,,,,,,43,88e39033fbbd388c97c41f4ac80d942c1749824a,2020-04-10T20:00:00Z,1,,368,323,323,78,0,0,22,4,26
20200410,VT,679,7553,,32,,,,,,15,dc96a20cf819e19bcf41ad74d575ae858dacf10c,2020-04-10T20:00:00Z,24,,8232,8232,8232,50,1,0,0,51,51
20200410,WA,9941,116396,,642,,191,,,,,e02b896cbd6bf109cab73b7faa3c0640b5254d5c,2020-04-10T20:00:00Z,476,,126337,126337,126337,53,17,0,3852,449,4301
20200410,WI,3068,33225,,,904,190,247,,,,1eeea810191607f248c1426c6d8b32934ec5365b,2020-04-10T20:00:00Z,128,904,36293,36293,36293,55,17,61,1801,183,1984
20200410,WV,554,14001,,85,,20,,22,,63,230ef679b8324b5fdf188b5acd7c07d4abf5e044,2020-04-10T20:00:00Z,5,,14555,14555,14555,54,0,0,661,31,692
20200410,WY,253,4736,,,37,,,,,105,542f22512141736619d47feb0b66d9539e12bb4e,2020-04-10T20:00:00Z,0,37,4989,4989,4989,56,0,3,816,23,839
20200409,AK,235,6988,,,27,,,,,49,b25c4a1e5bb964d05142022307f57e41e0872f26,2020-04-09T20:00:00Z,7,27,7223,7223,7223,02,0,0,146,9,155
20200409,AL,2769,18058,,,333,,,,,,34ec8a688f0984d69a58ddef29d640ace6ee65bf,2020-04-09T20:00:00Z,74,333,20827,20827,20827,01,8,19,1305,400,1705
20200409,AR,1119,13832,,73,130,,43,31,39,288,d21f4f58502c23fd66e3842b4b6eb7c9c18ccdf0,2020-04-09T20:00:00Z,21,130,14951,14951,14951,05,3,0,302,119,421
20200409,AS,0,3,2,,,,,,,,4550449cb174c1fcabdb4d4e92ebe0a79b4bd30f,2020-04-09T20:00:00Z,0,,5,3,3,60,0,0,0,0,0
20200409,AZ,3018,34160,,,,,,,,,a706debeb0a3336ce380a04afeca43b1f77d44c9,2020-04-09T20:00:00Z,89,,37178,37178,37178,04,9,0,2322,292,2614
20200409,CA,18309,145191,14100,2825,,1132,,,,,415e9a2ee1c4debcc75db294bc356b28a291a185,2020-04-09T20:00:00Z,492,,177600,163500,163500,06,50,0,17884,1352,19236
20200409,CO,5655,23544,,848,1162,,,,,,7da5b0594d9ac4a43b4ebef17fba2e299929b704,2020-04-09T20:00:00Z,193,1162,29199,29199,29199,08,14,83,879,226,1105
20200409,CT,9784,23718,,1464,,,,,,,4f9311d78efaba1380411da694bf2264bf3f4c69,2020-04-09T20:00:00Z,380,,33502,33502,33502,09,103,0,2463,2003,4466
20200409,DC,1523,7201,,,,,,,,393,5f3e6ed3208c06cc3446e80b46ca4bc5fee989b1,2020-04-09T20:00:00Z,32,,8724,8724,8724,11,5,0,358,83,441
20200409,DE,1207,8683,,201,,,,,,173,45f2d85472665b02bd94b4ef5f6a05fca3661bd0,2020-04-09T20:00:00Z,23,,9890,9890,9890,10,7,0,1055,279,1334
20200409,FL,16364,136185,1395,,2268,,,,,,754e4c4bc873607e36e18febcf6f6f3fe17eef34,2020-04-09T20:00:00Z,354,2268,153944,152549,152549,12,45,206,8506,909,9415
20200409,GA,10566,30519,,,2159,,,,,,e55d4dcfec26e2fede63494733c002a68b541521,2020-04-09T20:00:00Z,379,2159,41085,41085,41085,13,17,166,1633,665,2298
20200409,GU,128,593,,14,,2,,2,,33,8d0d6f8cf4948a29fbe75c2c6068e2e4bc336303,2020-04-09T20:00:00Z,4,,721,721,721,66,0,0,31,3,34
20200409,HI,435,15316,,,42,,6,,,113,b8cac0a3e57db8fcb5f8784a24ff0292859ce8b1,2020-04-09T20:00:00Z,5,42,15751,15751,15751,15,0,0,577,25,602
20200409,IA,1270,13703,,122,,,,,,476,1f9d61aaf5b280767ba36847ddc362d1b27327f9,2020-04-09T20:00:00Z,29,,14973,14973,14973,19,2,0,882,125,1007
20200409,ID,1232,11299,,,113,,29,,,,2cbe02b18b0ca2023e2896936099c1de3f2793ca,2020-04-09T20:00:00Z,18,113,12531,12531,12531,16,3,20,611,22,633
20200409,IL,16422,64435,,3680,,1166,,821,,,4a5176c1a33a75ad4f04db3b40abc94f7f24bfe5,2020-04-09T20:00:00Z,528,,80857,80857,80857,17,66,0,4447,1344,5791
20200409,IN,6351,25782,,,,924,,507,,,1406da427afc443d36e088a6059820b56836038e,2020-04-09T20:00:00Z,245,,32133,32133,32133,18,42,0,856,408,1264
20200409,KS,1106,9669,,,263,,,,,,dc24b13ac61718730956dec0e03f27c8b1f93822,2020-04-09T20:00:00Z,42,263,10775,10775,10775,20,4,40,532,60,592
20200409,KY,1346,20455,,,,,,,,,4fb35d2fca57462d9af6173dfc7908eca90f57f4,2020-04-09T20:00:00Z,73,,21801,21801,21801,21,8,0,0,197,197
20200409,LA,18283,68636,,2014,,,,473,,,f2b7e11d6a23a663135d5c22b782e3fe824a9623,2020-04-09T20:00:00Z,702,,86919,86919,86919,22,50,0,4260,1253,5513
20200409,MA,18843,76146,,2302,2302,,,,,,e8b2968723a8af7209cce529574d5032146bfaa2,2020-04-09T20:00:00Z,725,2302,94989,94989,94989,25,110,183,5297,2151,7448
20200409,MD,6185,35344,,,1348,,,,,376,dd11e0579e86c2a04984fc8a6c92a033633133a0,2020-04-09T20:00:00Z,138,1348,41529,41529,41529,24,14,138,2411,656,3067
20200409,ME,560,6088,,,105,,,,,202,de9357008b267094a60a0ac8ff7fd3c2dc3466c0,2020-04-09T20:00:00Z,16,105,6648,6648,6648,23,2,4,0,23,23
20200409,MI,21504,45550,,3826,,1628,,1434,,56,17e988d651529c4378e3d66af16ab70a20092e7f,2020-04-09T20:00:00Z,1076,,67054,67054,67054,26,117,0,0,915,915
20200409,MN,1242,31052,,145,293,63,119,,,675,cdf145be23b01c96273d3c5925c78004122d3677,2020-04-09T20:00:00Z,50,293,32294,32294,32294,27,11,22,1453,88,1541
20200409,MO,3539,34955,,568,,,,,,,b97f337b09235d8410b8c2a2f9d134d4d38e89f3,2020-04-09T20:00:00Z,77,,38494,38494,38494,29,19,0,4172,212,4384
20200409,MP,11,27,9,,,,,,,,2923ea3c9e9309ed8d343db9349620a8388522e7,2020-04-09T20:00:00Z,2,,47,38,38,69,0,0,0,0,0
20200409,MS,2260,18632,,,441,,,,,,a1e53262497df092c0e0c4ca9af9fd8f23aafe66,2020-04-09T20:00:00Z,76,441,20892,20892,20892,28,9,31,0,257,257
20200409,MT,354,7506,,13,36,,,,,157,c26e42cdca9c9d43ffd76a58290bd6a75c28198d,2020-04-09T20:00:00Z,6,36,7860,7860,7860,30,0,5,440,22,462
20200409,NC,3651,44158,,398,,,,,,,a6a57caf54cc0f7c9a4d14df31be2434fe42b80d,2020-04-09T20:00:00Z,65,,47809,47809,47809,37,12,0,4597,225,4822
20200409,ND,269,8721,,14,34,,,,,101,6ac57451eb83c5297a3f2fe18e496d59f112de5a,2020-04-09T20:00:00Z,5,34,8990,8990,8990,38,1,0,420,18,438
20200409,NE,567,8116,,,,,,,,,fce6cfce0f23547227601671cf284cae2df67536,2020-04-09T20:00:00Z,14,,8683,8683,8683,31,2,0,674,48,722
20200409,NH,788,8763,143,,118,,,,,227,b8d573ac2c092ed49dcab22fdc1f47f4cfed830d,2020-04-09T20:00:00Z,18,118,9694,9551,9551,33,0,0,374,0,374
20200409,NJ,51027,56165,,7363,,1523,,1551,,,d3664bdf91bd8ece813cb2d55230b4895f54b2c0,2020-04-09T20:00:00Z,1700,,107192,107192,107192,34,196,0,3186,3590,6776
20200409,NM,865,22942,,59,,,,18,,201,d5a00c6606ab48f22af533b1282f8163225fc10d,2020-04-09T20:00:00Z,16,,23807,23807,23807,35,3,0,1491,71,1562
20200409,NV,2456,19315,,282,,,,,,,9635ff95f130d1857de5d74bacf7f6c72af5d972,2020-04-09T20:00:00Z,80,,21771,21771,21771,32,9,0,1067,138,1205
20200409,NY,159937,231612,,18279,36576,4925,,,,18297,adcfe0b7d9f5faf78429b00c69af00833443c8ec,2020-04-09T20:00:00Z,7067,36576,391549,391549,391549,36,799,2144,15775,10621,26396
20200409,OH,5512,50473,,,1612,,497,,,,f099bcbfbf8d79d1541a85ea927661eac603a881,2020-04-09T20:00:00Z,213,1612,55985,55985,55985,39,20,117,2280,364,2644
20200409,OK,1684,18595,,188,415,120,,,,686,4134ad5e4d3911e0700b88a7aaae9339b1f207b6,2020-04-09T20:00:00Z,80,415,20279,20279,20279,40,1,25,6774,160,6934
20200409,OR,1321,24306,,146,326,66,,54,,,06d3913b0eccc967a1a12517d7f8e4783ce8f591,2020-04-09T20:00:00Z,44,326,25627,25627,25627,41,11,2,981,82,1063
20200409,PA,18228,87374,,2051,,,,592,,,8e11977c61eb78c15db006bc6135ab8066828777,2020-04-09T20:00:00Z,338,,105602,105602,105602,42,29,0,5075,1989,7064
20200409,PR,683,4703,1304,,,,,,,,3bb866405c927aaf77a70f81b17ece80ef99c327,2020-04-09T20:00:00Z,33,,6690,5386,5386,72,9,0,437,63,500
20200409,RI,1727,10682,,160,,45,,26,,35,fd47654c67cacd1940a1c7cffa0df6b0214882aa,2020-04-09T20:00:00Z,43,,12409,12409,12409,44,8,0,0,277,277
20200409,SC,2792,24575,,,241,,,,,,c05090d9d4cd23e93dadd900e6c6ebb2cc5b00f6,2020-04-09T20:00:00Z,67,241,27367,27367,27367,45,4,0,2493,240,2733
20200409,SD,447,6700,,,27,,,,,161,8cfce8992986ecd4882180246461d58c60cbb9cf,2020-04-09T20:00:00Z,6,27,7147,7147,7147,46,0,1,345,54,399
20200409,TN,4634,55215,,,505,,,,,921,520c002646bd19f9e80ae12d8f8315aab83d0297,2020-04-09T20:00:00Z,94,505,59849,59849,59849,47,15,56,2959,272,3231
20200409,TX,10230,95904,,1439,,,,,,1101,fe4a67d30a9035e09c2e041eb4efaa22284bb709,2020-04-09T20:00:00Z,199,,106134,106134,106134,48,22,0,8999,877,9876
20200409,UT,1976,36397,,,168,,,,,,34ed9aa981dc493348917a34c5d37854cab5b2b3,2020-04-09T20:00:00Z,13,168,38373,38373,38373,49,0,10,2127,130,2257
20200409,VA,4042,28984,627,669,685,469,,285,,,32a8135f572c4f5c6851cbeced9b22c53353e7df,2020-04-09T20:00:00Z,109,685,33653,33026,33026,51,34,70,1984,397,2381
20200409,VI,46,251,42,,,,,,,39,330da68f6494e174387505355ee3fa2cfdaa9e42,2020-04-09T20:00:00Z,1,,339,297,297,78,0,0,9,1,10
20200409,VT,628,7553,,33,,,,,,15,24b22733110eb020e8f1caee0a2cb8db9dd3b934,2020-04-09T20:00:00Z,23,,8181,8181,8181,50,0,0,409,23,432
20200409,WA,9492,112544,,650,,191,,,,,70b4370b242c35c14bcda871fd474a98674f1afa,2020-04-09T20:00:00Z,459,,122036,122036,122036,53,16,0,3697,278,3975
20200409,WI,2885,31424,,,843,,230,,,,aa5c7ae162799320b7accdadf68720fdb6c50f52,2020-04-09T20:00:00Z,111,843,34309,34309,34309,55,12,53,1309,129,1438
20200409,WV,523,13340,,,,,,,,,54cf0e05059125cce24ebdf1fdfdff35af1f361b,2020-04-09T20:00:00Z,5,,13863,13863,13863,54,1,0,1257,61,1318
20200409,WY,230,3920,,,34,,,,,94,231a30211b44fe5c73eef7f2161a0d501c682df9,2020-04-09T20:00:00Z,0,34,4150,4150,4150,56,0,1,77,9,86
20200408,AK,226,6842,,,27,,,,,32,b06950cbd3502f7885c9412d1bf698858848a4d7,2020-04-08T20:00:00Z,7,27,7068,7068,7068,02,1,4,142,13,155
20200408,AL,2369,16753,,,314,,,,,,d7c974f24aac9af8f039f0c9d4627e059267b4a1,2020-04-08T20:00:00Z,66,314,19122,19122,19122,01,10,43,3956,250,4206
20200408,AR,1000,13530,,76,130,,43,30,39,208,dc9ad2f9b7456a55682f25d3f5569a8a420a7f0c,2020-04-08T20:00:00Z,18,130,14530,14530,14530,05,2,-18,838,54,892
20200408,AS,0,3,2,,,,,,,,b1e0124ac6fe5ca02b1b17dc2464d3b5b31ace83,2020-04-08T20:00:00Z,0,,5,3,3,60,0,0,0,0,0
20200408,AZ,2726,31838,,,,,,,,,2b3096a859b88875d9972e3e5521cd07aed78996,2020-04-08T20:00:00Z,80,,34564,34564,34564,04,7,0,1038,151,1189
20200408,CA,16957,127307,14600,2714,,1154,,,,,c597c8b5b77b179c9e590a881c97d79fea2bd2db,2020-04-08T20:00:00Z,442,,158864,144264,144264,06,68,0,11943,1092,13035
20200408,CO,5429,22665,,833,1079,,,,,,c10a0cb31be734e887bcd88fee27d7b8174bc1bc,2020-04-08T20:00:00Z,179,1079,28094,28094,28094,08,29,85,962,257,1219
20200408,CT,7781,21255,,1308,,,,,,,45534c8765623e13c69801a1e66891b07171f925,2020-04-08T20:00:00Z,277,,29036,29036,29036,09,0,0,0,0,0
20200408,DC,1440,6843,,,,,,,,361,6a984539ee98fd18f8879705bea3637b3d17c542,2020-04-08T20:00:00Z,27,,8283,8283,8283,11,5,0,231,229,460
20200408,DE,928,7628,,147,,,,,,144,9a8eba55923c74303bfcc615fc6cd39c2d834f80,2020-04-08T20:00:00Z,16,,8556,8556,8556,10,0,0,0,0,0
20200408,FL,15455,127679,1324,,2062,,,,,,9ca6b245b17a0b8b9a414985df6f5e8338c1dd30,2020-04-08T20:00:00Z,309,2062,144458,143134,143134,12,13,63,4264,708,4972
20200408,GA,9901,28886,,,1993,,,,,,a895f3bea3a6eef44bee143492725ba4af74c53d,2020-04-08T20:00:00Z,362,1993,38787,38787,38787,13,33,219,3991,1083,5074
20200408,GU,125,562,,21,,2,,2,,31,f3056dbcf91af97f2a4055fc511d9f5e69e758fe,2020-04-08T20:00:00Z,4,,687,687,687,66,0,0,33,4,37
20200408,HI,410,14739,,,42,,6,,,113,c791e64551362c9d3458669437df3833d46bb4b6,2020-04-08T20:00:00Z,5,42,15149,15149,15149,15,0,16,1584,23,1607
20200408,IA,1145,12821,,122,193,,,,,431,6ed8bb2a57d38b65911feac6a484fec23d956882,2020-04-08T20:00:00Z,27,193,13966,13966,13966,19,1,0,1151,97,1248
20200408,ID,1210,10688,,,93,,24,,,,27b547d754d7b7848ee8bf6006162b7a42221c6d,2020-04-08T20:00:00Z,15,93,11898,11898,11898,16,2,10,612,40,652
20200408,IL,15078,59988,,3680,,1166,,821,,,db2da93a6acb672606b2a7d6aa39ea427bbb3701,2020-04-08T20:00:00Z,462,,75066,75066,75066,17,82,0,4805,1529,6334
20200408,IN,5943,24926,,,,924,,507,,,fbbf8a2b8324dab4096dc4c4082c442d1a303a08,2020-04-08T20:00:00Z,203,,30869,30869,30869,18,30,0,1669,436,2105
20200408,KS,1046,9137,,,223,,,,,,fd8d2aea43b7e390c0426d2ac0120a9d5aa12c57,2020-04-08T20:00:00Z,38,223,10183,10183,10183,20,11,0,523,146,669
20200408,KY,1149,20455,,,,,,,,,f4d5b5432b32b07295608c1298bee85c9dcb6c5e,2020-04-08T20:00:00Z,65,,21604,21604,21604,21,6,0,1508,141,1649
20200408,LA,17030,64376,,1983,,,,490,,,c174ce072a8244ab0d33a6f3f195c03aa665816d,2020-04-08T20:00:00Z,652,,81406,81406,81406,22,70,0,6005,746,6751
20200408,MA,16692,70849,,2119,2119,,,,,,f5128f9fff43592d64f3b649fb088189809ff685,2020-04-08T20:00:00Z,615,2119,87541,87541,87541,25,100,288,4579,1588,6167
20200408,MD,5529,32933,,,1210,,,,,365,d47d07ee138d924014565dabdc5316462616b927,2020-04-08T20:00:00Z,124,1210,38462,38462,38462,24,21,104,5677,1158,6835
20200408,ME,537,6088,,,101,,,,,187,ae1b00dd8f587c7cc0ff1fec4f62af3e28f48c2d,2020-04-08T20:00:00Z,14,101,6625,6625,6625,23,2,2,0,18,18
20200408,MI,20589,45550,,,,,,,,56,069cf53c2a7e5ed44fbbe8e54a6aa7c9cf6a070a,2020-04-08T20:00:00Z,959,,66139,66139,66139,26,114,0,0,766,766
20200408,MN,1154,29599,,135,271,64,105,,,632,d35b537cf4cb211b89d42f83477e0ac688431c6a,2020-04-08T20:00:00Z,39,271,30753,30753,30753,27,5,29,1408,85,1493
20200408,MO,3327,30783,,519,,,,,,,d610dbf95f9ce914e35925513bd27000667a1dd5,2020-04-08T20:00:00Z,58,,34110,34110,34110,29,5,0,1851,290,2141
20200408,MP,11,27,9,,,,,,,,735ed7fb7685d4eeb3831a9c3d19b1b39665d89f,2020-04-08T20:00:00Z,2,,47,38,38,69,0,0,12,3,15
20200408,MS,2003,18632,,,410,,,,,,fcd575a3ceb3f1a059d37279be733e6d49d79eb0,2020-04-08T20:00:00Z,67,410,20635,20635,20635,28,8,33,0,88,88
20200408,MT,332,7066,,,31,,,,,135,36c57219663afe4f9a25d8bb1219124aabcbc5c6,2020-04-08T20:00:00Z,6,31,7398,7398,7398,30,0,3,400,13,413
20200408,NC,3426,39561,,386,,,,,,,ef6411c1805a6c8509d4b7acf726edd78546548e,2020-04-08T20:00:00Z,53,,42987,42987,42987,37,7,0,1700,205,1905
20200408,ND,251,8301,,16,34,,,,,98,f5b46f7b1cf2660fc83947337d0163f20ba2e916,2020-04-08T20:00:00Z,4,34,8552,8552,8552,38,0,1,835,14,849
20200408,NE,519,7442,,,,,,,,,f0d5c983d53155a6c8258ec5594807b0dae155a8,2020-04-08T20:00:00Z,12,,7961,7961,7961,31,2,0,631,72,703
20200408,NH,788,8389,89,,118,,,,,211,7ebe9caa69ad598a5afd77ca6ca988541ac6e9ab,2020-04-08T20:00:00Z,18,118,9266,9177,9177,33,9,15,370,73,443
20200408,NJ,47437,52979,,7026,,1617,,1576,,,1ce238d30dd4f486d2f2bb36bef82c329b90fde8,2020-04-08T20:00:00Z,1504,,100416,100416,100416,34,272,0,2421,3021,5442
20200408,NM,794,21451,,51,,,,18,,171,5e9d9f69e1e9d52d200ebc187b2ec3a4e126db63,2020-04-08T20:00:00Z,13,,22245,22245,22245,35,1,0,312,108,420
20200408,NV,2318,18248,,282,,,,,,,8eeef516219c0235bb9ccef8db9926eb66f200dd,2020-04-08T20:00:00Z,71,,20566,20566,20566,32,13,0,1696,231,1927
20200408,NY,149316,215837,,18079,34432,4593,,,,16353,36db5397b3f156232e908feab224b44a19364028,2020-04-08T20:00:00Z,6268,34432,365153,365153,365153,36,779,2349,14642,10453,25095
20200408,OH,5148,48193,,,1495,,472,,,,3a07f6e617059a639f0e53d3277927ef65015168,2020-04-08T20:00:00Z,193,1495,53341,53341,53341,39,26,141,2137,366,2503
20200408,OK,1524,11821,,188,390,120,,,,686,162bc2c40a69457aa64daeba84ab2b0950a8b6e5,2020-04-08T20:00:00Z,79,390,13345,13345,13345,40,12,14,0,52,52
20200408,OR,1239,23325,,156,324,61,,58,69,,1c86840efc88ab6828b14988c2d5983a6049dc2e,2020-04-08T20:00:00Z,33,324,24564,24564,24564,41,0,0,1499,58,1557
20200408,PA,16239,82299,,1898,,,,603,,,cab36f3232f06858b95f1664b7788dadbf0f93a1,2020-04-08T20:00:00Z,309,,98538,98538,98538,42,69,0,5580,1680,7260
20200408,PR,620,4266,1160,,,,,,,,35f7ff30a6a6ed0b45cd9139f6ef39aa0edf4057,2020-04-08T20:00:00Z,24,,6046,4886,4886,72,1,0,300,47,347
20200408,RI,1450,10682,,143,,45,,26,,35,98ac386411d8aecfd63defe746ee07ab45b33a5e,2020-04-08T20:00:00Z,35,,12132,12132,12132,44,5,0,1605,220,1825
20200408,SC,2552,22082,,,241,,,,,,8f51f648224b34fc123427ec9411fe698b3fd55d,2020-04-08T20:00:00Z,63,241,24634,24634,24634,45,12,0,819,135,954
20200408,SD,393,6355,0,,26,,,,,146,a8f46321eb94c8751dab4186c5050bb4ded8aee4,2020-04-08T20:00:00Z,6,26,6748,6748,6748,46,0,3,407,73,480
20200408,TN,4362,52256,,,449,,,,,592,ff68dc08ca2226e687b39272db6329b7d75241b3,2020-04-08T20:00:00Z,79,449,56618,56618,56618,47,7,41,3520,224,3744
20200408,TX,9353,86905,,1491,,,,,,38,93f1b214cb7a5167793d5ec07075b9602aca2613,2020-04-08T20:00:00Z,177,,96258,96258,96258,48,23,0,6518,1091,7609
20200408,UT,1846,34270,,,158,,,,,,0ec7be922281b2c2e3ac1769448ed67ab2024183,2020-04-08T20:00:00Z,13,158,36116,36116,36116,49,0,10,1361,108,1469
20200408,VA,3645,27000,,,615,,145,,108,,4f244cf2235f74c233ab8d9fe566115c0adce611,2020-04-08T20:00:00Z,75,615,30645,30645,30645,51,12,52,1688,312,2000
20200408,VI,45,242,35,,,,,,,39,be21b51a3a90bca976c5226f32fc911743a57b90,2020-04-08T20:00:00Z,1,,322,287,287,78,0,0,20,2,22
20200408,VT,605,7144,,35,50,,,,,15,b8f5da42c9c0c15c8ca16cc61712345084f0d207,2020-04-08T20:00:00Z,23,50,7749,7749,7749,50,0,5,590,30,620
20200408,WA,9214,108847,,655,,186,,,,,bcc287d94b552e2dccac7425b80f5526244dca44,2020-04-08T20:00:00Z,443,,118061,118061,118061,53,14,0,4336,355,4691
20200408,WI,2756,30115,,,790,,218,,,,1e997110316d96e4af9dfed752e7c9bafaede693,2020-04-08T20:00:00Z,99,790,32871,32871,32871,55,7,45,1603,178,1781
20200408,WV,462,12083,,,,,,,,,59287361f21a273826deacdebcd7572e171a3e34,2020-04-08T20:00:00Z,4,,12545,12545,12545,54,0,0,436,50,486
20200408,WY,221,3843,,,33,,,,,62,871dc959c9d38ea20b4d4c856b22997e0bccaf55,2020-04-08T20:00:00Z,0,33,4064,4064,4064,56,0,0,54,5,59
20200407,AK,213,6700,,,23,,,,,29,427f23b794025bcc59ba746dc6721ba1ae4f6ff9,2020-04-07T20:00:00Z,6,23,6913,6913,6913,02,0,0,8,22,30
20200407,AL,2119,12797,,,271,,,,,,bc437164edce7423a9a6a0095632666a06d512c4,2020-04-07T20:00:00Z,56,271,14916,14916,14916,01,6,31,0,151,151
20200407,AR,946,12692,,74,148,,,26,43,142,3091efb8651506655cf6538a5a63244288d812e8,2020-04-07T20:00:00Z,16,148,13638,13638,13638,05,0,11,722,71,793
20200407,AS,0,3,2,,,,,,,,d76095b5eddc995d69df0f33197a6638cc6fbf7f,2020-04-07T20:00:00Z,0,,5,3,3,60,0,0,0,0,0
20200407,AZ,2575,30800,,,,,,,,,943f82c1a910748ffe6ec553b93b7b964125cc38,2020-04-07T20:00:00Z,73,,33375,33375,33375,04,8,0,722,119,841
20200407,CA,15865,115364,14100,2611,,1108,,,,,a2ab1e862259b9e5f29fc83a735a7402bacc7da6,2020-04-07T20:00:00Z,374,,145329,131229,131229,06,31,0,12269,1529,13798
20200407,CO,5172,21703,,786,994,,,,,,12249a5bdf925092cbd469cb2a578f54ad5a4c99,2020-04-07T20:00:00Z,150,994,26875,26875,26875,08,10,70,880,222,1102
20200407,CT,7781,21255,,1308,,,,,,,824d1ebd3f4b1c49e597d77753df238341173130,2020-04-07T20:00:00Z,277,,29036,29036,29036,09,71,0,1475,875,2350
20200407,DC,1211,6612,,,,,,,,318,4bb7cd953c61db17cc89b08b77d926f2eea787e6,2020-04-07T20:00:00Z,22,,7823,7823,7823,11,-2,0,256,114,370
20200407,DE,928,7628,,147,,,,,,144,b59047f7944fc9482b1f7653159655f7a5bfad7b,2020-04-07T20:00:00Z,16,,8556,8556,8556,10,2,0,1307,255,1562
20200407,FL,14747,123415,1407,,1999,,,,,,14451271e31c6ef62ec1fed25030c8bbcadd8c83,2020-04-07T20:00:00Z,296,1999,139569,138162,138162,12,60,317,13465,1423,14888
20200407,GA,8818,24895,,,1774,,,,,,7a0ffe5a1d036f2a779e0d14397523b71ac8241a,2020-04-07T20:00:00Z,329,1774,33713,33713,33713,13,100,442,935,1504,2439
20200407,GU,121,529,,21,,2,,2,,27,e4f1f3a809ee107b77e669dd351b0ea512d64a40,2020-04-07T20:00:00Z,4,,650,650,650,66,0,0,24,8,32
20200407,HI,387,13155,,,26,,6,,,89,06de5ddab7916756cd9f985d7476ee41c2851291,2020-04-07T20:00:00Z,5,26,13542,13542,13542,15,1,5,0,16,16
20200407,IA,1048,11670,,104,193,,,,,341,ae5471f42b9f26b00ec9f67c82c73e0e96bf77ac,2020-04-07T20:00:00Z,26,193,12718,12718,12718,19,1,14,1017,102,1119
20200407,ID,1170,10076,,,83,,21,,,,2223b4fd3b2130cde4c6e92876814d778ecc7ec7,2020-04-07T20:00:00Z,13,83,11246,11246,11246,16,3,6,182,69,251
20200407,IL,13549,55183,,3680,,1166,,821,,,01860afc01cd1aaca444ed3812a2f910c2871cf5,2020-04-07T20:00:00Z,380,,68732,68732,68732,17,73,0,4503,1287,5790
20200407,IN,5507,23257,,,,924,,507,,,42532e1054b8584b5dd3db8eaebb0ea3e0a5a8a3,2020-04-07T20:00:00Z,173,,28764,28764,28764,18,34,0,2010,563,2573
20200407,KS,900,8614,,,223,,,,,,a47fd40f94b1f7214f6b6ff2b771091439fffd90,2020-04-07T20:00:00Z,27,223,9514,9514,9514,20,2,25,375,55,430
20200407,KY,1008,18947,,,,,,,,,11fc69bcf9e209378b83b650cd855946fcf47ca9,2020-04-07T20:00:00Z,59,,19955,19955,19955,21,14,0,1135,53,1188
20200407,LA,16284,58371,,1996,,,,519,,,9139f6e23f09c887df221642ce10c85516944f49,2020-04-07T20:00:00Z,582,,74655,74655,74655,22,70,0,4072,1417,5489
20200407,MA,15104,66270,,1831,1831,,,,,,4815cf989210e42bc1099baade40e36de1dd1454,2020-04-07T20:00:00Z,515,1831,81374,81374,81374,25,67,164,3550,1365,4915
20200407,MD,4371,27256,,,1106,,,,,288,c957680fdbd36cb8cd1d307885f4d5b9b1e87afd,2020-04-07T20:00:00Z,103,1106,31627,31627,31627,24,12,47,1684,326,2010
20200407,ME,519,6088,,,99,,,,,176,af07f06f7bb91affb207dc39d20674e9ee2d4149,2020-04-07T20:00:00Z,12,99,6607,6607,6607,23,2,7,0,20,20
20200407,MI,19823,45550,,,,,,,,56,8ff4cbadba372a60d39f847bceeaf9eab1db8001,2020-04-07T20:00:00Z,845,,65373,65373,65373,26,118,0,2430,973,3403
20200407,MN,1069,28191,,120,242,64,100,,,549,1c6751a69dd6a4e9a349a62be6413fdbe71ea87a,2020-04-07T20:00:00Z,34,242,29260,29260,29260,27,4,19,1049,83,1132
20200407,MO,3037,28932,,508,,,,,,,a3d2d6a3042c80afb487dfd2d4a7897fe0edee76,2020-04-07T20:00:00Z,53,,31969,31969,31969,29,14,0,1819,315,2134
20200407,MP,8,15,,,,,,,,,70c7bf240bc0ee206b5e12ec30a64ffd6f19ca2a,2020-04-07T20:00:00Z,2,,23,23,23,69,1,0,2,0,2
20200407,MS,1915,18632,,,377,,,,,,807ca25410f85d8883f0c8fe409f630d92091d1e,2020-04-07T20:00:00Z,59,377,20547,20547,20547,28,8,-98,0,177,177
20200407,MT,319,6666,,,28,,,,,,7397072f3dbcb6c5c091e5ab277d8f2c2f68f82d,2020-04-07T20:00:00Z,6,28,6985,6985,6985,30,0,4,175,20,195
20200407,NC,3221,37861,,354,,,,,,,67dd715b37f86ed85a0618ce86dd6b9d498dee2b,2020-04-07T20:00:00Z,46,,41082,41082,41082,37,13,0,5,351,356
20200407,ND,237,7466,,18,33,,,,,82,59b258409a58763928c3aa0087984baad4dd1600,2020-04-07T20:00:00Z,4,33,7703,7703,7703,38,1,1,478,12,490
20200407,NE,447,6811,,,,,,,,,518ded644af5182eecdac1ec28f9dede5f3b98d8,2020-04-07T20:00:00Z,10,,7258,7258,7258,31,2,0,433,38,471
20200407,NH,715,8019,49,,103,,,,,151,9bdef844521f989a0ac01b4af374dcbb7368680b,2020-04-07T20:00:00Z,9,103,8783,8734,8734,33,0,11,318,46,364
20200407,NJ,44416,50558,,7017,,1651,,1540,,,cc2566fc957facb8d98c9cdcaafbb8235297c5e6,2020-04-07T20:00:00Z,1232,,94974,94974,94974,34,229,0,2616,3326,5942
20200407,NM,686,21139,,48,,,,18,,133,74b47d956a13a1210784d310796b4b88918963db,2020-04-07T20:00:00Z,12,,21825,21825,21825,35,0,0,2627,62,2689
20200407,NV,2087,16552,,282,,,,,,,4f4321d0926b598d47e2a920f8709e23c2b89e00,2020-04-07T20:00:00Z,58,,18639,18639,18639,32,12,0,876,134,1010
20200407,NY,138863,201195,,17493,32083,4593,,,,14590,15947b1c9ed54db71e224d5882c2e146b415b520,2020-04-07T20:00:00Z,5489,32083,340058,340058,340058,36,731,1880,11073,8174,19247
20200407,OH,4782,46056,,,1354,,417,,,,ee1be244efee5b29b0b3adc051423a9eba46f3f0,2020-04-07T20:00:00Z,167,1354,50838,50838,50838,39,25,140,2128,332,2460
20200407,OK,1472,11821,,186,376,137,,,,612,d926e29ea2057ff177bfe56ada2bf18ab9ecf780,2020-04-07T20:00:00Z,67,376,13293,13293,13293,40,16,36,10399,145,10544
20200407,OR,1181,21826,,,324,,,69,,,0d8a30e0bd30ca1bb26872f15cb6fd8209687f3e,2020-04-07T20:00:00Z,33,324,23007,23007,23007,41,6,66,1157,49,1206
20200407,PA,14559,76719,,1665,,,,548,,,5f6c0c5a75d956d960f06c3bff2b90956af04cf5,2020-04-07T20:00:00Z,240,,91278,91278,91278,42,78,0,5845,1579,7424
20200407,PR,573,3966,968,,,,,,,,f55b55c315376b7c321d3701606e48d766c257c6,2020-04-07T20:00:00Z,23,,5507,4539,4539,72,2,0,534,60,594
20200407,RI,1230,9077,,123,,40,,26,,35,813da9a6c780ba8fa0045b1f3cc2bd61c53fe95f,2020-04-07T20:00:00Z,30,,10307,10307,10307,44,3,0,1678,148,1826
20200407,SC,2417,21263,,,241,,,,,,33337e94ee9a38b99bd37fda37b889f83199a988,2020-04-07T20:00:00Z,51,241,23680,23680,23680,45,7,0,4336,368,4704
20200407,SD,320,5948,2,,23,,,,,98,23329c2017a92fb927ed537c0f932b129bff88ec,2020-04-07T20:00:00Z,6,23,6270,6268,6268,46,2,0,216,32,248
20200407,TN,4138,48736,,,408,,,,,466,a34b15897c7e1082065823522dfae12982a71304,2020-04-07T20:00:00Z,72,408,52874,52874,52874,47,7,56,5188,336,5524
20200407,TX,8262,80387,,1252,,,,,,38,cc8ef53ec9222fe4b8c2c5b0383d429085c6ad89,2020-04-07T20:00:00Z,154,,88649,88649,88649,48,14,0,2306,986,3292
20200407,UT,1738,32909,,,148,,,,,,40a68524a0d0c4244c5e3929960fac5865a4b540,2020-04-07T20:00:00Z,13,148,34647,34647,34647,49,0,10,1190,63,1253
20200407,VA,3333,25312,,,563,,145,,108,,2d8926f55fc5c4e769e6556a7e790b9c759e84c1,2020-04-07T20:00:00Z,63,563,28645,28645,28645,51,9,66,3669,455,4124
20200407,VI,43,222,20,,,,,,,36,070fb1b83a9073c515f131b90847354c4f4f4732,2020-04-07T20:00:00Z,1,,285,265,265,78,0,0,0,0,0
20200407,VT,575,6554,,29,45,,,,,15,44493af709005398cd2f24b0c1c9f7cf96707f38,2020-04-07T20:00:00Z,23,45,7129,7129,7129,50,0,0,464,32,496
20200407,WA,8859,104511,,641,,190,,,,,c592ffdb7d53e806595d9b6a097821cb83a7f0a5,2020-04-07T20:00:00Z,429,,113370,113370,113370,53,22,0,4674,336,5010
20200407,WI,2578,28512,,,745,,200,,,,e14827d359df3ec78ec54ec531ff175e68dd2bd4,2020-04-07T20:00:00Z,92,745,31090,31090,31090,55,15,77,1938,138,2076
20200407,WV,412,11647,,,,,,,,,e06f7c7ba78a9622b82d063891c486527000e2ee,2020-04-07T20:00:00Z,4,,12059,12059,12059,54,0,0,2052,67,2119
20200407,WY,216,3789,,,33,,,,,62,4351947d4b6974eb2fd1a41c558fe95a0fdb44b1,2020-04-07T20:00:00Z,0,33,4005,4005,4005,56,0,10,70,6,76
20200406,AK,191,6692,,,23,,,,,,4d91929ba83b31e1dda30ca4a3c7d5716d39bfd7,2020-04-06T20:00:00Z,6,23,6883,6883,6883,02,0,3,593,6,599
20200406,AL,1968,12797,,,240,,,,,,2efa35d0a2dc1dac3c6e12ced852169b719f14ea,2020-04-06T20:00:00Z,50,240,14765,14765,14765,01,5,9,1515,172,1687
20200406,AR,875,11970,,74,137,,,22,39,102,681e0e05c357b930913804c3afe865bfa6f966d3,2020-04-06T20:00:00Z,16,137,12845,12845,12845,05,0,7,1558,45,1603
20200406,AS,0,3,2,,,,,,,,3a37c6e7721e92a70327b4a50845f8a5579db152,2020-04-06T20:00:00Z,0,,5,3,3,60,0,0,0,0,0
20200406,AZ,2456,30078,,,,,,,,,be6a1c823f4e57810c2c8d8f43de71e304b6a99c,2020-04-06T20:00:00Z,65,,32534,32534,32534,04,1,0,4937,187,5124
20200406,CA,14336,103095,15000,2509,,1085,,,,,003211e59c1546fc081730f881ca621139601c35,2020-04-06T20:00:00Z,343,,132431,117431,117431,06,24,0,0,898,898
20200406,CO,4950,20823,,786,924,,,,,,07597b3350c29f1005bf0fe74b9fea1cb8b5a429,2020-04-06T20:00:00Z,140,924,25773,25773,25773,08,14,49,1488,385,1873
20200406,CT,6906,19780,,1221,,,,,,,331c624125331bd02f6656dbf3b17f66953734f1,2020-04-06T20:00:00Z,206,,26686,26686,26686,09,17,0,2185,1231,3416
20200406,DC,1097,6356,,,,,,,,287,efc1c5bfd8563e9f8cb1bcb65c39a8636e42aee3,2020-04-06T20:00:00Z,24,,7453,7453,7453,11,2,0,520,99,619
20200406,DE,673,6321,,101,,,,,,71,cf37ffc02efefef42ffb6e6b5529ba8356c3956f,2020-04-06T20:00:00Z,14,,6994,6994,6994,10,0,0,0,0,0
20200406,FL,13324,109950,1142,,1682,,,,,,b4dbb2348dfa81a79ef605f252915ceeb3f37601,2020-04-06T20:00:00Z,236,1682,124416,123274,123274,12,18,110,8697,1173,9870
20200406,GA,7314,23960,,,1332,,,,,,7fbdf8249948edf453caa4ac551cedfad4c6e5f9,2020-04-06T20:00:00Z,229,1332,31274,31274,31274,13,18,49,2775,667,3442
20200406,GU,113,505,,21,,2,,,,25,a296a0a8bbbdce70dbd163dae499b32101a2505b,2020-04-06T20:00:00Z,4,,618,618,618,66,0,0,12,1,13
20200406,HI,371,13155,,,21,,6,,,85,db9f4880719074c900ecffea275c5058b1b37074,2020-04-06T20:00:00Z,4,21,13526,13526,13526,15,0,2,551,20,571
20200406,IA,946,10653,,99,179,,,,,284,c4c1a020fdf54b6521f263c532a4de89d1879baf,2020-04-06T20:00:00Z,25,179,11599,11599,11599,19,3,14,680,78,758
20200406,ID,1101,9894,,,77,,16,,,,4e2f37a1fcf63752d912fbe47f4e932a367e3e5a,2020-04-06T20:00:00Z,10,77,10995,10995,10995,16,0,11,710,24,734
20200406,IL,12262,50680,,,,,,,,,78c31ba234d1c85d4b9d41c49ea533da5c855ffe,2020-04-06T20:00:00Z,307,,62942,62942,62942,17,33,0,2953,1006,3959
20200406,IN,4944,21247,,,,924,,507,,,5f4916e24243d76f03d2b658cf1f98ac188c64ca,2020-04-06T20:00:00Z,139,,26191,26191,26191,18,12,0,3006,533,3539
20200406,KS,845,8239,,,198,,,,,,6c72b546a13e3baf08b9c625794792dd4473f1c0,2020-04-06T20:00:00Z,25,198,9084,9084,9084,20,3,15,763,98,861
20200406,KY,955,17812,,,,,,,,,5f0f716526e1c3cc135a7162b6189a78ac324b8d,2020-04-06T20:00:00Z,45,,18767,18767,18767,21,5,0,2066,38,2104
20200406,LA,14867,54299,,1981,,,,552,,,a3740cf7280c590ba011403d5c2e52c73f99920c,2020-04-06T20:00:00Z,512,,69166,69166,69166,22,35,0,6984,1857,8841
20200406,MA,13739,62720,,1667,1667,,,,,,fd70b53cbaccbe3fcd713baccdebd6cec77d5dc9,2020-04-06T20:00:00Z,448,1667,76459,76459,76459,25,78,35,3155,1337,4492
20200406,MD,4045,25572,,,1059,,,,,184,51b860d3b0fe49a368c7ee7cb7ae0695859f0e5e,2020-04-06T20:00:00Z,91,1059,29617,29617,29617,24,24,123,844,436,1280
20200406,ME,499,6088,,,92,,,,,158,9816f29c109d6d20a0d8cdb7ffbf5641bc7dcbab,2020-04-06T20:00:00Z,10,92,6587,6587,6587,23,0,6,0,29,29
20200406,MI,18850,43120,,,,,,,,56,713b7f97c2e5c96c3c0080412dcda9b42df34214,2020-04-06T20:00:00Z,727,,61970,61970,61970,26,110,0,2789,1283,4072
20200406,MN,986,27142,,115,223,57,90,,,470,f7a8cca1c4f511a0b8c331cd2f42b77b7fb4aaeb,2020-04-06T20:00:00Z,30,223,28128,28128,28128,27,1,21,1300,51,1351
20200406,MO,2722,27113,,439,,,,,,,44876cfa047477bbea2f3887d3c012b5e9eb4d65,2020-04-06T20:00:00Z,39,,29835,29835,29835,29,5,0,2231,355,2586
20200406,MP,8,13,10,,,,,,,,10213f297312a3f5d4b85bae5983c6d4dcd6fa21,2020-04-06T20:00:00Z,1,,31,21,21,69,0,0,0,0,0
20200406,MS,1738,18632,,,475,,,,,,35f1e3f05db047b513ce0c520a71e84abd8c6c55,2020-04-06T20:00:00Z,51,475,20370,20370,20370,28,8,0,13052,100,13152
20200406,MT,299,6491,,,24,,,,,,72195fdeabd9bc44e4c62aabc52ba24fe91f47a4,2020-04-06T20:00:00Z,6,24,6790,6790,6790,30,0,0,174,13,187
20200406,NC,2870,37856,,270,,,,,,,79ed2fe9fc52cdceca198867d2f320bcc46ca495,2020-04-06T20:00:00Z,33,,40726,40726,40726,37,2,0,396,285,681
20200406,ND,225,6988,,19,32,,,,,74,422a526ac91fe712af0eaa412a73536e980ac1a3,2020-04-06T20:00:00Z,3,32,7213,7213,7213,38,0,1,408,18,426
20200406,NE,409,6378,8,,,,,,,,42cd4bf96826173bb3a5a6a5ca9df14cfde85a82,2020-04-06T20:00:00Z,8,,6795,6787,6787,31,0,0,820,46,866
20200406,NH,669,7701,101,,92,,,,,147,70a71d29747afd73ec66cdfd0621fb6a958076cf,2020-04-06T20:00:00Z,9,92,8471,8370,8370,33,0,6,290,48,338
20200406,NJ,41090,47942,,6390,,,,1263,,,461e1b1f9efb9d0e1190ba770527966f3ed83c11,2020-04-06T20:00:00Z,1003,,89032,89032,89032,34,86,0,3281,3585,6866
20200406,NM,624,18512,,45,,,,18,,130,824b4f01e29d57652140bde152e631fd06ec36c4,2020-04-06T20:00:00Z,12,,19136,19136,19136,35,1,0,2227,81,2308
20200406,NV,1953,15676,,,,,,,,,410ad8bd25fa26f8111b556ef20deba6ba990442,2020-04-06T20:00:00Z,46,,17629,17629,17629,32,0,0,681,117,798
20200406,NY,130689,190122,,16837,30203,4504,,,,13366,2f8e8d32b6402d0d288a4d4db9946c5667b67f39,2020-04-06T20:00:00Z,4758,30203,320811,320811,320811,36,599,2111,9873,8658,18531
20200406,OH,4450,43928,,,1214,,371,,,,379af1a5febc51ed345a6c4af033b8ed1030f0f0,2020-04-06T20:00:00Z,142,1214,48378,48378,48378,39,23,110,4215,407,4622
20200406,OK,1327,1422,,161,340,143,,,,522,7a9dbe14460760a8d8319bae852504e6653d079d,2020-04-06T20:00:00Z,51,340,2749,2749,2749,40,5,10,21,75,96
20200406,OR,1132,20669,,,258,,,40,,,25dd5121fb241ea32f05b2a662678e9ffae92040,2020-04-06T20:00:00Z,27,258,21801,21801,21801,41,0,0,1113,64,1177
20200406,PA,12980,70874,,,1145,,,533,,,38e0af60db24c9b40a0274e3929826b66e991968,2020-04-06T20:00:00Z,162,1145,83854,83854,83854,42,12,73,4613,1470,6083
20200406,PR,513,3432,1000,,,,,,,,4042cfb220e0d43e1dd965301a4b6d4e1a4f3f6c,2020-04-06T20:00:00Z,21,,4945,3945,3945,72,1,0,359,38,397
20200406,RI,1082,7399,,109,,37,,26,,35,a993fa3bfcd36b6447689c11581adcac70279d6e,2020-04-06T20:00:00Z,27,,8481,8481,8481,44,2,0,1140,160,1300
20200406,SC,2049,16927,,,241,,,,,,5fa94b2c78458efcbbcb8feb369f34826b4b2d30,2020-04-06T20:00:00Z,44,241,18976,18976,18976,45,0,0,0,0,0
20200406,SD,288,5732,0,,23,,,,,91,9a0ab68c444290d9b4b67c8b517b1116526f1b39,2020-04-06T20:00:00Z,4,23,6020,6020,6020,46,2,1,379,48,427
20200406,TN,3802,43548,,,352,,,,,356,6e99f97799daa32dfee6ab07755e268c0c2784aa,2020-04-06T20:00:00Z,65,352,47350,47350,47350,47,21,24,1881,169,2050
20200406,TX,7276,78081,,1153,,,,,,38,36fadabbdbb990c75e795f4b4d13f227963067fb,2020-04-06T20:00:00Z,140,,85357,85357,85357,48,13,0,13955,464,14419
20200406,UT,1675,31719,,,138,,,,,,a79f311e74664a5be49283b57cb86101e98e4f8c,2020-04-06T20:00:00Z,13,138,33394,33394,33394,49,5,14,2432,70,2502
20200406,VA,2878,21643,,,497,,145,,108,,c3515340a90eccc1b0b717381a669c8881457106,2020-04-06T20:00:00Z,54,497,24521,24521,24521,51,3,66,609,241,850
20200406,VI,43,222,20,,,,,,,36,9bd028c77055b8af275bac0ad96aef87f45c18fd,2020-04-06T20:00:00Z,1,,285,265,265,78,0,0,16,1,17
20200406,VT,543,6090,,28,45,,,,,15,65d25548f9cbaafc3f6e01dfcc9f8ff6993848ca,2020-04-06T20:00:00Z,23,45,6633,6633,6633,50,1,0,20,31,51
20200406,WA,8523,99837,,638,,191,,,,,25efbe7a4dd7e945776c17b45d6eb25ea59b36a1,2020-04-06T20:00:00Z,407,,108360,108360,108360,53,21,0,4551,342,4893
20200406,WI,2440,26574,,,668,,186,,,,7cd8b0660ae9551ba4a980f38fbd73aee870b871,2020-04-06T20:00:00Z,77,668,29014,29014,29014,55,9,44,1405,173,1578
20200406,WV,345,9595,,,,,,,,,f1298e935f9de41c83650aacb51c751c9be96333,2020-04-06T20:00:00Z,4,,9940,9940,9940,54,1,0,1081,21,1102
20200406,WY,210,3719,,,23,,,,,52,1a81a6ed6b83de32c30c32bfb094f26c70e62fd3,2020-04-06T20:00:00Z,0,23,3929,3929,3929,56,0,0,679,13,692
20200405,AK,185,6099,,,20,,,,,,661d7b0f627847a2dceb5d70d4e9260965031cc2,2020-04-05T20:00:00Z,6,20,6284,6284,6284,02,1,4,230,14,244
20200405,AL,1796,11282,,,231,,,,,,3f2c1f28926eeadf623d04aeb3716d29c5394d3c,2020-04-05T20:00:00Z,45,231,13078,13078,13078,01,2,19,2009,216,2225
20200405,AR,830,10412,,67,130,,,27,39,97,e494a9e5f54ebda0d5dc23e63da16773173c82cc,2020-04-05T20:00:00Z,16,130,11242,11242,11242,05,2,24,785,87,872
20200405,AS,0,3,2,,,,,,,,f2739209490825ae0877fda0f7d57622d07f62f3,2020-04-05T20:00:00Z,0,,5,3,3,60,0,0,0,0,0
20200405,AZ,2269,25141,,,,,,,,,2abd866096fc77008709c2702234d34a7462398b,2020-04-05T20:00:00Z,64,,27410,27410,27410,04,12,0,0,250,250
20200405,CA,13438,103095,15000,2398,,1040,,,,,b16da92c388833be7769869d9eaf221dabbd9b20,2020-04-05T20:00:00Z,319,,131533,116533,116533,06,43,0,1421,1412,2833
20200405,CO,4565,19335,,783,875,,,,,,31a247af3cbbcb8aa7a3f51aaa037f9e9bb5d84e,2020-04-05T20:00:00Z,126,875,23900,23900,23900,08,15,52,1437,392,1829
20200405,CT,5675,17595,,1142,,,,,,,1e92cd4c9468e9740d884cae46aa7fa1d8ad63e8,2020-04-05T20:00:00Z,189,,23270,23270,23270,09,24,0,842,399,1241
20200405,DC,998,5836,,,,,,,,258,492481c558e3cbdafc4289535e3c9f10603f6f0a,2020-04-05T20:00:00Z,22,,6834,6834,6834,11,1,0,300,96,396
20200405,DE,673,6321,,101,,,,,,71,4cfd22e6ea296fbca4f9ce0ea79a4b1b69a56eef,2020-04-05T20:00:00Z,14,,6994,6994,6994,10,0,0,447,80,527
20200405,FL,12151,101253,1129,,1572,,,,,,a93e5474b39c59e992996dd7ffc9f886446156c1,2020-04-05T20:00:00Z,218,1572,114533,113404,113404,12,27,110,10297,1040,11337
20200405,GA,6647,21185,,,1283,,,,,,d574a55e0cbdbd204007cc62e7d7da3ff1222c38,2020-04-05T20:00:00Z,211,1283,27832,27832,27832,13,10,44,1051,487,1538
20200405,GU,112,493,,21,,2,,,,23,657171a222a700475248cd3665c3656d81c40e13,2020-04-05T20:00:00Z,4,,605,605,605,66,0,0,21,19,40
20200405,HI,351,12604,,,19,,6,,,82,77397e6e6161c484fd9fd351a7a97f2504e3ef04,2020-04-05T20:00:00Z,4,19,12955,12955,12955,15,1,1,645,32,677
20200405,IA,868,9973,,91,165,,,,,188,ddab7f4fb076f0753905ad90cf58ce0af0c83e02,2020-04-05T20:00:00Z,22,165,10841,10841,10841,19,8,12,519,82,601
20200405,ID,1077,9184,,,66,,11,,,,181bae20b5e5d41e5e68a4ac2fbbec0ead002f93,2020-04-05T20:00:00Z,10,66,10261,10261,10261,16,0,4,1327,64,1391
20200405,IL,11256,47727,,,,,,,,,d76333be7d0f922df9b8b422717d922c15da272f,2020-04-05T20:00:00Z,274,,58983,58983,58983,17,31,0,4503,899,5402
20200405,IN,4411,18241,,,,,,,,,f93680f2440d0a80612808fcc143041ba9cb2558,2020-04-05T20:00:00Z,127,,22652,22652,22652,18,11,0,2394,458,2852
20200405,KS,747,7476,,,183,,,,,,dae86135f02c394b72b0ae420bb652e62b1475ff,2020-04-05T20:00:00Z,22,183,8223,8223,8223,20,1,11,596,49,645
20200405,KY,917,15746,,,,,,,,,b04b342a420aa4f3ebcda1e367731dcabb035fe9,2020-04-05T20:00:00Z,40,,16663,16663,16663,21,3,0,1005,86,1091
20200405,LA,13010,47315,,1803,,,,561,,,54b0aaaa06fce89fecccf2fd6ce9501b9190d7b5,2020-04-05T20:00:00Z,477,,60325,60325,60325,22,68,0,1313,514,1827
20200405,MA,12402,59565,,1632,1632,,,,,,25defd2f92e682777cafc9aab382fab867527a38,2020-04-05T20:00:00Z,370,1632,71967,71967,71967,25,66,262,2374,765,3139
20200405,MD,3609,24728,,,936,,,,,159,cac549d0b74daccf3ab34404fc5dd3812b44bbff,2020-04-05T20:00:00Z,67,936,28337,28337,28337,24,14,115,2243,484,2727
20200405,ME,470,6088,,,86,,,,,156,251d971acb2a0763de6451631e1f79284d54e187,2020-04-05T20:00:00Z,10,86,6558,6558,6558,23,0,3,0,14,14
20200405,MI,17567,40331,,,,,,,,56,4f43122e0d1c106e7db4947613520694e2e4514c,2020-04-05T20:00:00Z,617,,57898,57898,57898,26,77,0,2926,1172,4098
20200405,MN,935,25842,,106,202,48,77,,,451,c7075ad182d0178bcc22aab78d7cd3495cca7d7d,2020-04-05T20:00:00Z,29,202,26777,26777,26777,27,5,22,1284,70,1354
20200405,MO,2367,24882,,424,,,,,,,434ac4b9d0cbd2143af60703aa3aedc944b8ed77,2020-04-05T20:00:00Z,34,,27249,27249,27249,29,10,0,2268,76,2344
20200405,MP,8,13,10,,,,,,,,2dfb8a2e3962fb5328cb829dac324abbea5ea5c2,2020-04-05T20:00:00Z,1,,31,21,21,69,0,0,0,0,0
20200405,MS,1638,5580,,,475,,,,,,7e075b052224457cec693d4aa2f7c8c5b76962d3,2020-04-05T20:00:00Z,43,475,7218,7218,7218,28,8,39,447,183,630
20200405,MT,286,6317,,,24,,,,,,df75d2ad9e7baae0b40fddec219b81def7584a74,2020-04-05T20:00:00Z,6,24,6603,6603,6603,30,1,0,405,21,426
20200405,NC,2585,37460,,261,,,,,,,4d5b54fff38c79c5d34358a4fc1ecd201692b759,2020-04-05T20:00:00Z,31,,40045,40045,40045,37,7,0,1089,183,1272
20200405,ND,207,6580,,20,31,,,,,63,6a4b61d1260f55fee4335342942c41cf34e82bab,2020-04-05T20:00:00Z,3,31,6787,6787,6787,38,0,1,559,21,580
20200405,NE,363,5558,12,,,,,,,,6249d274e5c51fbff387c37b8d9ef435910c9a47,2020-04-05T20:00:00Z,8,,5933,5921,5921,31,2,0,500,42,542
20200405,NH,621,7411,93,,86,,,,,146,d5c04e13103086262e57257b6f168cab23603a0b,2020-04-05T20:00:00Z,9,86,8125,8032,8032,33,2,6,446,81,527
20200405,NJ,37505,44661,,4000,,,,,,,d2be91c6279c39ae389e9016e723b22d0f8ef25c,2020-04-05T20:00:00Z,917,,82166,82166,82166,34,71,0,3429,3381,6810
20200405,NM,543,16285,,37,,,,18,,54,63f30ca9eb0ba350762c320c91a6b9c3ee657611,2020-04-05T20:00:00Z,11,,16828,16828,16828,35,1,0,1148,48,1196
20200405,NV,1836,14995,,,,,,,,,eed461ec57cf1fb0231459c7950a45d60e402fc7,2020-04-05T20:00:00Z,46,,16831,16831,16831,32,0,0,574,94,668
20200405,NY,122031,180249,,16479,28092,4376,,,,12187,58a99b83c7368e224acff5ea100e3692a0b8fa75,2020-04-05T20:00:00Z,4159,28092,302280,302280,302280,36,594,1709,10332,8327,18659
20200405,OH,4043,39713,,,1104,,346,,,,e5ae03b405f85f1d28b2ebb497d115720b0a273c,2020-04-05T20:00:00Z,119,1104,43756,43756,43756,39,17,98,1581,304,1885
20200405,OK,1252,1401,,,330,,,,,,6533cee27cd3fff7678c17b003d7f79151d505c6,2020-04-05T20:00:00Z,46,330,2653,2653,2653,40,4,14,39,93,132
20200405,OR,1068,19556,,,258,,,40,,,895c3bb4369358143348dcc34246a7c7fc41e04b,2020-04-05T20:00:00Z,27,258,20624,20624,20624,41,1,19,3021,69,3090
20200405,PA,11510,66261,,,1072,,,,,,37345694c2105b11def51fd454c4a6757b9e3189,2020-04-05T20:00:00Z,150,1072,77771,77771,77771,42,14,68,6248,1493,7741
20200405,PR,475,3073,1039,,,,,,,,1573ba924ae71c4ae8290b22456399487d9a034b,2020-04-05T20:00:00Z,20,,4587,3548,3548,72,2,0,468,23,491
20200405,RI,922,6259,,103,,33,,6,,35,f8c3f68699896ac066c1b424d770f323fa222ba5,2020-04-05T20:00:00Z,25,,7181,7181,7181,44,8,0,675,116,791
20200405,SC,2049,16927,,,241,,,,,,ccdff6113258b5f27c5731a18b0b0b1a1839e358,2020-04-05T20:00:00Z,44,241,18976,18976,18976,45,4,0,530,132,662
20200405,SD,240,5353,,,22,,,,,84,95a0098886125c0b34f0de459993844962e75bd4,2020-04-05T20:00:00Z,2,22,5593,5593,5593,46,0,3,341,28,369
20200405,TN,3633,41667,,,328,,,,,295,5a155ea45dcb7ba75630d696556e3c0ed525d402,2020-04-05T20:00:00Z,44,328,45300,45300,45300,47,1,17,3597,312,3909
20200405,TX,6812,64126,,827,,,,,,38,12359c732574d27b68f27360a5f1a8abef4bbcdc,2020-04-05T20:00:00Z,127,,70938,70938,70938,48,22,0,6485,702,7187
20200405,UT,1605,29287,,,124,,,,,,83dbc778efc9acf771c3b3a3c24fdb95eccd9723,2020-04-05T20:00:00Z,8,124,30892,30892,30892,49,0,7,2672,177,2849
20200405,VA,2637,21034,,,431,,145,,108,,43347a01365145c45a8187e871977110df8e3d22,2020-04-05T20:00:00Z,51,431,23671,23671,23671,51,-1,41,1889,230,2119
20200405,VI,42,206,18,,,,,,,34,f7efcce917045a165880162c7ec816f33b5f318f,2020-04-05T20:00:00Z,1,,266,248,248,78,1,0,22,2,24
20200405,VT,512,6070,,29,45,,,,,15,e3035a258b92b434b2fe2e996f2935e60f287645,2020-04-05T20:00:00Z,22,45,6582,6582,6582,50,2,0,687,51,738
20200405,WA,8181,95286,,581,,178,,,,,07ffc5c45d33484f708c6d5e2ee4ac5172a9df72,2020-04-05T20:00:00Z,386,,103467,103467,103467,53,21,0,1757,389,2146
20200405,WI,2267,25169,,,624,,175,,,,e9ae6b075ad9a1a7866f76c9aeddda94fa67311d,2020-04-05T20:00:00Z,68,624,27436,27436,27436,55,12,36,1310,155,1465
20200405,WV,324,8514,,,,,,,,,7c658b660d0796f3403a84ab40c4f1fcb02d9eed,2020-04-05T20:00:00Z,3,,8838,8838,8838,54,1,0,1110,42,1152
20200405,WY,197,3040,,,23,,,,,50,521559b492dc45d4a16042c5a00a0be69fb8f96d,2020-04-05T20:00:00Z,0,23,3237,3237,3237,56,0,0,95,10,105
20200404,AK,171,5869,,,16,,,,,,10a0cf7d2d88dce27674dda730950a2661caa4b0,2020-04-04T20:00:00Z,5,16,6040,6040,6040,02,2,1,10,14,24
20200404,AL,1580,9273,,,212,,,,,,963802ea3a71c8b5d74fec7b17f1fb98e9547168,2020-04-04T20:00:00Z,43,212,10853,10853,10853,01,8,212,1086,148,1234
20200404,AR,743,9627,,72,106,,,23,39,79,e8ac44e2e243e6a3a4c4a59290ba4e5a35dcf203,2020-04-04T20:00:00Z,14,106,10370,10370,10370,05,2,1,632,39,671
20200404,AS,0,3,2,,,,,,,,b7b36903e210f356b4ff21b4a78c7049e6249b31,2020-04-04T20:00:00Z,0,,5,3,3,60,0,0,0,0,0
20200404,AZ,2019,25141,,,,,,,,,92d121ef592004f30d2027f8394c7d5b2003e425,2020-04-04T20:00:00Z,52,,27160,27160,27160,04,11,0,2237,250,2487
20200404,CA,12026,101674,13000,2300,,1008,,,,,4a3edf69851dfa895e0e69e83fb57f41cd4c4a9f,2020-04-04T20:00:00Z,276,,126700,113700,113700,06,39,0,77075,1325,78400
20200404,CO,4173,17898,,777,823,,,,,,864b034ba2cfbf7b77a5f90eafe2f95fc245b758,2020-04-04T20:00:00Z,111,823,22071,22071,22071,08,14,113,1215,445,1660
20200404,CT,5276,16753,,1033,,,,,,,6d7626dbd793cd794dc73f07b50278a1e51d9890,2020-04-04T20:00:00Z,165,,22029,22029,22029,09,34,0,1652,362,2014
20200404,DC,902,5536,,,,,,,,235,afaf508bebd20ff5f9dd84d3011a087369a8c2b7,2020-04-04T20:00:00Z,21,,6438,6438,6438,11,6,0,709,145,854
20200404,DE,593,5874,,95,,,,,,71,cc40395c305b43fd73a2e32bd1110b86b47e826b,2020-04-04T20:00:00Z,14,,6467,6467,6467,10,0,0,879,143,1022
20200404,FL,11111,90956,1281,,1462,,,,,,1f993ebcc7b85b2f8281d911efc5e3c78dda42e8,2020-04-04T20:00:00Z,191,1462,103348,102067,102067,12,28,175,8819,1526,10345
20200404,GA,6160,20134,,,1239,,,,,,18b3449ec335447f642a8016122da3ebf65fd362,2020-04-04T20:00:00Z,201,1239,26294,26294,26294,13,17,81,700,329,1029
20200404,GU,93,472,,20,,2,,,,20,8f8d2f5f8c4dd7332e8e2fc885fd5dbedfdcd645,2020-04-04T20:00:00Z,4,,565,565,565,66,0,0,13,9,22
20200404,HI,319,11959,,,18,,6,,,78,85b971fb96772bd9d5372009c96c64990057f4d5,2020-04-04T20:00:00Z,3,18,12278,12278,12278,15,1,3,1753,34,1787
20200404,IA,786,9454,,85,153,,,,,188,c2f4cc268e2b747cc59744241bf64e46a2935131,2020-04-04T20:00:00Z,14,153,10240,10240,10240,19,3,15,700,87,787
20200404,ID,1013,7857,,,62,,8,,,,ca14157f2fde1aec45469a4435b5ecac0c291f64,2020-04-04T20:00:00Z,10,62,8870,8870,8870,16,1,6,803,122,925
20200404,IL,10357,43224,,,,,,,,,3d772552de2938982868c2c2796802165dc593e4,2020-04-04T20:00:00Z,243,,53581,53581,53581,17,33,0,4080,1453,5533
20200404,IN,3953,15847,,,,,,,,,23917dae4d93280471686b45f6bc5b09a7c99781,2020-04-04T20:00:00Z,116,,19800,19800,19800,18,14,0,1449,516,1965
20200404,KS,698,6880,,,172,,,,,,1bd06ebda4fa4c851c7f1b7653fd751cdcbefeda,2020-04-04T20:00:00Z,21,172,7578,7578,7578,20,4,21,426,78,504
20200404,KY,831,14741,,,,,,,,,7303bebeca09a7039fc2cc1818e6edc0d80d62ed,2020-04-04T20:00:00Z,37,,15572,15572,15572,21,6,0,2707,61,2768
20200404,LA,12496,46002,,1726,,,,571,,,006a93457fa79372c9c83099dfe37f9b61ab0762,2020-04-04T20:00:00Z,409,,58498,58498,58498,22,39,0,2654,2199,4853
20200404,MA,11637,57191,,1370,1370,,,,,,e3761bf75abe9cec66ed42ae11ba6511ef692ac7,2020-04-04T20:00:00Z,304,1370,68828,68828,68828,25,39,404,4506,1334,5840
20200404,MD,3125,22485,,,821,,,,,159,3e558ddd96779d7dcb9e3081fabf4cbf5ab62a55,2020-04-04T20:00:00Z,53,821,25610,25610,25610,24,11,157,1553,367,1920
20200404,ME,456,6088,,,83,,,,,140,02fc81a3dbc1ac48ca9090a7e206593d987d39f8,2020-04-04T20:00:00Z,10,83,6544,6544,6544,23,1,8,0,24,24
20200404,MI,16395,37405,,,,,,,,56,73be3a717edb05eb45181c6e0debaf9453593f29,2020-04-04T20:00:00Z,540,,53800,53800,53800,26,61,0,3735,1143,4878
20200404,MN,865,24558,,95,180,42,69,,,440,47151f187a4d69935f42b9cd12a42cfe7fe3f4db,2020-04-04T20:00:00Z,24,180,25423,25423,25423,27,2,24,1120,76,1196
20200404,MO,2291,22614,,413,,,,,,,1de6d799527bb662b4f811d06062ae19798cf39c,2020-04-04T20:00:00Z,24,,24905,24905,24905,29,5,0,3257,178,3435
20200404,MP,8,13,10,,,,,,,,c8062971344da9c2966da3616c662302e33beb22,2020-04-04T20:00:00Z,1,,31,21,21,69,0,0,0,0,0
20200404,MS,1455,5133,,,436,,,,,,e6b7dcd404a9b670553d7a858afe76f239b27d8f,2020-04-04T20:00:00Z,35,436,6588,6588,6588,28,6,16,380,97,477
20200404,MT,265,5912,,,24,,,,,,4d03e9b5ae1b42666266fddb59c97097f2f184cb,2020-04-04T20:00:00Z,5,24,6177,6177,6177,30,0,0,579,22,601
20200404,NC,2402,36371,,271,,,,,,,d376f1f555fd1f8eb9e9fb805c2a44b9c5879598,2020-04-04T20:00:00Z,24,,38773,38773,38773,37,5,0,6866,309,7175
20200404,ND,186,6021,,,30,,,,,63,c036a7908926a69e9d6abbabfbccb51600d6ef08,2020-04-04T20:00:00Z,3,30,6207,6207,6207,38,0,1,396,13,409
20200404,NE,321,5058,10,,,,,,,,7c8f0e5925f2794be243d16c543031154fca7f32,2020-04-04T20:00:00Z,6,,5389,5379,5379,31,0,0,571,42,613
20200404,NH,540,6965,94,,80,,,,,144,6a22cd2922422f2362f9ae8e0328e75a92305659,2020-04-04T20:00:00Z,7,80,7599,7505,7505,33,2,7,390,61,451
20200404,NJ,34124,41232,,4000,,,,,,,9403b0c89cae5f262e33a28b73e52734aa654d49,2020-04-04T20:00:00Z,846,,75356,75356,75356,34,200,0,3624,4229,7853
20200404,NM,495,15137,,41,,,,18,,26,2b94d66d25c501a9c947be0bd794488ff4d04abf,2020-04-04T20:00:00Z,10,,15632,15632,15632,35,3,0,762,92,854
20200404,NV,1742,14421,,,,,,,,,34a77b0dddf91a2c2c4ca6b188c57b511c9dcafe,2020-04-04T20:00:00Z,46,,16163,16163,16163,32,3,0,1403,228,1631
20200404,NY,113704,169917,,15905,26383,4126,,,,10478,792799b4ed7e06f7995dec04e454a37ec5edb0c0,2020-04-04T20:00:00Z,3565,26383,283621,283621,283621,36,630,2687,12260,10841,23101
20200404,OH,3739,38132,,,1006,,326,,,,f317223856900d8dd2a3ec361b5b3edc776a2cb5,2020-04-04T20:00:00Z,102,1006,41871,41871,41871,39,11,111,3069,427,3496
20200404,OK,1159,1362,,,316,,,,,,c009b48e99f48b5124644ba88479304de7eab155,2020-04-04T20:00:00Z,42,316,2521,2521,2521,40,4,27,47,171,218
20200404,OR,999,16535,,,239,,,38,,,0d38ab0fd06af64c96daa9315d986181158b3ded,2020-04-04T20:00:00Z,26,239,17534,17534,17534,41,4,35,0,100,100
20200404,PA,10017,60013,,,1004,,,,,,81ba5a1abe612a1fd95cedf0baeb4e7b9e446694,2020-04-04T20:00:00Z,136,1004,70030,70030,70030,42,34,152,6318,1597,7915
20200404,PR,452,2605,1129,,,,,,,,6df35c474e40400cf188b8e94850f9c371d1a88d,2020-04-04T20:00:00Z,18,,4186,3057,3057,72,3,0,556,74,630
20200404,RI,806,5584,,93,,31,,6,,35,a77810637e6c6db9721eaa87537095b5e2a2d791,2020-04-04T20:00:00Z,17,,6390,6390,6390,44,3,0,727,97,824
20200404,SC,1917,16397,,,241,,,,,,b0fb0beac6f2e84cb2ef41f3a01abcf88df02ad7,2020-04-04T20:00:00Z,40,241,18314,18314,18314,45,9,0,10956,363,11319
20200404,SD,212,5012,1,,19,,,,,76,f4760a4f2592a21960fa3a320e23904bd1425fe8,2020-04-04T20:00:00Z,2,19,5225,5224,5224,46,0,2,419,25,444
20200404,TN,3321,38070,,,311,,,,,416,9a4555b4ea0d32017009e836958512d05cc69e17,2020-04-04T20:00:00Z,43,311,41391,41391,41391,47,6,18,3298,254,3552
20200404,TX,6110,57641,,196,,,,,,38,48b48de447638a10ca85269ada674586a07c6519,2020-04-04T20:00:00Z,105,,63751,63751,63751,48,15,0,7207,780,7987
20200404,UT,1428,26615,,,117,,,,,,7488de1606fb85c66768cd77a8f5b6742325f57a,2020-04-04T20:00:00Z,8,117,28043,28043,28043,49,1,11,3613,182,3795
20200404,VA,2407,19145,,,390,,145,,108,,44eaf300e7ae68bb5f75324ab03882f20c0c5c6e,2020-04-04T20:00:00Z,52,390,21552,21552,21552,51,6,78,2152,395,2547
20200404,VI,40,184,42,,,,,,,34,1f30a0f58472c56075f6ceef3a03b932f858d499,2020-04-04T20:00:00Z,,,266,224,224,78,0,0,30,2,32
20200404,VT,461,5383,,29,45,,,,,15,360482bd60b638d752907eee73f063bb7c1298f4,2020-04-04T20:00:00Z,20,45,5844,5844,5844,50,3,0,544,72,616
20200404,WA,7792,93529,,574,,174,,,,,7be57c3d7fb60b48033364b3ab548379469995d1,2020-04-04T20:00:00Z,365,,101321,101321,101321,53,27,0,2345,368,2713
20200404,WI,2112,23859,,,588,,,,,,53b4a4b3e0ef24896a5d026a80ca4246d6b4f550,2020-04-04T20:00:00Z,56,588,25971,25971,25971,55,19,101,1482,200,1682
20200404,WV,282,7404,,,,,,,,,d80af5ae8b58e07f6c9ff6bc393c3d2280e539aa,2020-04-04T20:00:00Z,2,,7686,7686,7686,54,0,0,1274,45,1319
20200404,WY,187,2945,,,23,,,,,49,415d73e6e2ac994fdc01d676595fb7ac5b666b1f,2020-04-04T20:00:00Z,0,23,3132,3132,3132,56,0,2,241,25,266
20200403,AK,157,5859,,,15,,,,,,192f851a8f9b68576ed308814322d1333b538699,2020-04-03T20:00:00Z,3,15,6016,6016,6016,02,0,6,980,14,994
20200403,AL,1432,8187,,,,,,,,,2321b8fce440dd33ac0feef0e923113ffffbf603,2020-04-03T20:00:00Z,35,,9619,9619,9619,01,3,0,684,199,883
20200403,AR,704,8995,,71,105,,,26,39,60,a129a75b81c57893907409886ae725cdb64e4b2c,2020-04-03T20:00:00Z,12,105,9699,9699,9699,05,0,5,1115,61,1176
20200403,AS,0,3,2,,,,,,,,927c34f4a05fc499874a1e27f00bc9b1f4fe7fe3,2020-04-03T20:00:00Z,0,,5,3,3,60,0,0,0,0,0
20200403,AZ,1769,22904,,,,,,,,,2034453edd5b83833266bd4b71eb40738571fb8e,2020-04-03T20:00:00Z,41,,24673,24673,24673,04,9,0,1793,171,1964
20200403,CA,10701,24599,59500,2188,,901,,,,,67f105bfa3690e07b85e362a0c6c43aa796aba45,2020-04-03T20:00:00Z,237,,94800,35300,35300,06,34,0,790,1510,2300
20200403,CO,3728,16683,,739,710,,,,,,7fabb770d24cefb51234aade04a64761abbb9ebd,2020-04-03T20:00:00Z,97,710,20411,20411,20411,08,17,90,1380,386,1766
20200403,CT,4914,15101,,909,,,,,,,1951d0ca03e6ab2d9bffc4856b060402c69ea7e6,2020-04-03T20:00:00Z,131,,20015,20015,20015,09,19,0,625,1090,1715
20200403,DC,757,4827,,,,,,,,206,fbf3f83530b301cee1d7dc47fd0719b435edc428,2020-04-03T20:00:00Z,15,,5584,5584,5584,11,3,0,410,104,514
20200403,DE,450,4995,,63,,,,,,71,b840b5921e6e7a1adc67cdefd1c22f4e046d277a,2020-04-03T20:00:00Z,14,,5445,5445,5445,10,2,0,429,57,486
20200403,FL,9585,82137,1225,,1287,,,,,,b57074c59ada3265eae0eff0d8740ad16a99e8cd,2020-04-03T20:00:00Z,163,1287,92947,91722,91722,12,35,164,12851,1575,14426
20200403,GA,5831,19434,,,1158,,,,,,c82f88637af7d0c85b2360390bb2386b0da43065,2020-04-03T20:00:00Z,184,1158,25265,25265,25265,13,21,102,1825,483,2308
20200403,GU,84,459,,19,,2,,,,14,043fa723d9c8baf2770180cf58a90543d8ada0b2,2020-04-03T20:00:00Z,4,,543,543,543,66,1,0,17,2,19
20200403,HI,285,10206,,,15,,6,,,72,1c81c643bccf41f562ee8a0b1565f639a71e5cb7,2020-04-03T20:00:00Z,2,15,10491,10491,10491,15,1,0,0,27,27
20200403,IA,699,8754,,80,138,,,,,188,feb894b5b255cf3a6496c9856b448a6307f9b022,2020-04-03T20:00:00Z,11,138,9453,9453,9453,19,0,18,700,85,785
20200403,ID,891,7054,,,56,,7,,,,a3f3c21c0ca004354535ce3e1e5108d313bd5a30,2020-04-03T20:00:00Z,9,56,7945,7945,7945,16,0,7,441,222,663
20200403,IL,8904,39144,,,,,,,,,5393eb554824524a4a63bbec9c795869c7869414,2020-04-03T20:00:00Z,210,,48048,48048,48048,17,53,0,3183,1209,4392
20200403,IN,3437,14398,,,,,,,,,b6a582ed478dfba401e4a56efe6e9e4a1b532d04,2020-04-03T20:00:00Z,102,,17835,17835,17835,18,24,0,1152,398,1550
20200403,KS,620,6454,,,151,,,,,,423f188ae5bf45319e336f75b49a3708bdbc8494,2020-04-03T20:00:00Z,17,151,7074,7074,7074,20,4,13,395,68,463
20200403,KY,770,12034,,,,,,,,,b7ec08543b9b2324d60694f6721979dc00c54543,2020-04-03T20:00:00Z,31,,12804,12804,12804,21,11,0,4814,90,4904
20200403,LA,10297,43348,,1707,,,,535,,,67272131caf7c308a8c118046b0f4720f48b292a,2020-04-03T20:00:00Z,370,,53645,53645,53645,22,60,0,1412,1147,2559
20200403,MA,10303,52685,,,966,,,,,,1af458b8004ff96bbec2b2873d34902038eb815c,2020-04-03T20:00:00Z,265,966,62988,62988,62988,25,36,153,4918,1436,6354
20200403,MD,2758,20932,,,664,,,,,159,748f7091af15d9ca085a92ba09b7390f763b6eb5,2020-04-03T20:00:00Z,42,664,23690,23690,23690,24,6,82,2042,427,2469
20200403,ME,432,6088,,,75,,,,,113,4b5209b1b8259d319beb467d9b74d759206853f8,2020-04-03T20:00:00Z,9,75,6520,6520,6520,23,2,7,0,56,56
20200403,MI,15252,33670,,,,,,,,56,6d7b1e9deef1dc89156d45d3791fd07684b2b368,2020-04-03T20:00:00Z,479,,48922,48922,48922,26,62,0,3302,1135,4437
20200403,MN,789,23438,,86,156,40,40,,,,6c45e5c1cc14d97b2d8c49fc1e64ae7a7ebb3861,2020-04-03T20:00:00Z,22,156,24227,24227,24227,27,4,18,1786,47,1833
20200403,MO,2113,19357,,,,,,,,,4b8f07be28b3788c1fbf8838dfb55730f628b262,2020-04-03T20:00:00Z,19,,21470,21470,21470,29,0,0,1508,279,1787
20200403,MP,8,13,10,,,,,,,,6642918d88a155cb1d4ec9916bd848942a950a82,2020-04-03T20:00:00Z,1,,31,21,21,69,0,0,0,0,0
20200403,MS,1358,4753,,,420,,,,,,8fa26347da7a40d2568c9ec1881dcb83d4ba139c,2020-04-03T20:00:00Z,29,420,6111,6111,6111,28,3,60,0,181,181
20200403,MT,243,5333,,,24,,,,,,58d29fc14826e53d165af859f9d3b6aa2a562cd4,2020-04-03T20:00:00Z,5,24,5576,5576,5576,30,0,4,240,16,256
20200403,NC,2093,29505,,184,,,,,,,f9a94cae7cfc07dcd853c4ffe5b95a6a7fb2b91c,2020-04-03T20:00:00Z,19,,31598,31598,31598,37,3,0,2683,236,2919
20200403,ND,173,5625,,,29,,,,,55,84ef01d179db6bf5d01711b8006489518c3cb319,2020-04-03T20:00:00Z,3,29,5798,5798,5798,38,0,1,804,14,818
20200403,NE,279,4487,11,,,,,,,,4afd0964d77f63c02401a16e57510b1d974e875d,2020-04-03T20:00:00Z,6,,4777,4766,4766,31,1,0,509,33,542
20200403,NH,479,6575,114,,73,,,,,101,d868c7b35e0058b0fc967b11ce603223586ff8a4,2020-04-03T20:00:00Z,5,73,7168,7054,7054,33,1,15,497,64,561
20200403,NJ,29895,37608,,3016,,,,,,,03c9451e42a8c786a5cf424ad0fbfb412981e80b,2020-04-03T20:00:00Z,646,,67503,67503,67503,34,109,0,4088,4305,8393
20200403,NM,403,14375,,31,,,,,,26,09eb92561715a0365bc92c3a3b35f0c08b82690e,2020-04-03T20:00:00Z,7,,14778,14778,14778,35,1,0,727,40,767
20200403,NV,1514,13018,,,,,,,,,b06428c9678bd268d2992c491635ac82ec96bf35,2020-04-03T20:00:00Z,43,,14532,14532,14532,32,5,0,430,56,486
20200403,NY,102863,157657,,14810,23696,3731,,,,8886,3581ea3846e784ce3996c873effe694f50617310,2020-04-03T20:00:00Z,2935,23696,260520,260520,260520,36,562,2879,11073,10482,21555
20200403,OH,3312,35063,,,895,,288,,,,4f9def22c6f51b8839104ffcb46d41122de71744,2020-04-03T20:00:00Z,91,895,38375,38375,38375,39,10,93,3047,410,3457
20200403,OK,988,1315,,171,289,123,,,,383,ce94ae6cd03042a8be757810176e3101087d0ee9,2020-04-03T20:00:00Z,38,289,2303,2303,2303,40,4,32,50,109,159
20200403,OR,899,16535,,188,204,,,38,,,bc8939b3d2eaa3d2307a465344d028859fb57771,2020-04-03T20:00:00Z,22,204,17434,17434,17434,41,1,16,1276,73,1349
20200403,PA,8420,53695,,,852,,,,,,aade9d40167b6e73754871c40386092b362363a2,2020-04-03T20:00:00Z,102,852,62115,62115,62115,42,12,122,5997,1404,7401
20200403,PR,378,2049,1055,,,,,,,,31c1cb53249716895ec3490c18feb99b785a620a,2020-04-03T20:00:00Z,15,,3482,2427,2427,72,3,0,445,62,507
20200403,RI,709,4857,,77,,14,,6,,35,0f4d117ec3f26dff910fff56bd42e00ac645986c,2020-04-03T20:00:00Z,14,,5566,5566,5566,44,2,0,445,52,497
20200403,SC,1554,5441,,,241,,,,,,83a9526f05767b32166dffbd1c0668fe1e12c1b5,2020-04-03T20:00:00Z,31,241,6995,6995,6995,45,0,-655,0,0,0
20200403,SD,187,4593,3,,17,,,,,69,aa416c771bd2c9e919678126e5564dbe952c2e46,2020-04-03T20:00:00Z,2,17,4783,4780,4780,46,0,0,376,22,398
20200403,TN,3067,34772,,,293,,,,,248,019351b10edda80786a653adea2799cab1992e8a,2020-04-03T20:00:00Z,37,293,37839,37839,37839,47,5,30,3006,222,3228
20200403,TX,5330,50434,,196,,,,,,38,d995c4ec3f315bd5c26553907caa07bff418a7d9,2020-04-03T20:00:00Z,90,,55764,55764,55764,48,20,0,4424,661,5085
20200403,UT,1246,23002,,,106,,,,,,be88433eea3c0ab307191b78f63c45fe05615642,2020-04-03T20:00:00Z,7,106,24248,24248,24248,49,0,6,2847,172,3019
20200403,VA,2012,16993,,,312,,145,,108,,cb349d06a8404e8ea589d4d05f5ae53dfdbd1692,2020-04-03T20:00:00Z,46,312,19005,19005,19005,51,5,7,1110,306,1416
20200403,VI,38,154,56,,,,,,,29,17ad51e2c11f205d7826f212c444c6191de61144,2020-04-03T20:00:00Z,,,248,192,192,78,0,0,5,5,10
20200403,VT,389,4839,,29,45,,,,,15,fd502b9dcb8608ca17ea5eecf37d01466c5f5389,2020-04-03T20:00:00Z,17,45,5228,5228,5228,50,0,0,128,51,179
20200403,WA,7424,91184,,,,,,,,,795071366777f29eee9beabf227e00db0f02345a,2020-04-03T20:00:00Z,338,,98608,98608,98608,53,28,0,4295,531,4826
20200403,WI,1912,22377,,,487,,,,,,ac2e774ab91aaf87bd106a4d19ddc35d0a14d163,2020-04-03T20:00:00Z,37,487,24289,24289,24289,55,6,26,2060,182,2242
20200403,WV,237,6130,,,1,,,,,,0d5735f82295c4874f145fbc22684001af9837e6,2020-04-03T20:00:00Z,2,1,6367,6367,6367,54,0,0,854,20,874
20200403,WY,162,2704,,,21,,,,,37,3fa4d519d76a3a9a53f819f66887a8a4f7587958,2020-04-03T20:00:00Z,0,21,2866,2866,2866,56,0,2,265,12,277
20200402,AK,143,4879,,,9,,,,,,87a29f5de0e12ea1b772006bfa38cdee3327489e,2020-04-02T20:00:00Z,3,9,5022,5022,5022,02,0,0,409,10,419
20200402,AL,1233,7503,,,,,,,,,1a78d31c95bd0d315fc61461107fcd8c66e53b43,2020-04-02T20:00:00Z,32,,8736,8736,8736,01,6,0,806,156,962
20200402,AR,643,7880,,66,100,,,23,32,47,d9bd463d4e0eec83d73a3185176ba4d9bb0e7a98,2020-04-02T20:00:00Z,12,100,8523,8523,8523,05,2,10,526,59,585
20200402,AS,0,3,2,,,,,,,,33ed9ee9243012a2f29381536962f508253e1df0,2020-04-02T20:00:00Z,0,,5,3,3,60,0,0,0,0,0
20200402,AZ,1598,21111,,,,,,,,,6e70cfc7ece882cb642606ef4d42687c36b5f6cc,2020-04-02T20:00:00Z,32,,22709,22709,22709,04,3,0,1466,185,1651
20200402,CA,9191,23809,59500,1922,,816,,,,,99877fe91b05bb13daef3f63c02c50d2a271e7f5,2020-04-02T20:00:00Z,203,,92500,33000,33000,06,32,0,2037,1036,3073
20200402,CO,3342,15303,,698,620,,,,,,54c77e38711f0c15356f554fa669ccfb4f8e6f50,2020-04-02T20:00:00Z,80,620,18645,18645,18645,08,11,111,1420,376,1796
20200402,CT,3824,14476,,827,,,,,,,bbaf84bc79e98252465e76199b3d66cb58316223,2020-04-02T20:00:00Z,112,,18300,18300,18300,09,27,0,1433,267,1700
20200402,DC,653,4417,,,,,,,,173,bb0f0a7da39336cefc7629d9814ca0bd2a83e358,2020-04-02T20:00:00Z,12,,5070,5070,5070,11,1,0,1155,67,1222
20200402,DE,393,4566,,56,,,,,,49,ed433f1aae9fc98fb0f7510f5bbd3f0bd9cdf5ab,2020-04-02T20:00:00Z,12,,4959,4959,4959,10,1,0,551,25,576
20200402,FL,8010,69286,1285,,1123,,,,,,174161bf2644248219c4f77323f7aa378fc8d409,2020-04-02T20:00:00Z,128,1123,78581,77296,77296,12,41,174,9757,1055,10812
20200402,GA,5348,17609,,,1056,,,,,,15b36e0f73598e9edefa4eb26b735231587f472d,2020-04-02T20:00:00Z,163,1056,22957,22957,22957,13,24,104,1921,710,2631
20200402,GU,82,442,,19,,2,,,,12,50fcb6de190ca75d99bd2eaf474a7bf0c5156550,2020-04-02T20:00:00Z,3,,524,524,524,66,0,0,36,5,41
20200402,HI,258,10206,,,15,,6,,,69,ac8dc9b5da36db2163bbfdd8ca59dd03cfec5f3d,2020-04-02T20:00:00Z,1,15,10464,10464,10464,15,0,2,1485,50,1535
20200402,IA,614,8054,,74,120,,,,,46,1f5c0a22d84a29b633b8b5a1fd1154e5b7a69bd9,2020-04-02T20:00:00Z,11,120,8668,8668,8668,19,2,21,750,65,815
20200402,ID,669,6613,,,49,,7,,,,378cb12d7518fb0b43fcd79e17608a1b0d3a2d1c,2020-04-02T20:00:00Z,9,49,7282,7282,7282,16,0,3,537,144,681
20200402,IL,7695,35961,,,,,,,,,1a8b1e0bab7743ed9c982d78d0d7844622a6d6a3,2020-04-02T20:00:00Z,157,,43656,43656,43656,17,16,0,2557,715,3272
20200402,IN,3039,13246,,,,,,,,,7efa7f48655167cc1d748ae1740c9b97dd06a209,2020-04-02T20:00:00Z,78,,16285,16285,16285,18,13,0,1436,474,1910
20200402,KS,552,6059,,,138,,,,,,e1d064496cc599d8997422f5393e363895fed048,2020-04-02T20:00:00Z,13,138,6611,6611,6611,20,3,24,648,70,718
20200402,KY,680,7220,,,,,,,,,9ab2e64fd49a2aba449f469559e03c171789906f,2020-04-02T20:00:00Z,20,,7900,7900,7900,21,3,0,255,89,344
20200402,LA,9150,41936,,1639,,,,507,,,74378a606d03569d38f8e7ee8f3eb876d17a661a,2020-04-02T20:00:00Z,310,,51086,51086,51086,22,37,0,2584,2726,5310
20200402,MA,8867,47767,,,813,,,,,,f3a6132bed37ee93dcf5112edd7177035fe8225f,2020-04-02T20:00:00Z,229,813,56634,56634,56634,25,42,131,3642,1228,4870
20200402,MD,2331,18890,,,582,,,,,81,ecc07bae25f936e57b3850a6ce3bcb5de2a72e94,2020-04-02T20:00:00Z,36,582,21221,21221,21221,24,5,60,1657,346,2003
20200402,ME,376,6088,,,68,,,,,94,06fbf4e13e1f498f67a0c8c3ed6230b5d2545f50,2020-04-02T20:00:00Z,7,68,6464,6464,6464,23,0,5,0,32,32
20200402,MI,14117,30368,,,,,,,,,abebb0f8a0764dcc090aee82a1c844333dae4b87,2020-04-02T20:00:00Z,417,,44485,44485,44485,26,80,0,3131,1229,4360
20200402,MN,742,21652,,75,138,38,38,,,,af6b7633af8e8dd204b0ba17fe37e8ade6cd0abb,2020-04-02T20:00:00Z,18,138,22394,22394,22394,27,1,16,1150,53,1203
20200402,MO,1834,17849,,,,,,,,,db61b660ddb54194c33a182e92605bcbeccb7e37,2020-04-02T20:00:00Z,19,,19683,19683,19683,29,1,0,2003,253,2256
20200402,MP,8,13,12,,,,,,,,4c6b9b16d6a6f74a9d5d88fac1a5f162fbf047df,2020-04-02T20:00:00Z,1,,33,21,21,69,1,0,13,2,15
20200402,MS,1177,4753,,,360,,,,,,3fcf47375c2d49eb03ea205131eac0e18c42a29d,2020-04-02T20:00:00Z,26,360,5930,5930,5930,28,4,28,1041,104,1145
20200402,MT,227,5093,,,20,,,,,,83ed127512ee7881e2dc28380478203d2775dbaa,2020-04-02T20:00:00Z,5,20,5320,5320,5320,30,0,3,383,19,402
20200402,NC,1857,26822,,184,,,,,,,02a3e91a943b52c408f70185009c0908f88ffe18,2020-04-02T20:00:00Z,16,,28679,28679,28679,37,6,0,2163,273,2436
20200402,ND,159,4821,,,28,,,,,43,772ba7dafcd9354101e253cccb816ef1eebf1dc7,2020-04-02T20:00:00Z,3,28,4980,4980,4980,38,0,5,470,17,487
20200402,NE,246,3978,11,,,,,,,,1e5adc3c19a8d6dfeddcd695a6e27c0091ee0f4a,2020-04-02T20:00:00Z,5,,4235,4224,4224,31,1,0,503,36,539
20200402,NH,415,6078,126,,58,,,,,91,85834510c408ec08a6cc26b011efba15b9c91fa4,2020-04-02T20:00:00Z,4,58,6619,6493,6493,33,0,2,93,0,93
20200402,NJ,25590,33520,,2000,,,,,,,787104ddf97e6c1c54a17fc84bff2f6cf5801c39,2020-04-02T20:00:00Z,537,,59110,59110,59110,34,182,0,3133,3335,6468
20200402,NM,363,13648,,31,,,,,,26,63f4d9a139969285dde777b0114ad3dfa234ef53,2020-04-02T20:00:00Z,6,,14011,14011,14011,35,1,0,723,48,771
20200402,NV,1458,12588,,,,,,,,,ac281047995939a05d81fab70153c5a347c9a93f,2020-04-02T20:00:00Z,38,,14046,14046,14046,32,12,0,1069,179,1248
20200402,NY,92381,146584,,13383,20817,3396,,,,7434,764d0566c27be04c416c502640d5fffbcb8cad26,2020-04-02T20:00:00Z,2373,20817,238965,238965,238965,36,432,2449,9416,8669,18085
20200402,OH,2902,32016,,,802,,260,,,,9cb637113ec0c42f449d0e11e3fb945befdcb348,2020-04-02T20:00:00Z,81,802,34918,34918,34918,39,16,123,5024,355,5379
20200402,OK,879,1265,,182,257,144,,,,,5085d08567113dc9cd8b3fe10058c452e252bef7,2020-04-02T20:00:00Z,34,257,2144,2144,2144,40,4,38,17,160,177
20200402,OR,826,15259,,134,188,,,38,,,52a7aca8aaa9fe439cda2bd887a39b03c5c9dd41,2020-04-02T20:00:00Z,21,188,16085,16085,16085,41,3,34,2123,90,2213
20200402,PA,7016,47698,,,730,,,,,,0dc7935c18797a0f7616c41c364e159c12d62657,2020-04-02T20:00:00Z,90,730,54714,54714,54714,42,16,110,5271,1211,6482
20200402,PR,316,1604,1119,,,,,,,,2b9a9af18f7c56e17ab89f48b071e4c9afd668a9,2020-04-02T20:00:00Z,12,,3039,1920,1920,72,1,0,195,30,225
20200402,RI,657,4412,,72,,14,,6,,35,5534b1ed82ad8e56d32d7f50c21589687d7b1c1f,2020-04-02T20:00:00Z,12,,5069,5069,5069,44,2,0,581,91,672
20200402,SC,1554,5441,,,896,,,,,,0226337007d3996a9de9db3c450c9eae6f65f47d,2020-04-02T20:00:00Z,31,896,6995,6995,6995,45,5,547,408,261,669
20200402,SD,165,4217,0,,17,,,,,57,4503bb5ad5f51410838cf0a227b9d7ebeb19f745,2020-04-02T20:00:00Z,2,17,4382,4382,4382,46,0,5,314,36,350
20200402,TN,2845,31766,,,263,,,,,220,59629453e17df16d80dffa1ce35c5dcb1e94c5a2,2020-04-02T20:00:00Z,32,263,34611,34611,34611,47,8,63,1997,162,2159
20200402,TX,4669,46010,,196,,,,,,38,57c7248c663ba35f47dddb6ce04cf2c62d885de3,2020-04-02T20:00:00Z,70,,50679,50679,50679,48,12,0,2150,672,2822
20200402,UT,1074,20155,,,100,,,,,,ae818e14f015da994e59de550caffbe290355ea3,2020-04-02T20:00:00Z,7,100,21229,21229,21229,49,0,9,0,62,62
20200402,VA,1706,15883,,246,305,,145,,108,,9796a8ec0aabb4d2cffe52ed46445fae43bd50c6,2020-04-02T20:00:00Z,41,305,17589,17589,17589,51,7,0,2023,222,2245
20200402,VI,33,149,42,,,,,,,25,0361adbd93f9cc390d8b9459a98f69fdd89577c7,2020-04-02T20:00:00Z,,,224,182,182,78,0,0,23,3,26
20200402,VT,338,4711,,29,45,,,,,15,7510d18997abe87e7201c6841efcdf23546e72e3,2020-04-02T20:00:00Z,17,45,5049,5049,5049,50,1,0,537,17,554
20200402,WA,6893,86889,,,,,,,,,98715d027b85da34f5759ed8b27f3e2ce4f92d25,2020-04-02T20:00:00Z,310,,93782,93782,93782,53,28,0,4332,353,4685
20200402,WI,1730,20317,,,461,,,,,,834fc46c2905f903a94bd047bced3c8b65158dbe,2020-04-02T20:00:00Z,31,461,22047,22047,22047,55,7,63,1498,180,1678
20200402,WV,217,5276,,,1,,,,,,bf37a7e21c11c01b281839b088a20c114f1455eb,2020-04-02T20:00:00Z,2,1,5493,5493,5493,54,1,0,892,26,918
20200402,WY,150,2439,,,19,,,,,31,eb0c78de23230d157b8ec36ace867b3cb3657118,2020-04-02T20:00:00Z,0,19,2589,2589,2589,56,0,1,221,20,241
20200401,AK,133,4470,,,9,,,,,,28dfb9b2615a8df04f8c622ad2fb590a6f7da833,2020-04-01T20:00:00Z,3,9,4603,4603,4603,02,0,2,876,14,890
20200401,AL,1077,6697,,,,,,,,,9bd398e733a5ca5042bde1fd8ce2831fc248b0b1,2020-04-01T20:00:00Z,26,,7774,7774,7774,01,13,0,399,96,495
20200401,AR,584,7354,,56,90,,,25,32,42,eb0f33b592be1e182660fe530097a09b66431f2c,2020-04-01T20:00:00Z,10,90,7938,7938,7938,05,2,90,1395,61,1456
20200401,AS,0,3,2,,,,,,,,7474fa36854837781f641e06f111c2a7d8da13ac,2020-04-01T20:00:00Z,0,,5,3,3,60,0,0,0,0,0
20200401,AZ,1413,19645,,,,,,,,,d12f3f1c80a1844af89ea00e1077f5095cd54767,2020-04-01T20:00:00Z,29,,21058,21058,21058,04,5,0,1563,124,1687
20200401,CA,8155,21772,57400,1855,,774,,,,,36cc579cf1bdcc8118bbf943a1f3239abe7ce41b,2020-04-01T20:00:00Z,171,,87327,29927,29927,06,18,0,0,673,673
20200401,CO,2966,13883,,574,509,,,,,,8bf82f524a8c38e9ae041e7b6f92ab5b5e55426c,2020-04-01T20:00:00Z,69,509,16849,16849,16849,08,18,95,1146,339,1485
20200401,CT,3557,13043,,766,,,,,,,4a71572b502d2295cf11a95ae6bb803e6c0ac2eb,2020-04-01T20:00:00Z,85,,16600,16600,16600,09,16,0,14,429,443
20200401,DC,586,3262,2,,,,,,,142,8a7aef6408b5c008467ada52ef83bc9e47d8af28,2020-04-01T20:00:00Z,11,,3850,3848,3848,11,2,0,0,91,91
20200401,DE,368,4015,,51,,,,,,49,ff8626da96327ed24e907f8daedaf58b38fceca9,2020-04-01T20:00:00Z,11,,4383,4383,4383,10,1,0,319,49,368
20200401,FL,6955,59529,1235,,949,,,,,,d9a24f33db59e2a7276a3019ee2e37f41f9bfb06,2020-04-01T20:00:00Z,87,949,67719,66484,66484,12,10,126,5244,617,5861
20200401,GA,4638,15688,,,952,,,,,,d6147a1075561f5d68ac98a7cb4dedb3e75bcd4c,2020-04-01T20:00:00Z,139,952,20326,20326,20326,13,28,119,3436,709,4145
20200401,GU,77,406,,19,,2,,,,9,c96d716269ed8689ada87b505715996beb241cff,2020-04-01T20:00:00Z,3,,483,483,483,66,1,0,35,8,43
20200401,HI,208,8721,,,13,,6,,,58,46d6cbdc0fe52b7c89e99d61bc60c6ddb4a7ab6d,2020-04-01T20:00:00Z,1,13,8929,8929,8929,15,1,1,250,4,254
20200401,IA,549,7304,,63,99,,,,,118,c2d7f358dcc4c936b1651f06d65c5bd7ef3ab8a2,2020-04-01T20:00:00Z,9,99,7853,7853,7853,19,2,5,416,52,468
20200401,ID,525,6076,,,46,,7,,,,cc12e3fa599537f47fad0258e0009e6ef9fe0581,2020-04-01T20:00:00Z,9,46,6601,6601,6601,16,2,1,779,110,889
20200401,IL,6980,33404,,,,,,,,,026b984139faebf730612961db2541ecac874f45,2020-04-01T20:00:00Z,141,,40384,40384,40384,17,42,0,4173,986,5159
20200401,IN,2565,11810,,,,,,,,,fcc053001d98ddb6739b2610781931fbb476aac3,2020-04-01T20:00:00Z,65,,14375,14375,14375,18,16,0,596,406,1002
20200401,KS,482,5411,,,114,,,,,,d8abbc3a45478014e68bb1033ec072f19a68ec6a,2020-04-01T20:00:00Z,10,114,5893,5893,5893,20,1,35,415,54,469
20200401,KY,591,6965,,,,,,,,,d401a0f0702a3e7442668504f89d9bbf0fd9db08,2020-04-01T20:00:00Z,17,,7556,7556,7556,21,6,0,635,111,746
20200401,LA,6424,39352,,1498,,,,490,,,ac01fe3940d3352133ae344db486ff72f25cf244,2020-04-01T20:00:00Z,273,,45776,45776,45776,22,34,0,5622,1187,6809
20200401,MA,7639,44125,,,682,,,,,,e0407c3d9a8a7611958812ce2d32351e6d4eb48d,2020-04-01T20:00:00Z,187,682,51764,51764,51764,25,34,120,3685,1118,4803
20200401,MD,1985,17233,,,522,,,,,,37fdabd80821d81988b5e5a11005bbe7e3a77a5f,2020-04-01T20:00:00Z,31,522,19218,19218,19218,24,13,93,2365,325,2690
20200401,ME,344,6088,,,63,,,,,80,d31aa8304a5b094eb4d5598468a141d0f896f408,2020-04-01T20:00:00Z,7,63,6432,6432,6432,23,2,6,0,41,41
20200401,MI,12888,27237,,,,,,,,,0792f1570e8e7519be93e514a705700ec6daeb6d,2020-04-01T20:00:00Z,337,,40125,40125,40125,26,78,0,3258,1013,4271
20200401,MN,689,20502,,54,122,27,27,,,,f3620fcfc12dce927a8e2f46922b59df0e351756,2020-04-01T20:00:00Z,17,122,21191,21191,21191,27,5,10,1351,60,1411
20200401,MO,1581,15846,,,,,,,,,dc97aa93ab282b95a3c23db92cd5efdf0b46ac22,2020-04-01T20:00:00Z,18,,17427,17427,17427,29,4,0,1232,254,1486
20200401,MP,6,,,,,,,,,,5fb1a4bb5496638fbba1216c23902a9938e1eaac,2020-04-01T20:00:00Z,,,6,6,6,69,0,0,0,4,4
20200401,MS,1073,3712,,,332,,,,,,03c61b979c5d42a05f6620424c0f7090acc01647,2020-04-01T20:00:00Z,22,332,4785,4785,4785,28,2,121,175,136,311
20200401,MT,208,4710,,,17,,,,,,5c9460763670b2514d789493ad77a8e06dc8bcc2,2020-04-01T20:00:00Z,5,17,4918,4918,4918,30,1,3,476,24,500
20200401,NC,1584,24659,,204,,,,,,,70807abafbcbc2da31b4f44c7523196116df4f15,2020-04-01T20:00:00Z,10,,26243,26243,26243,37,2,0,3051,86,3137
20200401,ND,142,4351,,,23,,,,,34,d5fcb30b1ccee3f5ace04e24072d51272e7e9d5b,2020-04-01T20:00:00Z,3,23,4493,4493,4493,38,0,2,220,16,236
20200401,NE,210,3475,8,,,,,,,,a736e9df99d379949dec4b420b4fe03c5a5b32b4,2020-04-01T20:00:00Z,4,,3693,3685,3685,31,1,0,544,38,582
20200401,NH,415,5985,97,,56,,,,,56,0a1a84677bbb59edf20b69ca4a71ad7f70bae202,2020-04-01T20:00:00Z,4,56,6497,6400,6400,33,1,11,572,101,673
20200401,NJ,22255,30387,,2000,,,,,,,970ca703cb183143daa9b6b3cb9b5b95746de860,2020-04-01T20:00:00Z,355,,52642,52642,52642,34,88,0,3310,3559,6869
20200401,NM,315,12925,,24,,,,,,26,3beefaa3bff9114ea2bf131529a2f0e13eecd129,2020-04-01T20:00:00Z,5,,13240,13240,13240,35,1,0,679,34,713
20200401,NV,1279,11519,,,,,,,,,99ca8c448bcd3a57ffe6454db6a4b2533447a96b,2020-04-01T20:00:00Z,26,,12798,12798,12798,32,9,0,838,166,1004
20200401,NY,83712,137168,,12226,18368,3022,,,,6142,0b906bb4c9631eecca95b6183d50bee067b4bbc2,2020-04-01T20:00:00Z,1941,18368,220880,220880,220880,36,391,2464,7777,7917,15694
20200401,OH,2547,26992,,,679,,222,,,,9742acfe1c987695868db136a9cc02a8e558dc7d,2020-04-01T20:00:00Z,65,679,29539,29539,29539,39,10,94,0,348,348
20200401,OK,719,1248,,174,219,98,,,,,857cacccae911c7d1d0003cb7fc05aa82d7ac1f1,2020-04-01T20:00:00Z,30,219,1967,1967,1967,40,7,42,19,154,173
20200401,OR,736,13136,,132,154,,,40,,,1f1edcb802acf42ba4967cdfed4f48c270347c97,2020-04-01T20:00:00Z,18,154,13872,13872,13872,41,0,0,0,46,46
20200401,PA,5805,42427,,,620,,,,,,575ea7e224d4f1f6797bed8fe0a7902daad3ffab,2020-04-01T20:00:00Z,74,620,48232,48232,48232,42,11,106,4782,962,5744
20200401,PR,286,1409,897,,,,,,,,ae0129f382eb5f04d790633ebc4cfb9e7e00f89a,2020-04-01T20:00:00Z,11,,2592,1695,1695,72,3,0,214,47,261
20200401,RI,566,3831,,60,,14,,6,,35,d6bd45c8f92d8d9e8b397cf13b291acb33c74944,2020-04-01T20:00:00Z,10,,4397,4397,4397,44,2,0,355,77,432
20200401,SC,1293,5033,,,349,,,,,,a321818d113ea1e8063433667ca10f117f264d11,2020-04-01T20:00:00Z,26,349,6326,6326,6326,45,4,90,417,210,627
20200401,SD,129,3903,0,,12,,,,,51,321e6948f2b0f05bf9e515252aed1d4ec4873a57,2020-04-01T20:00:00Z,2,12,4032,4032,4032,46,1,0,294,21,315
20200401,TN,2683,29769,,,200,,,,,137,9e9bb3593287cbf3b938263422d21dba45a771e1,2020-04-01T20:00:00Z,24,200,32452,32452,32452,47,1,25,4648,444,5092
20200401,TX,3997,43860,,196,,,,,,38,acd01e7eaf0e46a8473dd525c35a0c4fecbeca15,2020-04-01T20:00:00Z,58,,47857,47857,47857,48,17,0,4134,731,4865
20200401,UT,1012,20155,,,91,,,,,,3060e79ad1d88a94c41b61754e101f096b677716,2020-04-01T20:00:00Z,7,91,21167,21167,21167,49,2,18,2529,125,2654
20200401,VA,1484,13860,,,305,,145,,108,,3978f9b311c4141c1b8cab5ace841ef8bff698d3,2020-04-01T20:00:00Z,34,305,15344,15344,15344,51,7,140,1709,234,1943
20200401,VI,30,126,24,,,,,,,21,a7b58dc10565c19782a05701feaed42d38a8fb8e,2020-04-01T20:00:00Z,,,180,156,156,78,0,0,0,0,0
20200401,VT,321,4174,,30,45,,,,,15,09d62e8a97e7673d2cb199f97cefebe931639672,2020-04-01T20:00:00Z,16,45,4495,4495,4495,50,3,9,217,28,245
20200401,WA,6540,82557,,,,,,,,,c1c4710b66a9354f608a3668ef129a8dfecd7ba8,2020-04-01T20:00:00Z,282,,89097,89097,89097,53,20,0,4173,491,4664
20200401,WI,1550,18819,,,398,,,,,,3a304dc1edaaf3c59465b033f7b4aa76ad3dec32,2020-04-01T20:00:00Z,24,398,20369,20369,20369,55,8,61,1444,199,1643
20200401,WV,191,4384,,,1,,,,,,264082faaa6983c76d88bf13c4444943677bfd72,2020-04-01T20:00:00Z,1,1,4575,4575,4575,54,0,0,403,29,432
20200401,WY,130,2218,,,18,,,,,31,a5690ff900709e2e51e09c47b186c26c6bb7d126,2020-04-01T20:00:00Z,0,18,2348,2348,2348,56,0,1,219,21,240
20200331,AK,119,3594,,,7,,,,,,5ec8d7c9ede0e8d30b6f7b63be047ac0ead0b49b,2020-03-31T20:00:00Z,3,7,3713,3713,3713,02,0,0,54,5,59
20200331,AL,981,6298,,,,,,,,,42eecba7755e229592355c2a117a0c76245f655a,2020-03-31T20:00:00Z,13,,7279,7279,7279,01,7,0,604,122,726
20200331,AR,523,5959,,64,,,,23,,35,a9c9435748295307c8030289e3bbb22dbb61466f,2020-03-31T20:00:00Z,8,,6482,6482,6482,05,1,0,697,50,747
20200331,AS,0,3,2,,,,,,,,1c73590ddf391630382d8064191c344bc8195a3c,2020-03-31T20:00:00Z,0,,5,3,3,60,0,0,3,0,3
20200331,AZ,1289,18082,,,,,,,,,86a252a1dfcd2659cd4bebccacb9f93428dec0ce,2020-03-31T20:00:00Z,24,,19371,19371,19371,04,4,0,2480,132,2612
20200331,CA,7482,21772,57400,1617,,657,,,,,0d1f030c44db79d66aaebbed5cbc3c295b2838fe,2020-03-31T20:00:00Z,153,,86654,29254,29254,06,20,0,1223,1035,2258
20200331,CO,2627,12737,,503,414,,,,,,0736bc2e6ddb8489ecafa706a29941301edb7d9f,2020-03-31T20:00:00Z,51,414,15364,15364,15364,08,0,0,0,0,0
20200331,CT,3128,13029,,608,,,,,,,1dbf8c0e8e39af7461e15fb8855c64efc447b563,2020-03-31T20:00:00Z,69,,16157,16157,16157,09,33,0,1000,557,1557
20200331,DC,495,3262,2,,,,,,,121,5434bf0aabd9cdefb5f6ade62555f66bf0231f65,2020-03-31T20:00:00Z,9,,3759,3757,3757,11,0,0,580,94,674
20200331,DE,319,3696,,57,,,,,,22,2a0658af704fddd0065e7d3e957e71bf99c9f435,2020-03-31T20:00:00Z,10,,4015,4015,4015,10,4,0,1480,55,1535
20200331,FL,6338,54285,1163,,823,,,,,,c0d094c60a3352b108e4b759b45b066bd56cc068,2020-03-31T20:00:00Z,77,823,61786,60623,60623,12,14,171,6060,865,6925
20200331,GA,3929,12252,,,833,,,,,,59e2183e84ee35f0e1c3432ef7380d6b2ba4f740,2020-03-31T20:00:00Z,111,833,16181,16181,16181,13,24,126,2337,1120,3457
20200331,GU,69,371,,19,,2,,,,7,9bc093e770b32b248bc697d62d378eb33af1c668,2020-03-31T20:00:00Z,2,,440,440,440,66,1,0,19,11,30
20200331,HI,204,8471,,,12,,6,,,49,655f60069fde91c6736a5f66d52dbd65ea100e33,2020-03-31T20:00:00Z,,12,8675,8675,8675,15,0,0,646,29,675
20200331,IA,497,6888,,61,94,,,,,33,4ec1acfc172943306bb03e7153d7f1958591191d,2020-03-31T20:00:00Z,7,94,7385,7385,7385,19,1,20,726,73,799
20200331,ID,415,5297,,,45,,6,,,,6f7851470fbaf9166e84cbeb782d870ec1bbb384,2020-03-31T20:00:00Z,7,45,5712,5712,5712,16,1,6,901,105,1006
20200331,IL,5994,29231,,,,,,,,,979983c53f3fef1cf573ae3a61de7f9166197b17,2020-03-31T20:00:00Z,99,,35225,35225,35225,17,26,0,3842,937,4779
20200331,IN,2159,11214,,,,,,,,,76b4fbd00067fbb532bb2d0c63800ffa814d75c9,2020-03-31T20:00:00Z,49,,13373,13373,13373,18,14,0,1342,373,1715
20200331,KS,428,4996,,,79,,,,,,12716e5b136e60836429eab2bb08477c7ca6d529,2020-03-31T20:00:00Z,9,79,5424,5424,5424,20,1,13,442,60,502
20200331,KY,480,6330,,,,,,,,,37e85814eaa2e8744faaf12a5995d3a1d5958614,2020-03-31T20:00:00Z,11,,6810,6810,6810,21,2,0,751,41,792
20200331,LA,5237,33730,,1355,,,,438,,,cb012c368afcbcc2ef27ae4c8341f028b6d69381,2020-03-31T20:00:00Z,239,,38967,38967,38967,22,54,0,3722,1212,4934
20200331,MA,6521,40440,,,562,,,,,,edc9ca27a7dec072cc2db7a972f1c6d098e59e10,2020-03-31T20:00:00Z,153,562,46961,46961,46961,25,29,109,3274,868,4142
20200331,MD,1660,14868,,,429,,,,,,d7bfec3c323983994ff111c9de7dc7addc251550,2020-03-31T20:00:00Z,18,429,16528,16528,16528,24,3,76,1552,247,1799
20200331,ME,303,6088,,,57,,,,,68,9a8dc48e67c43030905fcae8d51b29844ca227ad,2020-03-31T20:00:00Z,5,57,6391,6391,6391,23,2,8,2694,28,2722
20200331,MI,11875,23979,,,,,,,,,ab147c05b259014d46b9027e65d44d7d12f869f2,2020-03-31T20:00:00Z,259,,35854,35854,35854,26,75,0,2796,974,3770
20200331,MN,629,19151,,56,112,26,26,,,,cb5ae95ed3bb94c2e6a93343b3be56544a28c7e0,2020-03-31T20:00:00Z,12,112,19780,19780,19780,27,2,20,905,53,958
20200331,MO,1327,14614,,,,,,,,,4fc56f79bf2224a97947093ebb74ae8bf0a5c36f,2020-03-31T20:00:00Z,14,,15941,15941,15941,29,1,0,1410,296,1706
20200331,MP,2,,,,,,,,,,ffa5f54a292f871515c1817ce333527b48f76d79,2020-03-31T20:00:00Z,,,2,2,2,69,0,0,0,0,0
20200331,MS,937,3537,,,211,,,,,,b44e85184d9a95e733dd5b77766d46986a09876a,2020-03-31T20:00:00Z,20,211,4474,4474,4474,28,4,16,548,90,638
20200331,MT,184,4234,,,14,,,,,,501a4ed165fe9f891b45ef2af4b82b23f264ef3a,2020-03-31T20:00:00Z,4,14,4418,4418,4418,30,0,4,91,13,104
20200331,NC,1498,21608,,157,,,,,,,d94d3c30bef4275e3636d15317c59e0091ab2e9e,2020-03-31T20:00:00Z,8,,23106,23106,23106,37,2,0,2051,191,2242
20200331,ND,126,4131,,,21,,,,,30,165f85808067a5516ef0cffab5966fd74ac37fd3,2020-03-31T20:00:00Z,3,21,4257,4257,4257,38,1,2,403,17,420
20200331,NE,172,2931,8,,,,,,,,b3674a50a3d04771860eca37b3917ee82b88fbba,2020-03-31T20:00:00Z,3,,3111,3103,3103,31,1,0,347,27,374
20200331,NH,314,5413,65,,45,,,,,,68bb996e94c06de538bf71b4b97068a9acae4c3f,2020-03-31T20:00:00Z,3,45,5792,5727,5727,33,0,0,27,0,27
20200331,NJ,18696,27077,,2000,,,,,,,407885b56f3b2687f57779a9981c027b0ebd092d,2020-03-31T20:00:00Z,267,,45773,45773,45773,34,69,0,1853,2060,3913
20200331,NM,281,12246,,22,,,,,,26,9318d0f9b076da040387faac6c578323bf64ae5b,2020-03-31T20:00:00Z,4,,12527,12527,12527,35,2,0,1304,44,1348
20200331,NV,1113,10681,,,,,,,,,75bc5c5fe829f18065e4706cf35ef2994fb69f7b,2020-03-31T20:00:00Z,17,,11794,11794,11794,32,2,0,474,105,579
20200331,NY,75795,129391,,10929,15904,2710,,,,4975,b82085af96dba94baabf7e0b7cf6e7b539cce21b,2020-03-31T20:00:00Z,1550,15904,205186,205186,205186,36,332,2183,9420,9298,18718
20200331,OH,2199,26992,,,585,,198,,,,10fe4fc7d3c11a63cedf85d22ac82fcbee137d99,2020-03-31T20:00:00Z,55,585,29191,29191,29191,39,16,110,1650,266,1916
20200331,OK,565,1229,,,177,83,,,,,519df67e7bc7167c52872bf04f91fcbcabb2b786,2020-03-31T20:00:00Z,23,177,1794,1794,1794,40,6,24,22,84,106
20200331,OR,690,13136,,132,154,,,40,,,75deaaf7ba4817dfbf64577e2466eee6fd6d5a5b,2020-03-31T20:00:00Z,18,154,13826,13826,13826,41,2,14,859,84,943
20200331,PA,4843,37645,,,514,,,,,,f2ddb226108bf8650a4c9d6b6394ff9083e3adbc,2020-03-31T20:00:00Z,63,514,42488,42488,42488,42,14,128,3868,756,4624
20200331,PR,239,1195,854,,,,,,,,78117516d9037f5282375c81906d6c029a53bf68,2020-03-31T20:00:00Z,8,,2288,1434,1434,72,2,0,264,65,329
20200331,RI,489,3476,,59,,9,,6,,35,bf796f9edfb484dec716499b5f5cc3d2391f2b6a,2020-03-31T20:00:00Z,8,,3965,3965,3965,44,4,0,289,87,376
20200331,SC,1083,4616,,,259,,,,,,34a657bc2def360f99f18a1a872eae0f3b37583b,2020-03-31T20:00:00Z,22,259,5699,5699,5699,45,4,130,456,158,614
20200331,SD,108,3609,0,,12,,,,,44,1dfa391214d591fb4af733f72b7006016c4f3309,2020-03-31T20:00:00Z,1,12,3717,3717,3717,46,0,12,131,7,138
20200331,TN,2239,25121,,,175,,,,,121,8b236550ae5ec5e539ddcd63854658d0193987d2,2020-03-31T20:00:00Z,23,175,27360,27360,27360,47,10,27,3651,405,4056
20200331,TX,3266,39726,,196,,,,,,38,9566b8b35846c815aa661bd2eff724a717eb8062,2020-03-31T20:00:00Z,41,,42992,42992,42992,48,7,0,6723,389,7112
20200331,UT,887,17626,,,73,,,,,,df48bc20a6b94395ef809b6483a81ac976f07c72,2020-03-31T20:00:00Z,5,73,18513,18513,18513,49,1,73,2429,81,2510
20200331,VA,1250,12151,,,165,,,,,,94c6ced5cbd2d7474ef25844e4f1c69d185328b8,2020-03-31T20:00:00Z,27,165,13401,13401,13401,51,2,29,1133,230,1363
20200331,VI,30,126,24,,,,,,,21,aa85d4eb0661c567f1f2843ad6583c65fa67411e,2020-03-31T20:00:00Z,,,180,156,156,78,0,0,0,0,0
20200331,VT,293,3957,,21,36,,,,,15,f7ff1c5b387b478086752b2ba379a2aaab0bf9fd,2020-03-31T20:00:00Z,13,36,4250,4250,4250,50,1,18,283,37,320
20200331,WA,6049,78384,,,,,,,,,5fa102007f07e51ccd432c033a2b5cdc28e5419c,2020-03-31T20:00:00Z,262,,84433,84433,84433,53,14,0,4126,460,4586
20200331,WI,1351,17375,,,337,,,,,,5743ca4c966b5e5a927d00d404c31fbb7cc91341,2020-03-31T20:00:00Z,16,337,18726,18726,18726,55,2,337,1519,130,1649
20200331,WV,162,3981,,,1,,,,,,8e2d2b08f0436cdcaf61239f004ddbef807c2a89,2020-03-31T20:00:00Z,1,1,4143,4143,4143,54,0,0,997,36,1033
20200331,WY,109,1999,,,17,,,,,26,56481c095ddf7e629ed8e0a3c0eedf3ce33180f7,2020-03-31T20:00:00Z,0,17,2108,2108,2108,56,0,0,159,15,174
20200330,AK,114,3540,,,7,,,,,,98553897a21c05aeec18d5391001f5bdb25eb44e,2020-03-30T20:00:00Z,3,7,3654,3654,3654,02,1,1,308,12,320
20200330,AL,859,5694,,,,,,,,,4552863c924f79edb83615e6b3642696b80a83cf,2020-03-30T20:00:00Z,6,,6553,6553,6553,01,2,0,1510,53,1563
20200330,AR,473,5262,,62,,,,21,,29,0ec0c0c3df52146a28574929923168f0a9b419c9,2020-03-30T20:00:00Z,7,,5735,5735,5735,05,1,0,2235,47,2282
20200330,AS,,,,,,,,,,,016909ef598616403b32e8c8d61b26a0498b9bfb,2020-03-30T20:00:00Z,0,,0,0,0,60,0,0,0,0,0
20200330,AZ,1157,15602,,,,,,,,,22b1a4b417a7dc39db4d03f7a24e514e1624d7db,2020-03-30T20:00:00Z,20,,16759,16759,16759,04,3,0,2649,238,2887
20200330,CA,6447,20549,64400,1432,,597,,,,,a5728b6db27be0a303e8c2270385ec0c71bc63e8,2020-03-30T20:00:00Z,133,,91396,26996,26996,06,10,0,0,739,739
20200330,CO,2627,12737,,358,414,,,,,,5f4dd92269e69d023f8567062d1b845e6bdf8b17,2020-03-30T20:00:00Z,51,414,15364,15364,15364,08,7,140,1522,566,2088
20200330,CT,2571,12029,,517,,,,,,,70eb03d4fcfe461e62251eef8272509a3f9f5a7d,2020-03-30T20:00:00Z,36,,14600,14600,14600,09,2,0,2122,578,2700
20200330,DC,401,2682,2,,,,,,,106,ce7ca86d5bbfbde3f47a32e8e6d830701114a95e,2020-03-30T20:00:00Z,9,,3085,3083,3083,11,4,0,213,59,272
20200330,DE,264,2216,,45,,,,,,9,b9ca4ef7d7d27f1040cc1a3b2a77a6d9d1b87193,2020-03-30T20:00:00Z,6,,2480,2480,2480,10,0,0,2180,32,2212
20200330,FL,5473,48225,,,652,,,,,,9a3e8154ce0eca0c63b55151a437a020a79406e3,2020-03-30T20:00:00Z,63,652,53698,53698,53698,12,7,58,9155,1227,10382
20200330,GA,2809,9915,,,707,,,,,,25ceba85ecebfa065b3994c5a0511a721902a2a5,2020-03-30T20:00:00Z,87,707,12724,12724,12724,13,7,41,2,158,160
20200330,GU,58,352,,19,,2,,,,7,325e44bac3252c9555fc2ae45206f278b4c9a474,2020-03-30T20:00:00Z,1,,410,410,410,66,0,0,18,2,20
20200330,HI,175,7825,,,12,,,,,,399f627e033b6cacfd3f76187089f3f5f49d5462,2020-03-30T20:00:00Z,,12,8000,8000,8000,15,0,0,976,24,1000
20200330,IA,424,6162,,51,74,,,,,23,bb8559f53afd6bd1498d5d61c82adc745f314b7d,2020-03-30T20:00:00Z,6,74,6586,6586,6586,19,2,6,1149,88,1237
20200330,ID,310,4396,,,39,,,,,,7199499861b27b9737de62f8b6fcccfd09b03ad8,2020-03-30T20:00:00Z,6,39,4706,4706,4706,16,1,3,375,49,424
20200330,IL,5057,25389,,,,,,,,,49eda929cdc14ecc7beeaffc5a03863b651175f5,2020-03-30T20:00:00Z,73,,30446,30446,30446,17,8,0,2223,461,2684
20200330,IN,1786,9872,,,,,,,,,1eb08f6c84c1646c1611f46dfcb77c86a50479fc,2020-03-30T20:00:00Z,35,,11658,11658,11658,18,3,0,1556,272,1828
20200330,KS,368,4554,,,66,,,,,,740551d80bb24aabc7ddbc519fc876c31ec53920,2020-03-30T20:00:00Z,8,66,4922,4922,4922,20,2,11,360,49,409
20200330,KY,439,5579,,,,,,,,,e683db18146f3c70866e5138f7c84f76f04bc09a,2020-03-30T20:00:00Z,9,,6018,6018,6018,21,0,0,432,45,477
20200330,LA,4025,30008,,1185,,,,385,,,06ff7ea1f0e4cc7ea2a7b1d27e4e0ae275c5a43e,2020-03-30T20:00:00Z,185,,34033,34033,34033,22,34,0,5677,485,6162
20200330,MA,5653,37166,,,453,,,,,,76b01afaf13af34dca1ffaffa88c696ca0edb7af,2020-03-30T20:00:00Z,124,453,42819,42819,42819,25,25,54,2932,797,3729
20200330,MD,1413,13316,,,353,,,,,,ea51bd505bfb1c35306ee4e4b22abdad5d2820d8,2020-03-30T20:00:00Z,15,353,14729,14729,14729,24,5,76,962,174,1136
20200330,ME,275,3394,,,49,,,,,41,fe7606d23c550ea474d64f9540019641a5da2680,2020-03-30T20:00:00Z,3,49,3669,3669,3669,23,0,49,0,22,22
20200330,MI,10901,21183,,,,,,,,,2ceff9e794b8c31ee7d7191153cdbcfdae09ba51,2020-03-30T20:00:00Z,184,,32084,32084,32084,26,52,0,5507,891,6398
20200330,MN,576,18246,,56,92,24,24,,,,f4fd6f4736f788b58399563a48e0a4a14c120ff4,2020-03-30T20:00:00Z,10,92,18822,18822,18822,27,1,17,1092,73,1165
20200330,MO,1031,13204,,,,,,,,,932b312edc6f1709cc6feaa4afd9e492c17be555,2020-03-30T20:00:00Z,13,,14235,14235,14235,29,3,0,1657,193,1850
20200330,MP,2,,,,,,,,,,330007cfa03e74e1da2c74b8b75a41f075ed1f10,2020-03-30T20:00:00Z,,,2,2,2,69,0,0,0,0,0
20200330,MS,847,2989,,,195,,,,,,306cc9d00ab15c39bbba409f447156bbece99bfe,2020-03-30T20:00:00Z,16,195,3836,3836,3836,28,2,-40,429,89,518
20200330,MT,171,4143,,,10,,,,,,40066be19c800ef5911207f9d482f8ef230d6a60,2020-03-30T20:00:00Z,4,10,4314,4314,4314,30,3,2,0,17,17
20200330,NC,1307,19557,,137,,,,,,,4a55f1f47fc6384a52875c590477c7ebd61c8a40,2020-03-30T20:00:00Z,6,,20864,20864,20864,37,2,0,1652,267,1919
20200330,ND,109,3728,,,19,,,,,19,68a3b5338b8b1424629db87b97ecbd0c347d7317,2020-03-30T20:00:00Z,2,19,3837,3837,3837,38,1,2,373,11,384
20200330,NE,145,2584,5,,,,,,,,088432e8d55e51cb7eaba7eba13d364259f8842c,2020-03-30T20:00:00Z,2,,2734,2729,2729,31,0,0,616,37,653
20200330,NH,314,5386,144,,45,,,,,,09deb0331b52dd98962c90342290df5b9d20b889,2020-03-30T20:00:00Z,3,45,5844,5700,5700,33,1,12,862,100,962
20200330,NJ,16636,25224,,2000,,,,,,,f214c15223ba6282835a9b067f69ac4f17a2ed28,2020-03-30T20:00:00Z,198,,41860,41860,41860,34,37,0,3008,3250,6258
20200330,NM,237,10942,,22,,,,,,26,056758cf1a3b84770e2b01cb509251b9de1724c4,2020-03-30T20:00:00Z,2,,11179,11179,11179,35,0,0,173,0,173
20200330,NV,1008,10207,,,,,,,,,34628b797fa0cbc9196833ea89dc685929e71e86,2020-03-30T20:00:00Z,15,,11215,11215,11215,32,1,0,1795,270,2065
20200330,NY,66497,119971,,9517,13721,2352,,,,4204,8ff11bd6ca3432e7960be3f3c82d4cfd0f320843,2020-03-30T20:00:00Z,1218,13721,186468,186468,186468,36,253,1646,7124,6984,14108
20200330,OH,1933,25342,,,475,,163,,,,71bcd417ea0891e655685ed3f8422e79a59f4ba8,2020-03-30T20:00:00Z,39,475,27275,27275,27275,39,10,72,6330,280,6610
20200330,OK,481,1207,,,153,103,,,,,b47be4f15b256548273890888c642d0090fa49de,2020-03-30T20:00:00Z,17,153,1688,1688,1688,40,1,13,2,52,54
20200330,OR,606,12277,,132,140,,,39,,,5ebeddaa7dd640814bb167d138ece738953fc2fc,2020-03-30T20:00:00Z,16,140,12883,12883,12883,41,3,11,1399,58,1457
20200330,PA,4087,33777,,,386,,,,,,cac05153a6de7331306734979416c0bbbca4be85,2020-03-30T20:00:00Z,49,386,37864,37864,37864,42,11,33,3716,693,4409
20200330,PR,174,931,794,,,,,,,,fd89d6c3b101b8f486f201f326442d416bfd4a2d,2020-03-30T20:00:00Z,6,,1899,1105,1105,72,1,0,90,47,137
20200330,RI,402,3187,,41,,9,,6,,,8f178ec7116e1893386a3222bf829388d99b7499,2020-03-30T20:00:00Z,4,,3589,3589,3589,44,1,0,347,108,455
20200330,SC,925,4160,,,129,,,,,,ceb9937dd126bead37bfbbd92bde9286cf955c64,2020-03-30T20:00:00Z,18,129,5085,5085,5085,45,2,0,1145,151,1296
20200330,SD,101,3478,0,,,,,,,34,0bb03d9210c26f22f5301e7d3d05499e38494ffb,2020-03-30T20:00:00Z,1,,3579,3579,3579,46,0,0,351,11,362
20200330,TN,1834,21470,,,148,,,,,,ec22bf9d70375a31624ca8e4f9483a01aac06b52,2020-03-30T20:00:00Z,13,148,23304,23304,23304,47,6,15,2433,297,2730
20200330,TX,2877,33003,,,,,,,,38,97f0dea6f50c349bb0a5bb31afde8cf9ad5ffcf8,2020-03-30T20:00:00Z,34,,35880,35880,35880,48,0,0,9795,325,10120
20200330,UT,806,15197,,,,,,,,,9c05aaa04b932a442629dc78d9f4015fc3648184,2020-03-30T20:00:00Z,4,,16003,16003,16003,49,2,0,1923,87,2010
20200330,VA,1020,11018,,,136,,,,,,1b814b67e1fc83c5f9fdc2e3ca2dc1e7d1fa66d7,2020-03-30T20:00:00Z,25,136,12038,12038,12038,51,3,24,1299,130,1429
20200330,VI,30,126,24,,,,,,,,b32a1c0cf911b225e766bdbf0fd0890dc047acdc,2020-03-30T20:00:00Z,,,180,156,156,78,0,0,3,7,10
20200330,VT,256,3674,,,18,,,,,,707ea7e30f8939272fe9b6691b379a0385237953,2020-03-30T20:00:00Z,12,18,3930,3930,3930,50,0,0,208,21,229
20200330,WA,5589,74258,,,,,,,,,0bdb4dd5cc66a3ff7c14b1b3380abeeec0ebf559,2020-03-30T20:00:00Z,248,,79847,79847,79847,53,11,0,4470,468,4938
20200330,WI,1221,15856,,,,,,,,,23dce446b3a30d5d3dda0c1c88c909196d75aaab,2020-03-30T20:00:00Z,14,,17077,17077,17077,55,1,0,-694,109,-585
20200330,WV,126,2984,0,,1,,,,,,ce4f1662c7da92e2834a2a7b3bfdc61882f80794,2020-03-30T20:00:00Z,1,1,3110,3110,3110,54,1,0,279,13,292
20200330,WY,94,1840,,,17,,,,,24,d063fc044d9f24bbc91ef6e673e1bc6e0a0b4e4b,2020-03-30T20:00:00Z,0,17,1934,1934,1934,56,0,2,286,8,294
20200329,AK,102,3232,,,6,,,,,,422bc4f921be7a7ead06e6f738314ef1911a8407,2020-03-29T20:00:00Z,2,6,3334,3334,3334,02,0,1,396,17,413
20200329,AL,806,4184,,,,,,,,,0c2a7ece10172b9bd60b53579fd6d9a53f5e9f03,2020-03-29T20:00:00Z,4,,4990,4990,4990,01,1,0,0,110,110
20200329,AR,426,3027,,43,,,,16,,28,b731e778cec28ea92d5307e74b6774e3a1f19f81,2020-03-29T20:00:00Z,6,,3453,3453,3453,05,1,0,89,22,111
20200329,AS,,,,,,,,,,,b71912eee827fe10f806cb56123974239fa7b3d5,2020-03-29T20:00:00Z,0,,0,0,0,60,0,0,0,0,0
20200329,AZ,919,12953,,,,,,,,,467d5839bc5cfabb09479bd53472842bf24f4f43,2020-03-29T20:00:00Z,17,,13872,13872,13872,04,2,0,5498,46,5544
20200329,CA,5708,20549,64400,1034,,410,,,,,21f0bf97cbd1f715f37780ee6f00cdb4442ffebb,2020-03-29T20:00:00Z,123,,90657,26257,26257,06,22,0,0,1065,1065
20200329,CO,2061,11215,,332,274,,,,,,095a08fb57b9e544ba799a68a2e34bb2e95b8189,2020-03-29T20:00:00Z,44,274,13276,13276,13276,08,13,35,1273,327,1600
20200329,CT,1993,9907,,404,,,,,,,029989758f7a0426df84362ece8d2fe9fc5e34a8,2020-03-29T20:00:00Z,34,,11900,11900,11900,09,7,0,2798,702,3500
20200329,DC,342,2469,1,,,,,,,66,4781282de2140f0f63dcd581d9f45c684bf3fb32,2020-03-29T20:00:00Z,5,,2812,2811,2811,11,1,0,258,38,296
20200329,DE,232,36,,33,,,,,,9,f501e8507f242da253b2646cb974edc30bc67370,2020-03-29T20:00:00Z,6,,268,268,268,10,3,0,0,18,18
20200329,FL,4246,39070,,,594,,,,,,39553e3ec095e3143e776031465d2e90ade6c787,2020-03-29T20:00:00Z,56,594,43316,43316,43316,12,2,68,3704,483,4187
20200329,GA,2651,9913,,,666,,,,,,8fd5124a5d60c405bdada62747c232a41e2f9111,2020-03-29T20:00:00Z,80,666,12564,12564,12564,13,11,49,1228,285,1513
20200329,GU,56,334,,15,,,,,,7,b2cb617f4bd3a7be5db2e39016e92ab8bf2f1efb,2020-03-29T20:00:00Z,1,,390,390,390,66,0,0,35,1,36
20200329,HI,151,6849,,,12,,,,,,840860ca961633c9010ff0a1373e16b2d9146a30,2020-03-29T20:00:00Z,,12,7000,7000,7000,15,0,4,2492,31,2523
20200329,IA,336,5013,,51,68,,,,,17,0390f1a7c97c62a24050e5d9ebac698026cb1467,2020-03-29T20:00:00Z,4,68,5349,5349,5349,19,1,7,638,38,676
20200329,ID,261,4021,,,36,,,,,,8979502556f020e81fc4c2989d1a752bf6e3068d,2020-03-29T20:00:00Z,5,36,4282,4282,4282,16,1,11,679,31,710
20200329,IL,4596,23166,,,,,,,,,bd7639325f1e033630241a08bc0e4cfebae48436,2020-03-29T20:00:00Z,65,,27762,27762,27762,17,18,0,1166,1105,2271
20200329,IN,1514,8316,,,,,,,,,7218f7ee5dcf63b69f6d3a8be6ab8404ecd588c4,2020-03-29T20:00:00Z,32,,9830,9830,9830,18,1,0,1141,282,1423
20200329,KS,319,4194,,,55,,,,,,5bcb9dae92d0bbe8c3b18551ded266dd24876d38,2020-03-29T20:00:00Z,6,55,4513,4513,4513,20,1,28,523,58,581
20200329,KY,394,5147,,,,,,,,,466fb0bcb56c8e91014554ef6a8818029299ecfd,2020-03-29T20:00:00Z,9,,5541,5541,5541,21,1,0,326,92,418
20200329,LA,3540,24331,,1127,,,,380,,,540faf48376478e6345cb140616c5c5ad0fe45c5,2020-03-29T20:00:00Z,151,,27871,27871,27871,22,14,0,2485,225,2710
20200329,MA,4856,34234,,,399,,,,,,b127c22a4312099cceb9130d399ddd84b5c5bbf7,2020-03-29T20:00:00Z,99,399,39090,39090,39090,25,27,49,3319,698,4017
20200329,MD,1239,12354,,,277,,,,,,43e502f79bd427c342c79c2281412b86f1c174e1,2020-03-29T20:00:00Z,10,277,13593,13593,13593,24,5,51,838,247,1085
20200329,ME,253,3394,,,,,,,,41,1f1feafef96ccfc55b84c7fc1ec38625fc276029,2020-03-29T20:00:00Z,3,,3647,3647,3647,23,2,0,0,42,42
20200329,MI,10010,15676,,,,,,,,,78103abcede4de100cefa054c696ba6ad96716cf,2020-03-29T20:00:00Z,132,,25686,25686,25686,26,40,0,1493,723,2216
20200329,MN,503,17154,,39,75,,17,,,252,74247593bee28b5b049c8db9e1db79859e9d48fb,2020-03-29T20:00:00Z,9,75,17657,17657,17657,27,4,18,1466,62,1528
20200329,MO,838,11547,,,,,,,,,c9427dccdae92e441cee6fbb2787ea3a231dc686,2020-03-29T20:00:00Z,10,,12385,12385,12385,29,0,0,1465,0,1465
20200329,MP,2,,,,,,,,,,80c72d24c28e3245151244a3e59d6ee9fe9a391b,2020-03-29T20:00:00Z,,,2,2,2,69,0,0,0,0,0
20200329,MS,758,2560,,,235,,,,,,7e0258b174e76d4043c8b6164aa265e2ea9b1f53,2020-03-29T20:00:00Z,14,235,3318,3318,3318,28,1,16,0,95,95
20200329,MT,154,4143,,,8,,,,,,8e59ae6eb967f41c99ed548a2cd1a8e66fafb8e1,2020-03-29T20:00:00Z,1,8,4297,4297,4297,30,0,1,887,25,912
20200329,NC,1040,17905,,91,,,,,,,48107df93e16171dfd6faf7dbaf698bb19af8b2c,2020-03-29T20:00:00Z,4,,18945,18945,18945,37,0,0,1313,105,1418
20200329,ND,98,3355,,,17,,,,,18,9ea37c7842380c19726ed92b58103490a1d7de53,2020-03-29T20:00:00Z,1,17,3453,3453,3453,38,0,1,546,15,561
20200329,NE,108,1968,4,,,,,,,,a91fc8b0c0abec3ecc573422316a5421f9afd0ed,2020-03-29T20:00:00Z,2,,2080,2076,2076,31,0,0,64,12,76
20200329,NH,214,4524,285,,33,,,,,,0802aecb450515b575cf19e88b8b137764d666dc,2020-03-29T20:00:00Z,2,33,5023,4738,4738,33,0,3,868,27,895
20200329,NJ,13386,22216,,2000,,,,,,,25ca9138c4a2da1c7d10525cb7bd148761303d58,2020-03-29T20:00:00Z,161,,35602,35602,35602,34,21,0,2830,2262,5092
20200329,NM,237,10769,,19,,,,,,2,3650556fd86edbe68b549235d70d2605865aa335,2020-03-29T20:00:00Z,2,,11006,11006,11006,35,1,0,1573,46,1619
20200329,NV,738,8412,,,,,,,,,0c74530736aea27f85556493e8fa89eb8b417763,2020-03-29T20:00:00Z,14,,9150,9150,9150,32,4,0,511,117,628
20200329,NY,59513,112847,,8503,12075,2037,,,,3572,1c5d1ed64f0ad27a41286104875c23a773a62a40,2020-03-29T20:00:00Z,965,12075,172360,172360,172360,36,237,2021,9231,7195,16426
20200329,OH,1653,19012,,,403,,139,,,,10c9da94683ad45dfb568422d04af2604ade7ca3,2020-03-29T20:00:00Z,29,403,20665,20665,20665,39,4,59,0,247,247
20200329,OK,429,1205,,,140,,,,,,90830f70410babf14d5be9257a440aec4c3a2752,2020-03-29T20:00:00Z,16,140,1634,1634,1634,40,1,14,25,52,77
20200329,OR,548,10878,,107,129,,,37,,,58e5cfeaabed045338f7db94d98652bce8b93797,2020-03-29T20:00:00Z,13,129,11426,11426,11426,41,0,12,1185,69,1254
20200329,PA,3394,30061,,,353,,,,,,da55c1eba9c83cb8c9e3ce7b474a2d7f74f7ecbc,2020-03-29T20:00:00Z,38,353,33455,33455,33455,42,4,37,4807,643,5450
20200329,PR,127,841,817,,,,,,,,e0fd73e5dd7429d9fdff54eda5df78010bbd83c6,2020-03-29T20:00:00Z,5,,1785,968,968,72,2,0,102,27,129
20200329,RI,294,2840,,35,,9,,6,,,b90aa14699c9395b429ef0673f23fa9863cc8fa0,2020-03-29T20:00:00Z,3,,3134,3134,3134,44,3,0,299,55,354
20200329,SC,774,3015,,,129,,,,,,6e080ec1f424aec417c9000a8c610501e2870c5a,2020-03-29T20:00:00Z,16,129,3789,3789,3789,45,3,0,607,235,842
20200329,SD,90,3127,1,,,,,,,29,c81ef2d008bae4c0458db5684079af5ccdbe5abe,2020-03-29T20:00:00Z,1,,3218,3217,3217,46,0,0,535,22,557
20200329,TN,1537,19037,,,133,,,,,,13f3a406e572a8d2c810f9154c0c08a615f21fb1,2020-03-29T20:00:00Z,7,133,20574,20574,20574,47,1,15,2072,164,2236
20200329,TX,2552,23208,,,,,,,,,a9b7fb107b90949f6bd5ab29b957e2cf6e46f9c5,2020-03-29T20:00:00Z,34,,25760,25760,25760,48,7,0,0,500,500
20200329,UT,719,13274,,,,,,,,,c9720da2b069f73256af2086f464a94afc3ade35,2020-03-29T20:00:00Z,2,,13993,13993,13993,49,0,0,2564,117,2681
20200329,VA,890,9719,,,112,,,,,,c69c5d634a01118e8c0e248abc63805871431f51,2020-03-29T20:00:00Z,22,112,10609,10609,10609,51,5,13,1292,151,1443
20200329,VI,23,123,37,,,,,,,,fc797a1ff071a1407658e2f2635370e51d0b804d,2020-03-29T20:00:00Z,,,183,146,146,78,0,0,17,1,18
20200329,VT,235,3466,,,18,,,,,,6378ad325a9d0e9f7f1edfeb369856d460b5e9d8,2020-03-29T20:00:00Z,12,18,3701,3701,3701,50,0,0,1303,24,1327
20200329,WA,5121,69788,,,,,,,,,2963b6534a5cfef6613258e5770a7df3376e11d1,2020-03-29T20:00:00Z,237,,74909,74909,74909,53,17,0,1586,384,1970
20200329,WI,1112,16550,,,,,,,,,8687db826f68ba2e1871b9798043b5acf7de9e5e,2020-03-29T20:00:00Z,13,,17662,17662,17662,55,0,0,1318,123,1441
20200329,WV,113,2705,0,,1,,,,,,95339cc3a82c7850a55cdc2d30895277e29795d5,2020-03-29T20:00:00Z,0,1,2818,2818,2818,54,0,0,374,17,391
20200329,WY,86,1554,,,15,,,,,20,521448649e211047b886a9ac18dbc0b0bd35cf3e,2020-03-29T20:00:00Z,0,15,1640,1640,1640,56,0,1,79,4,83
20200328,AK,85,2836,,,5,,,,,,8a84438657945de664a61b77351faf30fafb9111,2020-03-28T20:00:00Z,2,5,2921,2921,2921,02,1,2,517,16,533
20200328,AL,696,4184,,,,,,,,,63de5e074e982530fe275d036c8318c14eabf49f,2020-03-28T20:00:00Z,3,,4880,4880,4880,01,0,0,0,109,109
20200328,AR,404,2938,,48,,,,17,,24,821e36063f84aa707c0d1ebd3983a4abfa560ac0,2020-03-28T20:00:00Z,5,,3342,3342,3342,05,2,0,1393,23,1416
20200328,AS,,,,,,,,,,,1cd7c88c7f467edd373751178a42f7123d5d457b,2020-03-28T20:00:00Z,0,,0,0,0,60,0,0,0,0,0
20200328,AZ,873,7455,21,,,,,,,,06aad51da966e2299f0c0537e0cf4fbba4c6c696,2020-03-28T20:00:00Z,15,,8349,8328,8328,04,2,0,0,137,137
20200328,CA,4643,20549,64400,1034,,410,,,,,b157cc0b84b971d5a3a02d83eff554903bc4e42f,2020-03-28T20:00:00Z,101,,89592,25192,25192,06,23,0,3169,764,3933
20200328,CO,1734,9942,,307,239,,,,,,0f504f665e7ee9fb3f5a32de281e25f407499940,2020-03-28T20:00:00Z,31,239,11676,11676,11676,08,7,55,1250,304,1554
20200328,CT,1291,7109,,173,,,,,,,4b54cec168b8c41b7f2e60c54af8db39164dd3ad,2020-03-28T20:00:00Z,27,,8400,8400,8400,09,0,0,0,0,0
20200328,DC,304,2211,1,,,,,,,51,1a0f746e0a4c29b6d4b0f58ba80a30d82fbc3ccb,2020-03-28T20:00:00Z,4,,2516,2515,2515,11,1,0,314,37,351
20200328,DE,214,36,,31,,,,,,9,a6e34ce456e231c698fdc1ee16f40c4858227866,2020-03-28T20:00:00Z,3,,250,250,250,10,1,0,0,51,51
20200328,FL,3763,35366,,,526,,,,,,14cf93a61518d7efeec334a7c7fb1c959060c9f8,2020-03-28T20:00:00Z,54,526,39129,39129,39129,12,20,70,7180,998,8178
20200328,GA,2366,8685,,,617,,,,,,202f88e65247b72d32891c53d6d6c15fd209d322,2020-03-28T20:00:00Z,69,617,11051,11051,11051,13,5,51,821,365,1186
20200328,GU,55,299,,15,,,,,,7,b1d234c73440aba9439f6b60529423ffc740bf70,2020-03-28T20:00:00Z,1,,354,354,354,66,0,0,0,4,4
20200328,HI,120,4357,,,8,,,,,,37b251fd5f1651b4c76855ef6f4077c6c4a39f5e,2020-03-28T20:00:00Z,,8,4477,4477,4477,15,0,1,0,14,14
20200328,IA,298,4375,,46,61,,,,,15,a6e6297aaacb70cf1998fe078852e2d7c0446496,2020-03-28T20:00:00Z,3,61,4673,4673,4673,19,0,11,635,63,698
20200328,ID,230,3342,,,25,,,,,,9a384c62a22020c8ec086d3f520e57d5f47d80e1,2020-03-28T20:00:00Z,4,25,3572,3572,3572,16,1,25,674,41,715
20200328,IL,3491,22000,,,,,,,,,073372a26378c93d1b5b6ee7307fb9c030f82f2d,2020-03-28T20:00:00Z,47,,25491,25491,25491,17,13,0,3484,465,3949
20200328,IN,1232,7175,,,,,,,,,bb33e7862d580175dc4ae2bfe3b91be2dd68c719,2020-03-28T20:00:00Z,31,,8407,8407,8407,18,7,0,1220,251,1471
20200328,KS,261,3671,,,27,,,,,,aa84b44c0851b4d887ab1410a969451c25976b52,2020-03-28T20:00:00Z,5,27,3932,3932,3932,20,1,0,442,59,501
20200328,KY,302,4821,,,,,,,,,ea4c264896e76b10ebe1600f6c5705d613dc6f9e,2020-03-28T20:00:00Z,8,,5123,5123,5123,21,2,0,1053,54,1107
20200328,LA,3315,21846,,927,,,,336,,,0a37aa047446a367cce2ff12aebc516ae46b6ed5,2020-03-28T20:00:00Z,137,,25161,25161,25161,22,18,0,3233,569,3802
20200328,MA,4158,30915,,,350,,,,,,60ca78ef57d25fac04e86e18595395bfe838746a,2020-03-28T20:00:00Z,72,350,35073,35073,35073,25,15,131,4671,1007,5678
20200328,MD,992,11516,,,226,,,,,,9a4f0c46cc3178a20535820bef6c0096ec60c487,2020-03-28T20:00:00Z,5,226,12508,12508,12508,24,0,53,11422,218,11640
20200328,ME,211,3394,,,,,,,,36,6a5bccaf6b59cc976bba660e1db01c905136fd21,2020-03-28T20:00:00Z,1,,3605,3605,3605,23,0,0,0,43,43
20200328,MI,9287,14183,,,,,,,,,4d982f1ea0d2d1f67634828a85f3e5d5837db62f,2020-03-28T20:00:00Z,92,,23470,23470,23470,26,0,0,1544,628,2172
20200328,MN,441,15688,,30,57,,17,,,220,a8973e480f151382f19549d1bdfc538a4e03c387,2020-03-28T20:00:00Z,5,57,16129,16129,16129,27,1,6,2083,43,2126
20200328,MO,838,10082,,,,,,,,,e3f4b93a6ae042958eb8189a70db6a5157dcbfbe,2020-03-28T20:00:00Z,10,,10920,10920,10920,29,2,0,9713,169,9882
20200328,MP,2,,,,,,,,,,7b50f60167cf1b698fab776267ec6db2d2d94e8e,2020-03-28T20:00:00Z,,,2,2,2,69,0,0,0,2,2
20200328,MS,663,2560,,,219,,,,,,6abee145ef8e88027852840cb9a48bc1ad203737,2020-03-28T20:00:00Z,13,219,3223,3223,3223,28,5,34,0,84,84
20200328,MT,129,3256,,,7,,,,,,92e123a507931bf1b282c0575331bdd0d17fba98,2020-03-28T20:00:00Z,1,7,3385,3385,3385,30,1,0,666,21,687
20200328,NC,935,16592,,87,,,,,,,f85a64360e16bd10ae0bfae5989948e04dfa3b74,2020-03-28T20:00:00Z,4,,17527,17527,17527,37,1,0,2219,172,2391
20200328,ND,83,2809,,,16,,,,,16,b3dcd39ac30934f3e505d5d57bc88442172b358f,2020-03-28T20:00:00Z,1,16,2892,2892,2892,38,1,3,382,18,400
20200328,NE,96,1904,,,,,,,,,ba991b0ef3a5d94c0f5b994ff54cc8053cfde2b7,2020-03-28T20:00:00Z,2,,2000,2000,2000,31,2,0,143,11,154
20200328,NH,187,3656,296,,30,,,,,,3372eb26e404d2af3105361a92e2fcff4bdd04e7,2020-03-28T20:00:00Z,2,30,4139,3843,3843,33,1,5,261,29,290
20200328,NJ,11124,19386,,2000,,,,,,,d013d501bf506e7978b59f0fd09793994ed757b3,2020-03-28T20:00:00Z,140,,30510,30510,30510,34,32,0,2839,2299,5138
20200328,NM,191,9196,,17,,,,,,,d150e7faad5390184e84f058771ebe3e21a2c2b3,2020-03-28T20:00:00Z,1,,9387,9387,9387,35,0,0,819,55,874
20200328,NV,621,7901,,,,,,,,,38aee6610ca54e785d7593c3916d7256e0ac2a9b,2020-03-28T20:00:00Z,10,,8522,8522,8522,32,0,0,1740,86,1826
20200328,NY,52318,103616,,7328,10054,1755,,,,2726,9d3efd380bf48a8a6a2ff98004ddd6a29a59c988,2020-03-28T20:00:00Z,728,10054,155934,155934,155934,36,209,1528,2498,7683,10181
20200328,OH,1406,19012,,,344,,123,,,,e1ae2e6533d6476a00dce3fdf53a9d06d6df11c3,2020-03-28T20:00:00Z,25,344,20418,20418,20418,39,6,68,0,269,269
20200328,OK,377,1180,,,126,,,,,,0955acd0f7dadd282ecf522f79bd9042b3af7b95,2020-03-28T20:00:00Z,15,126,1557,1557,1557,40,7,21,96,55,151
20200328,OR,479,9693,,107,117,,,31,,,4b290ff3db90da090eab1f7a1f4cefcde650b790,2020-03-28T20:00:00Z,13,117,10172,10172,10172,41,1,15,1183,65,1248
20200328,PA,2751,25254,,,316,,,,,,0b00e5e4eec84c744f25bfd23aa3ff905cca2f2e,2020-03-28T20:00:00Z,34,316,28005,28005,28005,42,12,75,4238,533,4771
20200328,PR,100,739,792,,,,,,,,c1f61bf559aeba0b90d63533c15308234532ea16,2020-03-28T20:00:00Z,3,,1631,839,839,72,0,0,220,21,241
20200328,RI,239,2541,138,29,,9,,6,,,7e5f58bc1722f99ce207cc0d9f753d553667b66a,2020-03-28T20:00:00Z,,,2918,2780,2780,44,0,0,235,36,271
20200328,SC,539,2408,,,129,,,,,,4328bb39fcb99f8666b72daf09cc3812ab1727cf,2020-03-28T20:00:00Z,13,129,2947,2947,2947,45,4,20,101,83,184
20200328,SD,68,2592,0,,,,,,,26,f6d58782a216be383150078737dd5aa359ef916d,2020-03-28T20:00:00Z,1,,2660,2660,2660,46,0,0,205,10,215
20200328,TN,1373,16965,,,118,,,,,,645205ffe209d5acbff94f4dd98d7d981e97a644,2020-03-28T20:00:00Z,6,118,18338,18338,18338,47,0,15,2077,170,2247
20200328,TX,2052,23208,,,,,,,,,9d601857ab7b38aa375d52c046e21db2fe147e92,2020-03-28T20:00:00Z,27,,25260,25260,25260,48,4,0,1273,321,1594
20200328,UT,602,10710,,,,,,,,,eff17f1a0f1557568ff842519c39e1fbc56c66ae,2020-03-28T20:00:00Z,2,,11312,11312,11312,49,0,0,1946,122,2068
20200328,VA,739,8427,,,99,,,,,,4a9486b875debc40351684839a6e07900f0fd3ca,2020-03-28T20:00:00Z,17,99,9166,9166,9166,51,3,16,1694,135,1829
20200328,VI,22,106,55,,,,,,,,d4ffcf812bce08ca20c0cc0a25c40adbedd622db,2020-03-28T20:00:00Z,,,183,128,128,78,0,0,51,3,54
20200328,VT,211,2163,,,18,,,,,,c531c6adaae5c5623a25bebe275eb0269f0e549e,2020-03-28T20:00:00Z,12,18,2374,2374,2374,50,2,0,86,27,113
20200328,WA,4737,68202,,,,,,,,,346e1f5fe0787f04d362fe925e74dd4aa54b5102,2020-03-28T20:00:00Z,220,,72939,72939,72939,53,21,0,2315,432,2747
20200328,WI,989,15232,,,,,,,,,cc9a38626e488667d80901c4814ba600f9f923cb,2020-03-28T20:00:00Z,13,,16221,16221,16221,55,0,0,2092,147,2239
20200328,WV,96,2331,6,,1,,,,,,673594f71200f16f129f2a5e2d70765e7785bb3e,2020-03-28T20:00:00Z,0,1,2433,2427,2427,54,0,0,552,20,572
20200328,WY,82,1475,,,14,,,,,18,33814ce4191a5dcfd2db3346f01e91095209c877,2020-03-28T20:00:00Z,0,14,1557,1557,1557,56,0,3,264,12,276
20200327,AK,69,2319,13,,3,,,,,,4440492623bf23f8e264cde045f01820bcf5eb1f,2020-03-27T20:00:00Z,1,3,2401,2388,2388,02,0,0,518,10,528
20200327,AL,587,4184,,,,,,,,,07d7df62adf5e730a3da751291c1fba471551397,2020-03-27T20:00:00Z,3,,4771,4771,4771,01,2,0,591,81,672
20200327,AR,381,1545,,48,,,,17,,19,00b098e286ece2617f1acecb0abd238b8b786f1a,2020-03-27T20:00:00Z,3,,1926,1926,1926,05,0,0,41,46,87
20200327,AS,,,,,,,,,,,e56724c557d48a4cb6080632b317c35eea41e880,2020-03-27T20:00:00Z,0,,0,0,0,60,0,0,0,0,0
20200327,AZ,736,7455,30,,,,,,,,ed32559e21a38aa4dcf186932bc2e858d1974669,2020-03-27T20:00:00Z,13,,8221,8191,8191,04,5,0,7108,159,7267
20200327,CA,3879,17380,57400,746,,200,,,,,8d4a4c3407f121198d45ea520a0fead10e78b7ea,2020-03-27T20:00:00Z,78,,78659,21259,21259,06,13,0,0,873,873
20200327,CO,1430,8692,,278,184,,,,,,c0a340133fc94be89c0606305c4c1361b1ff14d7,2020-03-27T20:00:00Z,24,184,10122,10122,10122,08,5,36,1714,344,2058
20200327,CT,1291,7109,,173,,,,,,,a8a5f5f6ff700aca7582d8fc72d71f5fde38fc69,2020-03-27T20:00:00Z,27,,8400,8400,8400,09,6,0,1484,279,1763
20200327,DC,267,1897,2,,,,,,,49,05e7fe78e293ec8a664077ad665e2495d86713bd,2020-03-27T20:00:00Z,3,,2166,2164,2164,11,0,0,271,36,307
20200327,DE,163,36,,15,,,,,,9,bad5bab1f9987dd260382f36323623a344953a31,2020-03-27T20:00:00Z,2,,199,199,199,10,1,0,0,33,33
20200327,FL,2765,28186,1517,,456,,,,,,b93ab29f799aa9d89c0f98c7f427278725445572,2020-03-27T20:00:00Z,34,456,32468,30951,30951,12,6,50,4445,410,4855
20200327,GA,2001,7864,,,566,,,,,,b85e11000166a29096d95a7188bd6313144ef7fe,2020-03-27T20:00:00Z,64,566,9865,9865,9865,13,16,93,463,476,939
20200327,GU,51,299,,13,,,,,,,b0946d74b2f737a6121bcccad2d6d512e5238d43,2020-03-27T20:00:00Z,1,,350,350,350,66,0,0,36,6,42
20200327,HI,106,4357,,,7,,,,,,8abd3d7a2e51102bd77b1d155788a12a5405e9ab,2020-03-27T20:00:00Z,,7,4463,4463,4463,15,0,2,0,11,11
20200327,IA,235,3740,,32,50,,,,,18,a23c3b107d9c1fdabfcdbf0d850c781b78831c20,2020-03-27T20:00:00Z,3,50,3975,3975,3975,19,2,4,1162,56,1218
20200327,ID,189,2668,,,,,,,,,e07b9d6372f5b9719ff22ba8d64b136f5aabe538,2020-03-27T20:00:00Z,3,,2857,2857,2857,16,3,0,603,66,669
20200327,IL,3026,18516,,,,,,,,,65f47d4e133e84caba214c7a0efd4f69e51ceb5a,2020-03-27T20:00:00Z,34,,21542,21542,21542,17,8,0,4423,488,4911
20200327,IN,981,5955,,,,,,,,,3708ffb8604728a20d1032f73b6da67ee72ea866,2020-03-27T20:00:00Z,24,,6936,6936,6936,18,7,0,1949,336,2285
20200327,KS,202,3229,,,27,,,,,,00010abd938af813b268bdf5dfe70271ba5d42aa,2020-03-27T20:00:00Z,4,27,3431,3431,3431,20,1,27,360,34,394
20200327,KY,248,3768,,,,,,,,,c8caceb5970b63067f283dfe604e520e4034f198,2020-03-27T20:00:00Z,6,,4016,4016,4016,21,2,0,666,50,716
20200327,LA,2746,18613,,773,,,,270,,,82b631667fdd96fa61e4fc1733f03cc43182176b,2020-03-27T20:00:00Z,119,,21359,21359,21359,22,36,0,2889,441,3330
20200327,MA,3151,26244,,,219,,,,,,b6c870e0c8cf85caabe5cc471e5381d2c31db540,2020-03-27T20:00:00Z,57,219,29395,29395,29395,25,15,0,4917,833,5750
20200327,MD,774,94,,,173,,,,,25,0a28c9d4e27baa6cdf5626370be8d76e282880d6,2020-03-27T20:00:00Z,5,173,868,868,868,24,1,41,0,194,194
20200327,ME,168,3394,,,,,,,,24,7150d501b5d1f77e6ab73e054bb65b8ac1d6685b,2020-03-27T20:00:00Z,1,,3562,3562,3562,23,1,0,0,13,13
20200327,MI,8659,12639,,,,,,,,,8bc1808989463af326a28c9e670034c077877e70,2020-03-27T20:00:00Z,92,,21298,21298,21298,26,32,0,2334,892,3226
20200327,MN,398,13605,,34,51,,17,,,180,7c0b3f30124d18556eddb9a53cba26e8b144daca,2020-03-27T20:00:00Z,4,51,14003,14003,14003,27,2,10,1001,52,1053
20200327,MO,669,369,,,,,,,,,e164635689d048e1c9a7125b8b7fe42bd18dfd3d,2020-03-27T20:00:00Z,8,,1038,1038,1038,29,0,0,0,167,167
20200327,MP,0,,,,,,,,,,2f5f231a6bd383fd894c67af3b27dee189d2815e,2020-03-27T20:00:00Z,0,,0,0,0,69,0,0,0,0,0
20200327,MS,579,2560,,,185,,,,,,cb4ab3b814e5417a4015c0a7ae69eb7eaa092c9a,2020-03-27T20:00:00Z,8,185,3139,3139,3139,28,2,35,269,94,363
20200327,MT,108,2590,,,7,,,,,,80cf224382b2b613d31d3a1a3987b68e42389ca3,2020-03-27T20:00:00Z,,7,2698,2698,2698,30,0,6,462,37,499
20200327,NC,763,14373,,77,,,,,,,d165f85a12dbab90b0ab2cea143f8bb4f6907b29,2020-03-27T20:00:00Z,3,,15136,15136,15136,37,1,0,2099,127,2226
20200327,ND,65,2427,,,13,,,,,15,4211f51616b6afba9db6498b58fc90ab33be7172,2020-03-27T20:00:00Z,0,13,2492,2492,2492,38,0,3,388,13,401
20200327,NE,85,1761,,,,,,,,,64cd084ae1882a6e72f9f4b3908fd89881bb007f,2020-03-27T20:00:00Z,0,,1846,1846,1846,31,0,0,177,12,189
20200327,NH,158,3395,592,,25,,,,,,a82fcad4f7253fef19c71e71f7f2429e17e1c1a7,2020-03-27T20:00:00Z,1,25,4145,3553,3553,33,0,6,394,21,415
20200327,NJ,8825,16547,,2000,,,,,,,97947965fc4783e404b2b3f653e188ca13eedfdc,2020-03-27T20:00:00Z,108,,25372,25372,25372,34,27,0,2886,1949,4835
20200327,NM,136,8377,,,,,,,,,a96718b15dd4f8b2bf0aa0cf64145d513d35f6e6,2020-03-27T20:00:00Z,1,,8513,8513,8513,35,0,0,696,24,720
20200327,NV,535,6161,,,,,,,,,c45254e1c7f4cc7635c3cc42cc996a47b745d36c,2020-03-27T20:00:00Z,10,,6696,6696,6696,32,0,0,1464,115,1579
20200327,NY,44635,101118,,6481,8526,1583,,,,2045,e450c496d8e40791775087cd390d8f9ac5f298cd,2020-03-27T20:00:00Z,519,8526,145753,145753,145753,36,134,1682,16272,7377,23649
20200327,OH,1137,19012,,,276,,107,,,,775347bbd54dbd3e3235391c7d2d5eb4c87cab2c,2020-03-27T20:00:00Z,19,276,20149,20149,20149,39,4,53,2563,270,2833
20200327,OK,322,1084,,,105,,,,,,01208f5d22ac2638f9654bb25fdb4bbe426dd561,2020-03-27T20:00:00Z,8,105,1406,1406,1406,40,1,19,126,74,200
20200327,OR,414,8510,,91,102,,,31,,,41d09c4e184746901e91a26a1f302dde797b8058,2020-03-27T20:00:00Z,12,102,8924,8924,8924,41,1,12,1557,87,1644
20200327,PA,2218,21016,,,241,,,,,,e80400da9fd2c8e84d22566050fa2b705d7fdde0,2020-03-27T20:00:00Z,22,241,23234,23234,23234,42,6,241,4575,531,5106
20200327,PR,79,519,334,,,,,,,,aefe7a30d1464bfc9d4213163b6f4e311db5a14b,2020-03-27T20:00:00Z,3,,932,598,598,72,1,0,142,15,157
20200327,RI,203,2306,138,28,,9,,6,,,96f0e54cf6fb06d019b82a2ae42e7b9ed4ac1135,2020-03-27T20:00:00Z,,,2647,2509,2509,44,0,0,1044,38,1082
20200327,SC,456,2307,,,109,,,,,,eba42fa8d4d9d65fdf8d2aefb0cc7cf13e75ee31,2020-03-27T20:00:00Z,9,109,2763,2763,2763,45,0,0,0,0,0
20200327,SD,58,2387,20,,,,,,,21,5d1fd96fd9c93ab88a3ac21f0a7fb8314ab018ef,2020-03-27T20:00:00Z,1,,2465,2445,2445,46,0,0,414,12,426
20200327,TN,1203,14888,,,103,,,,,,c3a5af8cf2531b13791648be5b30584a9e811787,2020-03-27T20:00:00Z,6,103,16091,16091,16091,47,3,27,936,246,1182
20200327,TX,1731,21935,,,,,,,,,8409fedc70d96ce072fcd2c62d1101488f155d94,2020-03-27T20:00:00Z,23,,23666,23666,23666,48,5,0,1907,335,2242
20200327,UT,480,8764,,,,,,,,,59049455f72c15c38a8ad386ca6a601e271b4a6d,2020-03-27T20:00:00Z,2,,9244,9244,9244,49,1,0,1456,78,1534
20200327,VA,604,6733,,,83,,,,,,376dd9385db92b70861adb4e990699e2ae38ea4f,2020-03-27T20:00:00Z,14,83,7337,7337,7337,51,1,18,1004,144,1148
20200327,VI,19,55,2,,,,,,,,32ebeb6f98af6bf98f77c8511e2ec314bc5b8869,2020-03-27T20:00:00Z,,,76,74,74,78,0,0,0,2,2
20200327,VT,184,2077,,,18,,,,,,0064eda2b4b2bd74f386a29d0fa13b8378aff141,2020-03-27T20:00:00Z,10,18,2261,2261,2261,50,1,18,227,26,253
20200327,WA,4305,65887,,,,,,,,,f662c6857b61ea6b2c2d0167228181157941fbd4,2020-03-27T20:00:00Z,199,,70192,70192,70192,53,16,0,3900,483,4383
20200327,WI,842,13140,,,,,,,,,8c63c548c621e8d51f2c08c5e2e7a34947238262,2020-03-27T20:00:00Z,13,,13982,13982,13982,55,5,0,1557,135,1692
20200327,WV,76,1779,43,,1,,,,,,67ad4031bd5dd9dfb1b414880205d3698549469c,2020-03-27T20:00:00Z,0,1,1898,1855,1855,54,0,0,748,25,773
20200327,WY,70,1211,,,11,,,,,17,ece3b4c4bd5b7103d4e083be4a022cb425a1924f,2020-03-27T20:00:00Z,0,11,1281,1281,1281,56,0,11,159,17,176
20200326,AK,59,1801,,,3,,,,,,141c8e163d64a2762eb6ce6fab3863ab853929a4,2020-03-26T20:00:00Z,1,3,1860,1860,1860,02,0,2,152,17,169
20200326,AL,506,3593,,,,,,,,,fbb44aa6b758e39d9ca03edb761c2463bc6d09e7,2020-03-26T20:00:00Z,1,,4099,4099,4099,01,1,0,1064,223,1287
20200326,AR,335,1504,,41,,,,13,,13,b3807a88dfed74bba84ae7ae53bc48ae629efe67,2020-03-26T20:00:00Z,3,,1839,1839,1839,05,1,0,67,55,122
20200326,AS,,,,,,,,,,,0d9d160c81296656a218a2713654bbbae3d967a5,2020-03-26T20:00:00Z,0,,0,0,0,60,0,0,0,0,0
20200326,AZ,577,347,33,,,,,,,,fc2dfd68a669b464fea245b75014240abefeee52,2020-03-26T20:00:00Z,8,,957,924,924,04,2,0,24,127,151
20200326,CA,3006,17380,57400,,,,,,,,d073989819811eaa4edd1a4f71a3716c44b653ac,2020-03-26T20:00:00Z,65,,77786,20386,20386,06,12,0,1459,651,2110
20200326,CO,1086,6978,,230,148,,,,,,a1c2870d7b6a658d2e68fc29e800e75e1cda421f,2020-03-26T20:00:00Z,19,148,8064,8064,8064,08,8,64,189,174,363
20200326,CT,1012,5625,,125,,,,,,,1742b9a50eb648ea5cd758b44de2e4ded9b8bfcf,2020-03-26T20:00:00Z,21,,6637,6637,6637,09,2,0,602,137,739
20200326,DC,231,1626,1,,,,,,,21,be59e63006a0dcd465209f8d1b3097218f92f343,2020-03-26T20:00:00Z,3,,1858,1857,1857,11,1,0,203,48,251
20200326,DE,130,36,,13,,,,,,4,19405b8d3a5695178ede4bb185d23fa2eec6654d,2020-03-26T20:00:00Z,1,,166,166,166,10,1,0,0,15,15
20200326,FL,2355,23741,1443,,406,,,,,,1290ba6a489ffe158fa4333c279e73b7c728543e,2020-03-26T20:00:00Z,28,406,27539,26096,26096,12,6,90,8367,673,9040
20200326,GA,1525,7401,,,473,,,,,,5bd7f61bc12b4e207e0ceda50e5fe469273a6b44,2020-03-26T20:00:00Z,48,473,8926,8926,8926,13,8,79,2469,278,2747
20200326,GU,45,263,,11,,,,,,,d5ec60b36b329b943e899f07431485ec8ab96ea6,2020-03-26T20:00:00Z,1,,308,308,308,66,0,0,30,8,38
20200326,HI,95,4357,,,5,,,,,,cdbfa8c05d4138523b7bd76294518d1ef0dac898,2020-03-26T20:00:00Z,,5,4452,4452,4452,15,0,-1,0,5,5
20200326,IA,179,2578,,31,46,,,,,15,411e2fbdf3f70764fb24db7b34feb147bc2ecb13,2020-03-26T20:00:00Z,1,46,2757,2757,2757,19,0,10,0,34,34
20200326,ID,123,2065,,,,,,,,,accd7f2d4f84c66bb09e13ee9e72790b73ed7751,2020-03-26T20:00:00Z,0,,2188,2188,2188,16,0,0,178,50,228
20200326,IL,2538,14093,,,,,,,,,ede372266e78d0a0ceff08d95ac84932e0fcfc7d,2020-03-26T20:00:00Z,26,,16631,16631,16631,17,7,0,1749,673,2422
20200326,IN,645,4006,,,,,,,,,d09dec87fbea244ee83df1fb0d61288197978934,2020-03-26T20:00:00Z,17,,4651,4651,4651,18,3,0,1127,168,1295
20200326,KS,168,2869,,,,,,,,,aa2e17ec747401ff3e73105d0b833fa0b4f03d67,2020-03-26T20:00:00Z,3,,3037,3037,3037,20,0,0,509,42,551
20200326,KY,198,3102,,,,,,,,,3a82ab3456c2469d52b7790c96cb4cfa30f25cd5,2020-03-26T20:00:00Z,4,,3300,3300,3300,21,0,0,237,41,278
20200326,LA,2305,15724,,676,,,,239,,,ca5bdffed97943221ff58631ebd9789d4a5aa600,2020-03-26T20:00:00Z,83,,18029,18029,18029,22,18,0,6068,510,6578
20200326,MA,2318,21327,,,219,,,,,,67a403d8c4ba853e9740950be32adbf351243fda,2020-03-26T20:00:00Z,42,219,23645,23645,23645,25,9,116,3248,579,3827
20200326,MD,580,94,,,132,,,,,,871e46620cc8507563260a7f3a0336d8e426ab51,2020-03-26T20:00:00Z,4,132,674,674,674,24,0,132,0,157,157
20200326,ME,155,3394,,,,,,,,16,482e706965e1aaacc7b8f40547be7a63dbcb4b7d,2020-03-26T20:00:00Z,,,3549,3549,3549,23,0,0,217,6,223
20200326,MI,7767,10305,,,,,,,,,e1de57b6e220762fddb1d9ed686161ea23799666,2020-03-26T20:00:00Z,60,,18072,18072,18072,26,17,0,2768,707,3475
20200326,MN,346,12604,,31,41,,,,,,54abcd207865204ef3da6e8985ee95f798f94255,2020-03-26T20:00:00Z,2,41,12950,12950,12950,27,1,6,1416,59,1475
20200326,MO,502,369,,,,,,,,,5d322e752d7a1f4672917629e7702c7bc26a93f6,2020-03-26T20:00:00Z,8,,871,871,871,29,0,0,0,146,146
20200326,MP,0,,,,,,,,,,4f1e047c3e63f3349e4f7c617874492431c8a5f9,2020-03-26T20:00:00Z,0,,0,0,0,69,0,0,0,0,0
20200326,MS,485,2291,,,150,,,,,,20667611a63432824d0ff16867b5adc4c06b5936,2020-03-26T20:00:00Z,6,150,2776,2776,2776,28,4,33,725,108,833
20200326,MT,71,2128,,,1,,,,,,e7caf7619a1d9a6677a95d9d85eb24598221158d,2020-03-26T20:00:00Z,,1,2199,2199,2199,30,0,1,180,18,198
20200326,NC,636,12274,,29,,,,,,,384b4ce0619787f46136d144e17bc74618e69bad,2020-03-26T20:00:00Z,2,,12910,12910,12910,37,1,0,2289,132,2421
20200326,ND,52,2039,,,10,,,,,,e574ee98155f078e25da07dbc6404e23add90f9b,2020-03-26T20:00:00Z,0,10,2091,2091,2091,38,0,2,305,13,318
20200326,NE,73,1584,,,,,,,,,b1e3ffd00324b8a8500be3b3a4b0e378b57710b5,2020-03-26T20:00:00Z,0,,1657,1657,1657,31,0,0,280,12,292
20200326,NH,137,3001,712,,19,,,,,,a37cd44af5e89e3f36bcbc424c61162b18173e05,2020-03-26T20:00:00Z,1,19,3850,3138,3138,33,0,6,645,29,674
20200326,NJ,6876,13661,,1080,,,,,,,164bbcd99de9fa76ebb40894fd2d348c5e384d71,2020-03-26T20:00:00Z,81,,20537,20537,20537,34,19,0,3209,2474,5683
20200326,NM,112,7681,,,,,,,,,1e43be6fccfd53482152b6f0032c9f5380179480,2020-03-26T20:00:00Z,1,,7793,7793,7793,35,0,0,939,12,951
20200326,NV,420,4697,,,,,,,,,8439b92c8ef2ecd1b055e3ed1acbab7bedd90001,2020-03-26T20:00:00Z,10,,5117,5117,5117,32,4,0,446,99,545
20200326,NY,37258,84846,,5327,6844,1290,,,,,0058535329a967d92568319188616fcc3ddde2da,2020-03-26T20:00:00Z,385,6844,122104,122104,122104,36,100,3039,12178,6447,18625
20200326,OH,867,16449,,,223,,91,,,,ec54f23b722a56fc6cb60ec0603c774a574b1b58,2020-03-26T20:00:00Z,15,223,17316,17316,17316,39,5,41,2389,163,2552
20200326,OK,248,958,,,86,,,,,,6a5dd746a3fa2c1898256473098b5715589457c2,2020-03-26T20:00:00Z,7,86,1206,1206,1206,40,2,27,153,84,237
20200326,OR,327,6953,,,90,,,,,,ddb030ea072a2fe01a8d71d2a5a24e917d4e8ea2,2020-03-26T20:00:00Z,11,90,7280,7280,7280,41,3,29,2603,118,2721
20200326,PA,1687,16441,,,,,,,,,7712fd7f15f40e975c2a503bd7633edd4387df7e,2020-03-26T20:00:00Z,16,,18128,18128,18128,42,5,0,5248,560,5808
20200326,PR,64,377,335,,,,,,,,f0017006486c2085b91f1f75468f643da3153af8,2020-03-26T20:00:00Z,2,,776,441,441,72,0,0,60,13,73
20200326,RI,165,1262,181,23,,9,,6,,,a61cfb3d2f6c540ab418b7ebe42eee237687da77,2020-03-26T20:00:00Z,,,1608,1427,1427,44,0,0,0,33,33
20200326,SC,456,2307,,,109,,,,,,4c55b055bf2708a25455b71cdb3d6115453ed71c,2020-03-26T20:00:00Z,9,109,2763,2763,2763,45,2,7,4,32,36
20200326,SD,46,1973,125,,,,,,,16,279cd2d4767245d1841274ed2d19a0a4f5c9b673,2020-03-26T20:00:00Z,1,,2144,2019,2019,46,0,0,1154,5,1159
20200326,TN,957,13952,,,76,,,,,,d3ce5ed8216ba2c78107cb4d4ec9da1dd0b0f77f,2020-03-26T20:00:00Z,3,76,14909,14909,14909,47,0,23,2940,173,3113
20200326,TX,1396,20028,,,,,,,,,fa643c14dbc1c896f7d243f22f25aa05e563d6af,2020-03-26T20:00:00Z,18,,21424,21424,21424,48,6,0,7508,422,7930
20200326,UT,402,7308,,,,,,,,,dd83cffb270720784e9e520a6513c7c8f1ec68c5,2020-03-26T20:00:00Z,1,,7710,7710,7710,49,0,0,817,56,873
20200326,VA,460,5729,,,65,,,,,,60d151765c90a17f38487d1089ef283796e1c122,2020-03-26T20:00:00Z,13,65,6189,6189,6189,51,4,6,750,69,819
20200326,VI,17,55,2,,,,,,,,7387909f4f1f9ad32b038215b37dd6819ef2eb15,2020-03-26T20:00:00Z,,,74,72,72,78,0,0,0,0,0
20200326,VT,158,1850,,,,,,,,,994b0d80648160d62da49b803410ff385ef7f906,2020-03-26T20:00:00Z,9,,2008,2008,2008,50,1,0,261,35,296
20200326,WA,3822,61987,,,,,,,,,d1af3f772e517986f23167311b4bc2e541425fac,2020-03-26T20:00:00Z,183,,65809,65809,65809,53,24,0,4058,483,4541
20200326,WI,707,11583,,,,,,,,,9683cfe2bd653af14dcfc375a493d40198712796,2020-03-26T20:00:00Z,8,,12290,12290,12290,55,1,0,1494,122,1616
20200326,WV,51,1031,19,,1,,,,,,ea32f587f060c45231c6013fa4924abbc339400a,2020-03-26T20:00:00Z,0,1,1101,1082,1082,54,0,0,272,12,284
20200326,WY,53,1052,,,,,,,,12,4fb67721dfe7158af2d510dc704638497f0a8359,2020-03-26T20:00:00Z,,,1105,1105,1105,56,0,0,98,9,107
20200325,AK,42,1649,,,1,,,,,,d0981dc0ff9e0b50793d2307ce11831905ea3c01,2020-03-25T20:00:00Z,1,1,1691,1691,1691,02,1,1,663,6,669
20200325,AL,283,2529,,,,,,,,,2f45607dc8271295dd36e91588d93ebaa1bc3110,2020-03-25T20:00:00Z,0,,2812,2812,2812,01,0,0,423,68,491
20200325,AR,280,1437,,22,,,,4,,11,a55c4c11c7faab713d2bd57c30acda12f8a79830,2020-03-25T20:00:00Z,2,,1717,1717,1717,05,2,0,490,62,552
20200325,AS,,,,,,,,,,,d12176b38413ba2e195f83b80e78bdf6dae954ec,2020-03-25T20:00:00Z,0,,0,0,0,60,0,0,0,0,0
20200325,AZ,450,323,53,,,,,,,,825d3e27cef83c2a2f4fd66b0ce710ea0cdd8340,2020-03-25T20:00:00Z,6,,826,773,773,04,1,0,10,93,103
20200325,CA,2355,15921,48600,,,,,,,,8d9cf944b6bf56c413644ce7729ef18efa3d75a0,2020-03-25T20:00:00Z,53,,66876,18276,18276,06,13,0,2469,253,2722
20200325,CO,912,6789,,152,84,,,,,,885c5f3d8965666c6728d14e4dd6adf737aa2076,2020-03-25T20:00:00Z,11,84,7701,7701,7701,08,4,12,1285,192,1477
20200325,CT,875,5023,,113,,,,,,,26bda0962bcd2c46918956f27804c62275c6be2d,2020-03-25T20:00:00Z,19,,5898,5898,5898,09,7,0,341,257,598
20200325,DC,183,1423,3,,,,,,,,4c94c1d06cba80ba6ca85bc5eb70dab16b46b6bf,2020-03-25T20:00:00Z,2,,1609,1606,1606,11,0,0,228,46,274
20200325,DE,115,36,,11,,,,,,,d451aedba3efc2662603737e82f38aed0fb267e2,2020-03-25T20:00:00Z,0,,151,151,151,10,0,0,0,24,24
20200325,FL,1682,15374,1233,,316,,,,,,3824a66b112cf25a03e7e1701dc1af01026bd711,2020-03-25T20:00:00Z,22,316,18289,17056,17056,12,4,57,2247,270,2517
20200325,GA,1247,4932,,,394,,,,,,0608d7952fefcad2df075352ee28eb32e13426be,2020-03-25T20:00:00Z,40,394,6179,6179,6179,13,8,394,474,221,695
20200325,GU,37,233,,10,,,,,,,68ef6bb52723460829502eba44a7ffe48e78388d,2020-03-25T20:00:00Z,1,,270,270,270,66,0,0,32,5,37
20200325,HI,90,4357,,,6,,,,,,9bb75dd30e325c6a18abe4a0b7efc5abf0c2ef57,2020-03-25T20:00:00Z,,6,4447,4447,4447,15,0,2,768,13,781
20200325,IA,145,2578,,23,36,,,,,,13d8e16121979021bb57103d7b961e31b3dfee2e,2020-03-25T20:00:00Z,1,36,2723,2723,2723,19,1,9,263,21,284
20200325,ID,73,1887,,,,,,,,,a4fa527e00632ae29efb14c92c81b06642e554cb,2020-03-25T20:00:00Z,0,,1960,1960,1960,16,0,0,0,23,23
20200325,IL,1865,12344,,,,,,,,,de4c69056480e6111af2b8aeb434f5f8d597b170,2020-03-25T20:00:00Z,19,,14209,14209,14209,17,3,0,2410,330,2740
20200325,IN,477,2879,,,1,,,,,,1a6af9e7ccb688e3321a736a824bb1fe799b7ef8,2020-03-25T20:00:00Z,14,1,3356,3356,3356,18,2,0,313,112,425
20200325,KS,126,2360,,,,,,,,,deae962902c0a2fb252f981aaba83eda616d6029,2020-03-25T20:00:00Z,3,,2486,2486,2486,20,1,0,274,28,302
20200325,KY,157,2865,,,,,,,,,8fc7de737c41520c298dcbceba279e065ddceeb7,2020-03-25T20:00:00Z,4,,3022,3022,3022,21,0,0,1103,33,1136
20200325,LA,1795,9656,,491,,,,163,,,f8bc75603abe9cb7b1b17b37196513f9f0916e82,2020-03-25T20:00:00Z,65,,11451,11451,11451,22,19,0,2441,407,2848
20200325,MA,1739,18079,,,103,,,,,,eb6ec148234fbeedd7dc7d575b2b48c597367f9c,2020-03-25T20:00:00Z,33,103,19818,19818,19818,25,7,9,5365,679,6044
20200325,MD,423,94,,,,,,,,,ef79567177f07f1f10279b6a4bbb1326684bbd00,2020-03-25T20:00:00Z,4,,517,517,517,24,1,0,0,74,74
20200325,ME,149,3177,,,,,,,,7,6a21285c01dfd9378d220175d14dc3a772dfe3fe,2020-03-25T20:00:00Z,,,3326,3326,3326,23,0,0,163,24,187
20200325,MI,7060,7537,,,,,,,,,8caeeec0387cf6fe763f8215ab7d28c56c8ad0a7,2020-03-25T20:00:00Z,43,,14597,14597,14597,26,19,0,1741,619,2360
20200325,MN,287,11188,,26,35,,,,,122,0901433ad4b755a7fa7bf999a5d1cb967f3b843e,2020-03-25T20:00:00Z,1,35,11475,11475,11475,27,0,14,5638,25,5663
20200325,MO,356,369,,,,,,,,,f7ac8ac4376125f549f2d3237af885e7effab1b5,2020-03-25T20:00:00Z,8,,725,725,725,29,5,0,0,173,173
20200325,MP,0,,,,,,,,,,2412f6b612ee38dd778455fcf069651b33a164a0,2020-03-25T20:00:00Z,0,,0,0,0,69,0,0,0,0,0
20200325,MS,377,1566,,,117,,,,,,9968fd3d3074b5b25f4930d48c5c7269f0a83495,2020-03-25T20:00:00Z,2,117,1943,1943,1943,28,1,31,14,57,71
20200325,MT,53,1948,,,,,,,,,25cdd51b3866c8760da24735f8c0b495d8ea371c,2020-03-25T20:00:00Z,,,2001,2001,2001,30,0,0,305,7,312
20200325,NC,504,9985,,29,,,,,,,ee6173b3a7357aaa26da71326ded7a234fa338c1,2020-03-25T20:00:00Z,1,,10489,10489,10489,37,1,0,1844,106,1950
20200325,ND,39,1734,,,8,,,,,,6c0feae4a6bfd4cf279d43da9bed66faff769fa4,2020-03-25T20:00:00Z,0,8,1773,1773,1773,38,0,3,280,5,285
20200325,NE,61,1304,,,,,,,,,72bc397b422f829aa332430ba9e018a98aec8427,2020-03-25T20:00:00Z,0,,1365,1365,1365,31,0,0,329,9,338
20200325,NH,108,2356,804,,13,,,,,,ba894271c0369b91572e02c61dbe15afd68c146b,2020-03-25T20:00:00Z,1,13,3268,2464,2464,33,0,2,909,7,916
20200325,NJ,4402,10452,,,,,,,,,db32961abdc494e4610cb9201238755c5dbe9c9d,2020-03-25T20:00:00Z,62,,14854,14854,14854,34,18,0,2127,727,2854
20200325,NM,100,6742,,,,,,,,,b1128704739dbdde58897b48092a9f580fa1ee73,2020-03-25T20:00:00Z,1,,6842,6842,6842,35,1,0,852,17,869
20200325,NV,321,4251,,,,,,,,,527559709b16a14d2f376fb0df0c1c90150a4399,2020-03-25T20:00:00Z,6,,4572,4572,4572,32,2,0,297,43,340
20200325,NY,30811,72668,,4079,3805,,,,,,038e3496fd1c543cbd1726a874e91a2707a4597f,2020-03-25T20:00:00Z,285,3805,103479,103479,103479,36,75,571,7063,5146,12209
20200325,OH,704,14060,,,182,,74,,,,37f081a41326a68ac5070d7ed52344f4839699b4,2020-03-25T20:00:00Z,10,182,14764,14764,14764,39,2,37,13920,140,14060
20200325,OK,164,805,,,59,,,,,,0a9c58ed26188df9e615374204dca8c4e9bded41,2020-03-25T20:00:00Z,5,59,969,969,969,40,2,34,70,58,128
20200325,OR,209,4350,,,61,,,,,,5a3e8848f9b6371e0c31274fd62117c40f06a0a3,2020-03-25T20:00:00Z,8,61,4559,4559,4559,41,0,0,0,0,0
20200325,PA,1127,11193,,,,,,,,,a04cdbf57ddbd0c489b48882295db9559fb037b5,2020-03-25T20:00:00Z,11,,12320,12320,12320,42,4,0,2550,276,2826
20200325,PR,51,317,70,,,,,,,,a29866b5ad6a6ac14b8d352af3b9af315c1f1c63,2020-03-25T20:00:00Z,2,,438,368,368,72,0,0,49,12,61
20200325,RI,132,1262,196,15,,,,,,,375952097e60875f852b8b4afdec4b37e5e1872e,2020-03-25T20:00:00Z,,,1590,1394,1394,44,0,0,62,8,70
20200325,SC,424,2303,,,102,,,,,,eee95db6f47c1427fd6e5482cf0deeced90a8f05,2020-03-25T20:00:00Z,7,102,2727,2727,2727,45,2,102,291,126,417
20200325,SD,41,819,268,,,,,,,,26eb16cec32ca8e58e78f3faa6b2bf73b60aeecc,2020-03-25T20:00:00Z,1,,1128,860,860,46,0,0,29,11,40
20200325,TN,784,11012,,,53,,,,,,99bf1065223280d5519a05c0f2363f77244d41a9,2020-03-25T20:00:00Z,3,53,11796,11796,11796,47,1,53,495,117,612
20200325,TX,974,12520,,,,,,,,,94d22076ee33e8232bf343c6e7cb48853cad8083,2020-03-25T20:00:00Z,12,,13494,13494,13494,48,3,0,1763,564,2327
20200325,UT,346,6491,,,,,,,,,0edf4fe386389c4acf4c834fa913fa86ba48669b,2020-03-25T20:00:00Z,1,,6837,6837,6837,49,0,0,967,47,1014
20200325,VA,391,4979,,,59,,,,,,f6276b380e5e6e9a92435116b52b41ae24db94df,2020-03-25T20:00:00Z,9,59,5370,5370,5370,51,2,14,799,101,900
20200325,VI,17,55,2,,,,,,,,ef607d6eacdb14ebba28bb521e766e6bbbd21a77,2020-03-25T20:00:00Z,,,74,72,72,78,0,0,55,0,55
20200325,VT,123,1589,,,,,,,,,007aa638edad042e4ae3bc4e7d899f62b3d3ffee,2020-03-25T20:00:00Z,8,,1712,1712,1712,50,1,0,149,28,177
20200325,WA,3339,57929,,,,,,,,,b9f57419dacd8d938205bbca8ba78aa0d69f6a23,2020-03-25T20:00:00Z,159,,61268,61268,61268,53,13,0,4588,462,5050
20200325,WI,585,10089,,,,,,,,,990d1cee0a0325690dd1ddb866cc2ec4d457130a,2020-03-25T20:00:00Z,7,,10674,10674,10674,55,2,0,1852,128,1980
20200325,WV,39,759,6,,1,,,,,,e23f509ba05bca7c485e27672c0beea77f7608e7,2020-03-25T20:00:00Z,0,1,804,798,798,54,0,0,149,19,168
20200325,WY,44,954,,,,,,,,7,9eeedd6bac08a0fa82e127b99fd62ab414a2f690,2020-03-25T20:00:00Z,,,998,998,998,56,0,0,244,15,259
20200324,AK,36,986,,,0,,,,,,08ee797011e15cf7528034c8de823ae36dcc4164,2020-03-24T20:00:00Z,0,0,1022,1022,1022,02,0,0,40,14,54
20200324,AL,215,2106,,,,,,,,,c212a8468e01e67b91f78d053b0440276641d84f,2020-03-24T20:00:00Z,0,,2321,2321,2321,01,0,0,441,48,489
20200324,AR,218,947,,22,,,,,,,d8534a438538284a464f1162c4502b3b09e3d903,2020-03-24T20:00:00Z,0,,1165,1165,1165,05,0,0,41,44,85
20200324,AS,,,,,,,,,,,6be3aad6eae6ca42ef1d4cf38e24ab40cf817ce1,2020-03-24T20:00:00Z,0,,0,0,0,60,0,0,0,0,0
20200324,AZ,357,313,22,,,,,,,,e5040b6755e38071fb65133e5ff2fb1d49b41c70,2020-03-24T20:00:00Z,5,,692,670,670,04,3,0,4,92,96
20200324,CA,2102,13452,12100,,,,,,,,de4019ee1e7e99d093947ecd2a91c6093439f221,2020-03-24T20:00:00Z,40,,27654,15554,15554,06,13,0,885,369,1254
20200324,CO,720,5504,,116,72,,,,,,58e00f78f651ee87b7972b5186f98b000a969926,2020-03-24T20:00:00Z,7,72,6224,6224,6224,08,1,14,659,129,788
20200324,CT,618,4682,,71,,,,,,,0029ca1528305bb39b465eaadfee22f7cc558888,2020-03-24T20:00:00Z,12,,5300,5300,5300,09,2,0,597,203,800
20200324,DC,137,1195,2,,,,,,,,b0e3891c7034fd64b2031778208ec8934a5f2ddf,2020-03-24T20:00:00Z,2,,1334,1332,1332,11,0,0,82,21,103
20200324,DE,91,36,,,,,,,,,87f8b0a23f5fb9719ce50fb40b83be4b7fd9b03b,2020-03-24T20:00:00Z,0,,127,127,127,10,0,0,0,23,23
20200324,FL,1412,13127,1008,,259,,,,,,01f224778b595c53a53b114c66966c5987214220,2020-03-24T20:00:00Z,18,259,15547,14539,14539,12,4,42,2064,241,2305
20200324,GA,1026,4458,,,,,,,,,837865a88d570829d28bd06b24a4d97e5e901ddb,2020-03-24T20:00:00Z,32,,5484,5484,5484,13,7,0,161,254,415
20200324,GU,32,201,,5,,,,,,,277343684f9e9751ef5a043c295d7c4da955a35e,2020-03-24T20:00:00Z,1,,233,233,233,66,0,0,40,3,43
20200324,HI,77,3589,,,4,,,,,,c8688910d03a46dcdec0bba2338d32b386e8e7af,2020-03-24T20:00:00Z,,4,3666,3666,3666,15,0,4,634,21,655
20200324,IA,124,2315,,,27,,,,,,7cc0fd2b921b97c1bfacb447011ac898b4781078,2020-03-24T20:00:00Z,,27,2439,2439,2439,19,0,27,272,19,291
20200324,ID,50,1887,,,,,,,,,027fc25af7fa5b80a0a2d8e1f588710a5a0b223f,2020-03-24T20:00:00Z,0,,1937,1937,1937,16,0,0,578,3,581
20200324,IL,1535,9934,,,,,,,,,9c757789b4681fc36efffd962d3e75fb4ee6374f,2020-03-24T20:00:00Z,16,,11469,11469,11469,17,4,0,1351,262,1613
20200324,IN,365,2566,,,1,,,,,,d20aff6badc212807b7cd5db58fc6d2b08795e49,2020-03-24T20:00:00Z,12,1,2931,2931,2931,18,5,0,865,106,971
20200324,KS,98,2086,,,,,,,,,282cc098a42c426e6cf2f9a0d3fcff306bfe1547,2020-03-24T20:00:00Z,2,,2184,2184,2184,20,0,0,1669,16,1685
20200324,KY,124,1762,,,,,,,,,7f736e70b653bb755683c7b68cb76e5e19b363de,2020-03-24T20:00:00Z,4,,1886,1886,1886,21,1,0,0,20,20
20200324,LA,1388,7215,,271,,,,,,,ae625456c944c9cff54c9690466a68e937f61f64,2020-03-24T20:00:00Z,46,,8603,8603,8603,22,12,0,2439,216,2655
20200324,MA,1060,12714,,,94,,,,,,9410b9703db5cd502e3d4a69df155f78582d5657,2020-03-24T20:00:00Z,26,94,13774,13774,13774,25,9,15,4451,382,4833
20200324,MD,349,94,,,,,,,,,266357ae1f44a606612441a5a7418a525dda2e4b,2020-03-24T20:00:00Z,3,,443,443,443,24,0,0,0,61,61
20200324,ME,125,3014,,,,,,,,,9f0c2d2a6bfd36968270dd1dce4ecdfcb0e894bd,2020-03-24T20:00:00Z,,,3139,3139,3139,23,0,0,223,18,241
20200324,MI,6441,5796,,,,,,,,,66254caf8469cb1c8d0754f0db17253a5d906c37,2020-03-24T20:00:00Z,24,,12237,12237,12237,26,9,0,1099,652,1751
20200324,MN,262,5550,,,21,,,,,,4359be22f1d018582c52f57f0005ecd6da7e3697,2020-03-24T20:00:00Z,1,21,5812,5812,5812,27,0,4,1039,27,1066
20200324,MO,183,369,,,,,,,,,9e947531084071a07ed377efd8d57dac769fed9f,2020-03-24T20:00:00Z,3,,552,552,552,29,0,0,0,0,0
20200324,MP,0,,,,,,,,,,52d83ea3d9e40fdcb085782a62b7e421b38959eb,2020-03-24T20:00:00Z,0,,0,0,0,69,0,0,0,0,0
20200324,MS,320,1552,,,86,,,,,,4b6d159c684e2e8f23fc95e94397d786890afbd4,2020-03-24T20:00:00Z,1,86,1872,1872,1872,28,0,53,409,71,480
20200324,MT,46,1643,,,,,,,,,fc865b228236789c9beaaf57416291a8b341f1ed,2020-03-24T20:00:00Z,,,1689,1689,1689,30,0,0,497,12,509
20200324,NC,398,8141,,,,,,,,,48a75030e4fdc67a802eb4afde3e104c229b4eca,2020-03-24T20:00:00Z,0,,8539,8539,8539,37,0,0,0,101,101
20200324,ND,34,1454,,,5,,,,,,4e468d07760eca0f47732febc8a8afab1800febe,2020-03-24T20:00:00Z,0,5,1488,1488,1488,38,0,1,101,4,105
20200324,NE,52,975,,,,,,,,,8b9d1afc73a62509d249a7f707364e01b05db6b1,2020-03-24T20:00:00Z,0,,1027,1027,1027,31,0,0,619,2,621
20200324,NH,101,1447,869,,11,,,,,,eb6013bb5115cbbe92d9b4d3830dd1fc8f64c164,2020-03-24T20:00:00Z,1,11,2417,1548,1548,33,1,11,73,23,96
20200324,NJ,3675,8325,45,,,,,,,,3298b6676fb93503cc4695dfd502db188db72854,2020-03-24T20:00:00Z,44,,12045,12000,12000,34,17,0,7966,831,8797
20200324,NM,83,5890,,,,,,,,,01ee7963abb7aa5321d1d1ea06baaad72fc05588,2020-03-24T20:00:00Z,,,5973,5973,5973,35,0,0,569,18,587
20200324,NV,278,3954,,,,,,,,,7850dc16931857b0e4f9b31620513a89c7ce8cda,2020-03-24T20:00:00Z,4,,4232,4232,4232,32,0,0,464,33,497
20200324,NY,25665,65605,,3343,3234,,,,,,d6f0b735999481a6fec3c24c58d95bc9ba13a6b3,2020-03-24T20:00:00Z,210,3234,91270,91270,91270,36,96,599,8191,4790,12981
20200324,OH,564,140,,,145,,,,,,63b5a22304ed473e83bfbf270a76c1032acea29e,2020-03-24T20:00:00Z,8,145,704,704,704,39,2,41,0,122,122
20200324,OK,106,735,,,25,,,,,,6f7920a3fbf6e8734988631827d4e088b3e392e1,2020-03-24T20:00:00Z,3,25,841,841,841,40,1,10,41,25,66
20200324,OR,209,4350,,,61,,,,,,48f6f90138b010e86974032f5c2c2831e7fb4a75,2020-03-24T20:00:00Z,8,61,4559,4559,4559,41,3,5,701,18,719
20200324,PA,851,8643,,,,,,,,,ce0a280d338c6cb38fc09e23260c4a9d36b61a64,2020-03-24T20:00:00Z,7,,9494,9494,9494,42,1,0,2048,207,2255
20200324,PR,39,268,42,,,,,,,,a4422b62864b4880eb9b5ca60650238cb712aae5,2020-03-24T20:00:00Z,2,,349,307,307,72,0,0,79,8,87
20200324,RI,124,1200,77,,,,,,,,83b358e9dcb98725c3bf61a3b2beb27af76f6c0c,2020-03-24T20:00:00Z,,,1401,1324,1324,44,0,0,57,18,75
20200324,SC,298,2012,,,,,,,,,3ee6b47e4fe208a1a7422880f344f3f32f67679b,2020-03-24T20:00:00Z,5,,2310,2310,2310,45,0,0,546,0,546
20200324,SD,30,790,268,,,,,,,,f1b660e61e0b8a627c426d7b62a346a72b2e7797,2020-03-24T20:00:00Z,1,,1088,820,820,46,0,0,28,2,30
20200324,TN,667,10517,,,,,,,,,4c9bb8e4a36f22b926ee84af65928e341d4fef89,2020-03-24T20:00:00Z,2,,11184,11184,11184,47,0,0,7245,52,7297
20200324,TX,410,10757,,,,,,,,,f004eb8a9503c7e97a5fc6cd7c6d33278d7a4305,2020-03-24T20:00:00Z,9,,11167,11167,11167,48,1,0,1054,58,1112
20200324,UT,299,5524,,,,,,,,,ded18a05ae98e3a2dd796af47b0463703d38fd1e,2020-03-24T20:00:00Z,1,,5823,5823,5823,49,0,0,734,42,776
20200324,VA,290,4180,,,45,,,,,,c50739256e2bff651beb24c7d3bf783301d228bd,2020-03-24T20:00:00Z,7,45,4470,4470,4470,51,1,7,737,36,773
20200324,VI,17,,,,,,,,,,43ac7cddd17387c1b7958570250a1d74710ce525,2020-03-24T20:00:00Z,,,17,17,17,78,0,0,0,0,0
20200324,VT,95,1440,,,,,,,,,a0057043daf21cd5b60d9e10d5109d9aa2dbb574,2020-03-24T20:00:00Z,7,,1535,1535,1535,50,2,0,334,20,354
20200324,WA,2877,53341,,,,,,,,,893787b99a64e7c7bd548ea871aec60751510ad1,2020-03-24T20:00:00Z,146,,56218,56218,56218,53,9,0,4849,381,5230
20200324,WI,457,8237,,,,,,,,,f3b3b8071eeb99db0f8a0ba361cffbf1d17aa843,2020-03-24T20:00:00Z,5,,8694,8694,8694,55,0,0,1187,41,1228
20200324,WV,20,610,0,,1,,,,,,b1e8c04bf831d17f0262bc42ab7656b32f937f44,2020-03-24T20:00:00Z,0,1,630,630,630,54,0,0,166,4,170
20200324,WY,29,710,,,,,,,,,98459e884507e1d53a1bdd0bc4cb1ab9ccd26ffc,2020-03-24T20:00:00Z,,,739,739,739,56,0,0,118,3,121
20200323,AK,22,946,,,0,,,,,,476e17c6b73b3b5062fe1e1dba6f79e2dd1500f3,2020-03-23T20:00:00Z,0,0,968,968,968,02,0,0,0,0,0
20200323,AL,167,1665,,,,,,,,,83712877a917de925fb93de8aaa8443850e13f5e,2020-03-23T20:00:00Z,0,,1832,1832,1832,01,0,0,201,29,230
20200323,AR,174,906,,13,,,,,,,71896654761ce8d7ad037266afe060c7c3aca297,2020-03-23T20:00:00Z,0,,1080,1080,1080,05,0,0,195,9,204
20200323,AS,,,,,,,,,,,90a046f9acb7ff5dfa0d4311a5b944b5103ab579,2020-03-23T20:00:00Z,0,,0,0,0,60,0,0,0,0,0
20200323,AZ,265,309,6,,,,,,,,14d6aadf353c2d7f46fa679d1eef562ab766560e,2020-03-23T20:00:00Z,2,,580,574,574,04,0,0,27,113,140
20200323,CA,1733,12567,12100,,,,,,,,71c982ee815f7305f8cc4c93014774584620fa5f,2020-03-23T20:00:00Z,27,,26400,14300,14300,06,0,0,1263,197,1460
20200323,CO,591,4845,,74,58,,,,,,6ed9e7b28dc4485bafe179736fb6e52983f505d3,2020-03-23T20:00:00Z,6,58,5436,5436,5436,08,1,9,770,116,886
20200323,CT,415,4085,,54,,,,,,,d805e0c66ee0456c42148c9494eba857b18aec51,2020-03-23T20:00:00Z,10,,4500,4500,4500,09,5,0,1208,192,1400
20200323,DC,116,1113,,,,,,,,,a4ac9750469218e985257eae6f8bf345a38e2e94,2020-03-23T20:00:00Z,2,,1229,1229,1229,11,1,0,156,18,174
20200323,DE,68,36,,,,,,,,,ccdc7a3c1ce545efc42901ab13fd6f7add956503,2020-03-23T20:00:00Z,0,,104,104,104,10,0,0,0,12,12
20200323,FL,1171,11063,860,,217,,,,,,fefea265e78e4106c70c1907bee630dd8b5d76ad,2020-03-23T20:00:00Z,14,217,13094,12234,12234,12,1,32,3073,341,3414
20200323,GA,772,4297,,,,,,,,,0f7832c9c3f96874233ce85032ac2f2d78f66eb8,2020-03-23T20:00:00Z,25,,5069,5069,5069,13,2,0,877,172,1049
20200323,GU,29,161,,,,,,,,,ce31ff4a54165054ac6f5f94f5fe0f449c7fa847,2020-03-23T20:00:00Z,1,,190,190,190,66,0,0,35,2,37
20200323,HI,56,2955,,,,,,,,,a64b1c79f254b53625563c06841dd934ec71c54b,2020-03-23T20:00:00Z,,,3011,3011,3011,15,0,0,2692,8,2700
20200323,IA,105,2043,,,,,,,,,e300223bdb614731413a2a2689d16cd9d67b28be,2020-03-23T20:00:00Z,,,2148,2148,2148,19,0,0,828,15,843
20200323,ID,47,1309,,,,,,,,,671c3f6d3a73ffe687fb7f61e9f4ee48557c2217,2020-03-23T20:00:00Z,0,,1356,1356,1356,16,0,0,134,5,139
20200323,IL,1273,8583,,,,,,,,,0d6671c3e7d63029f51e664df09115c8458b7875,2020-03-23T20:00:00Z,12,,9856,9856,9856,17,3,0,1312,224,1536
20200323,IN,259,1701,,,1,,,,,,b98a92f68b8f40cdb0f7aac19be6caeff46c5480,2020-03-23T20:00:00Z,7,1,1960,1960,1960,18,1,0,408,58,466
20200323,KS,82,417,,,,,,,,,3e1f376103afb2bf2e72cbfb075ca706098eecda,2020-03-23T20:00:00Z,2,,499,499,499,20,0,0,0,18,18
20200323,KY,104,1762,,,,,,,,,1da5d1dc8e4c52e1ff55eb3170d02ea0200a4cb0,2020-03-23T20:00:00Z,3,,1866,1866,1866,21,0,0,290,5,295
20200323,LA,1172,4776,,,,,,,,,fd499be556bb029c4bc349ac19373d9ba7b95fcd,2020-03-23T20:00:00Z,34,,5948,5948,5948,22,14,0,2115,335,2450
20200323,MA,678,8263,,,79,,,,,,9e6e148409391c70c1c74dee92e8f7be5dba7c03,2020-03-23T20:00:00Z,17,79,8941,8941,8941,25,6,8,2787,131,2918
20200323,MD,288,94,,,,,,,,,6e4ed4b8716381c2a1daaa4d89c4647815bc188e,2020-03-23T20:00:00Z,3,,382,382,382,24,0,0,0,44,44
20200323,ME,107,2791,,,,,,,,,88636589511012ea8869a31269dbb2c701023479,2020-03-23T20:00:00Z,,,2898,2898,2898,23,0,0,527,18,545
20200323,MI,5789,4697,,,,,,,,,84a4b69577379e2159ba9c4e79e2bf4bae5122ff,2020-03-23T20:00:00Z,15,,10486,10486,10486,26,7,0,985,691,1676
20200323,MN,235,4511,,,17,,,,,,d688eeb57c635ed77ed2196359d616a3dae38e3e,2020-03-23T20:00:00Z,1,17,4746,4746,4746,27,0,5,0,66,66
20200323,MO,183,369,,,,,,,,,d451a8053ea326216b31c935b674d0457532b596,2020-03-23T20:00:00Z,3,,552,552,552,29,0,0,0,93,93
20200323,MP,0,,,,,,,,,,55022701b87eeeffb616fb7eae76d2e2fe55bb3b,2020-03-23T20:00:00Z,0,,0,0,0,69,0,0,0,0,0
20200323,MS,249,1143,,,33,,,,,,2ed97cbc9d4455685f466d3ba3c9e7edbd3413ef,2020-03-23T20:00:00Z,1,33,1392,1392,1392,28,0,0,29,42,71
20200323,MT,34,1146,,,,,,,,,e824730ff62964c60931b7f59c00c1e8ee7ea035,2020-03-23T20:00:00Z,,,1180,1180,1180,30,0,0,0,3,3
20200323,NC,297,8141,,,,,,,,,f498171c52256d450302d4d6e478d260e7d5b51d,2020-03-23T20:00:00Z,0,,8438,8438,8438,37,0,0,1958,42,2000
20200323,ND,30,1353,,,4,,,,,,b45813a4a0e083874a405d5ffb64d2944abf2d5f,2020-03-23T20:00:00Z,0,4,1383,1383,1383,38,0,1,93,2,95
20200323,NE,50,356,,,,,,,,,93f27986c82b8f07b7360321ad9d715951ff14e0,2020-03-23T20:00:00Z,0,,406,406,406,31,0,0,0,2,2
20200323,NH,78,1374,889,,,,,,,,ea9ab3f6c3061a5ed37885a1478f700d7c44c9b6,2020-03-23T20:00:00Z,,,2341,1452,1452,33,0,0,186,13,199
20200323,NJ,2844,359,94,,,,,,,,31b24615de8d15c0b6de14c1d8d6d4f06708f56f,2020-03-23T20:00:00Z,27,,3297,3203,3203,34,7,0,32,930,962
20200323,NM,65,5321,,,,,,,,,fd468d865dcbf3b9efc33a3819fbe8ad824cbec7,2020-03-23T20:00:00Z,,,5386,5386,5386,35,0,0,599,8,607
20200323,NV,245,3490,,,,,,,,,fb2100c3617a15181d8fdb28298b8be70790c0e0,2020-03-23T20:00:00Z,4,,3735,3735,3735,32,2,0,1042,55,1097
20200323,NY,20875,57414,,2629,2635,,,,,,e2fc8b5cc39977e28dfb6194b47a259e7f893735,2020-03-23T20:00:00Z,114,2635,78289,78289,78289,36,0,661,11181,5707,16888
20200323,OH,442,140,,,104,,,,,,8966d12c492b67747a0413f8a0fb4ee97bc8b1d6,2020-03-23T20:00:00Z,6,104,582,582,582,39,3,21,0,91,91
20200323,OK,81,694,102,,15,,,,,,06988832908c4bd0101aa70897aaa31f44bf1f07,2020-03-23T20:00:00Z,2,15,877,775,775,40,0,4,25,14,39
20200323,OR,191,3649,,,56,,,,,,d32dc80aee60746bbda8cd2ded2558efd103b76d,2020-03-23T20:00:00Z,5,56,3840,3840,3840,41,1,13,785,30,815
20200323,PA,644,6595,,,,,,,,,f34848bd60ba259abd8ba905bbf1a2edc2e450da,2020-03-23T20:00:00Z,6,,7239,7239,7239,42,4,0,1631,165,1796
20200323,PR,31,189,35,,,,,,,,f11fb4d67e27feb9ecd7b591d6c96fd2073b15eb,2020-03-23T20:00:00Z,2,,255,220,220,72,2,0,6,8,14
20200323,RI,106,1143,216,,,,,,,,e756bdb973c135644d91e1f1cd4a9f53467e0375,2020-03-23T20:00:00Z,,,1465,1249,1249,44,0,0,211,23,234
20200323,SC,298,1466,,,,,,,,,6065c53119b350f0a5abc09e33240e8344459d65,2020-03-23T20:00:00Z,5,,1764,1764,1764,45,2,0,0,103,103
20200323,SD,28,762,265,,,,,,,,042646860048b05f38e0717c8322ccb5dcf0a33e,2020-03-23T20:00:00Z,1,,1055,790,790,46,0,0,22,7,29
20200323,TN,615,3272,,,,,,,,,2c5ac2c1a6353ca8ed3b942a6580e298e333a7ff,2020-03-23T20:00:00Z,2,,3887,3887,3887,47,2,0,0,110,110
20200323,TX,352,9703,,,,,,,,,b8898c676a614ee7ce5cba28465922cb7b1b025e,2020-03-23T20:00:00Z,8,,10055,10055,10055,48,3,0,1281,18,1299
20200323,UT,257,4790,,,,,,,,,1c0d56f6022578f0b588db0251a1c880d278c1c8,2020-03-23T20:00:00Z,1,,5047,5047,5047,49,0,0,1282,76,1358
20200323,VA,254,3443,,,38,,,,,,f04ccf03a897d757c0d98d7b10c12edb59dbbc33,2020-03-23T20:00:00Z,6,38,3697,3697,3697,51,3,6,325,35,360
20200323,VI,17,,,,,,,,,,6b742c14c76705483cc3fe5bb6aeb86828d935de,2020-03-23T20:00:00Z,,,17,17,17,78,0,0,0,11,11
20200323,VT,75,1106,,,,,,,,,72af0f2c9c2f632f233a942199d61c606b68fd90,2020-03-23T20:00:00Z,5,,1181,1181,1181,50,3,0,0,23,23
20200323,WA,2496,48492,,,,,,,,,c569e736b5f462b779b02176a2fad6942cd2a19c,2020-03-23T20:00:00Z,137,,50988,50988,50988,53,11,0,4852,212,5064
20200323,WI,416,7050,,,,,,,,,4d367dd2bdc949d101983f7dca73a29062b3f1f7,2020-03-23T20:00:00Z,5,,7466,7466,7466,55,1,0,820,31,851
20200323,WV,16,444,4,,1,,,,,,93a7366dbdbbe8314dac0702465b28a583e20467,2020-03-23T20:00:00Z,0,1,464,460,460,54,0,0,59,4,63
20200323,WY,26,592,,,,,,,,,61e5cc96d0195daeb49d495e5abec3130fbb841f,2020-03-23T20:00:00Z,,,618,618,618,56,0,0,154,2,156
20200322,AK,22,946,,,0,,,,,,954538b091e0df5320af2ba9881b4b4e9a10fcb2,2020-03-22T20:00:00Z,0,0,968,968,968,02,0,0,188,8,196
20200322,AL,138,1464,,,,,,,,,336c2b990aa3df11f73436c012fb53a71c5b36fd,2020-03-22T20:00:00Z,0,,1602,1602,1602,01,0,0,1436,14,1450
20200322,AR,165,711,119,13,,,,,,,7a7789c5ffc39500e1fb19708f57b9c5729c8530,2020-03-22T20:00:00Z,0,,995,876,876,05,0,0,144,47,191
20200322,AS,,,,,,,,,,,7922fdb5c81d4a4b4549e23485608a699255d3c9,2020-03-22T20:00:00Z,0,,0,0,0,60,0,0,0,0,0
20200322,AZ,152,282,87,,,,,,,,4cbd0a587cb58735684352d0a8dea494c4e5510a,2020-03-22T20:00:00Z,2,,521,434,434,04,1,0,42,48,90
20200322,CA,1536,11304,,,,,,,,,894c0795f019e9dad5fb2ea4b76464bd93ca011e,2020-03-22T20:00:00Z,27,,12840,12840,12840,06,3,0,55,257,312
20200322,CO,475,4075,,56,49,,,,,,168a6003a0f0dc9dd310312e1b35b8d0cc2ccf77,2020-03-22T20:00:00Z,5,49,4550,4550,4550,08,1,5,758,112,870
20200322,CT,223,2877,,43,,,,,,,9bc80cd28db75381e9b8018f53c24796f3b6a842,2020-03-22T20:00:00Z,5,,3100,3100,3100,09,1,0,771,29,800
20200322,DC,98,957,,,,,,,,,6cd7f2b5c81f8b714e6564b8bcd9309604c9d92e,2020-03-22T20:00:00Z,1,,1055,1055,1055,11,0,0,451,21,472
20200322,DE,56,36,,,,,,,,,853edea9e9aa87a30f9e8d40e2f4a73735f35606,2020-03-22T20:00:00Z,0,,92,92,92,10,0,0,0,11,11
20200322,FL,830,7990,963,,185,,,,,,4e90c613758e8eb9c13d69d3d68c462bba4cb68f,2020-03-22T20:00:00Z,13,185,9783,8820,8820,12,1,27,1411,172,1583
20200322,GA,600,3420,,,,,,,,,69702dd23d01e4995145ae809b89338c1dd848e2,2020-03-22T20:00:00Z,23,,4020,4020,4020,13,9,0,863,93,956
20200322,GU,27,126,,,,,,,,,760562a7cce7809e06d7d66233f2168e78f3ae9f,2020-03-22T20:00:00Z,1,,153,153,153,66,1,0,18,12,30
20200322,HI,48,263,,,,,,,,,6daf3b6060a3ba24489bc466e6e5c190b15955c4,2020-03-22T20:00:00Z,,,311,311,311,15,0,0,139,11,150
20200322,IA,90,1215,,,,,,,,,0d5c8c0464af1d50dab5ca09cb810e469781a539,2020-03-22T20:00:00Z,,,1305,1305,1305,19,0,0,166,22,188
20200322,ID,42,1175,,,,,,,,,f79d41155ce5dde0d4087aceff09c30b8b2f5ad9,2020-03-22T20:00:00Z,0,,1217,1217,1217,16,0,0,295,11,306
20200322,IL,1049,7271,,,,,,,,,54f72764f10b61ac90bf334158a12c9193e78805,2020-03-22T20:00:00Z,9,,8320,8320,8320,17,3,0,1783,296,2079
20200322,IN,201,1293,,,1,,,,,,753c16b219930207a817b10f2ad60504a7a5762d,2020-03-22T20:00:00Z,6,1,1494,1494,1494,18,2,0,586,75,661
20200322,KS,64,417,,,,,,,,,699f1a58fbe837f26dfaa7bf2bb51d82ce9c6928,2020-03-22T20:00:00Z,2,,481,481,481,20,0,0,0,9,9
20200322,KY,99,1472,,,,,,,,,a9002192cd7888064a4a40cd704e6b6f19933dc9,2020-03-22T20:00:00Z,3,,1571,1571,1571,21,1,0,758,45,803
20200322,LA,837,2661,,,,,,,,,c89220ae4e2b0931fb785ec35f44887bf5a5355b,2020-03-22T20:00:00Z,20,,3498,3498,3498,22,4,0,481,252,733
20200322,MA,547,5476,,,71,,,,,,3d4cfd567423a3cab8ff964a3f62edad1abd7bf4,2020-03-22T20:00:00Z,11,71,6023,6023,6023,25,4,10,677,121,798
20200322,MD,244,94,,,,,,,,,d9cf183ca3af60eaff0e839e6542a4ae56000e2d,2020-03-22T20:00:00Z,3,,338,338,338,24,1,0,0,54,54
20200322,ME,89,2264,,,,,,,,,75a9c5c5d650bb96972accb662c7a1498fc48e10,2020-03-22T20:00:00Z,,,2353,2353,2353,23,0,0,0,16,16
20200322,MI,5098,3712,,,,,,,,,c9cf971e323b571b235d5f65cab54d551f16a902,2020-03-22T20:00:00Z,8,,8810,8810,8810,26,3,0,16,555,571
20200322,MN,169,4511,,,12,,,,,,eca43d6a5a1e21aef9b115cbf6c37684dfe5daff,2020-03-22T20:00:00Z,1,12,4680,4680,4680,27,0,12,559,31,590
20200322,MO,90,369,,,,,,,,,4ccad6d58d6ff133d8f62d55cdee11096e9c76c3,2020-03-22T20:00:00Z,3,,459,459,459,29,0,0,0,17,17
20200322,MP,0,,,,,,,,,,47a1f8351b146d34fc8eca53b5de76e4487e7dcc,2020-03-22T20:00:00Z,0,,0,0,0,69,0,0,0,0,0
20200322,MS,207,1114,,,33,,,,,,894b62e8c387654b1a0363daf8a6664d1ec4f1a3,2020-03-22T20:00:00Z,1,33,1321,1321,1321,28,0,33,419,67,486
20200322,MT,31,1146,,,,,,,,,b2c90f7ae286607e49a984824d71835787a69bf8,2020-03-22T20:00:00Z,,,1177,1177,1177,30,0,0,0,11,11
20200322,NC,255,6183,,,,,,,,,f7ae5da72d04953c92dbeded88d4532bcc0e7cf5,2020-03-22T20:00:00Z,0,,6438,6438,6438,37,0,0,1091,71,1162
20200322,ND,28,1260,,,3,,,,,,7549a624b49809d6eac8a3c40e3b6617c40ff00a,2020-03-22T20:00:00Z,0,3,1288,1288,1288,38,0,0,119,0,119
20200322,NE,48,356,,,,,,,,,7689257b7671d64bc5dc19ab900cc8be6d724b4a,2020-03-22T20:00:00Z,0,,404,404,404,31,0,0,0,10,10
20200322,NH,65,1188,959,,,,,,,,0b7e1e183feb671d98bc630201bb3f4af7bf1187,2020-03-22T20:00:00Z,,,2212,1253,1253,33,0,0,215,10,225
20200322,NJ,1914,327,49,,,,,,,,facc3296d95ab4cdeff98dca4f6628c0c6c8a193,2020-03-22T20:00:00Z,20,,2290,2241,2241,34,4,0,33,587,620
20200322,NM,57,4722,,,,,,,,,41571c753abe314b81f1a7a40a28672e2d5620c0,2020-03-22T20:00:00Z,,,4779,4779,4779,35,0,0,951,0,951
20200322,NV,190,2448,,,,,,,,,0dc69efb9cfc8c62e6017e048e94bd390c94d17a,2020-03-22T20:00:00Z,2,,2638,2638,2638,32,0,0,64,66,130
20200322,NY,15168,46233,,2043,1974,,,,,,ad2d93083f335f0a9bfa72ed8711ba982bf1592c,2020-03-22T20:00:00Z,114,1974,61401,61401,61401,36,70,371,11152,4812,15964
20200322,OH,351,140,,,83,,,,,,39a31d5f0d426b43011e943369aa758634b79c97,2020-03-22T20:00:00Z,3,83,491,491,491,39,0,25,0,104,104
20200322,OK,67,669,102,,11,,,,,,9ffd88f2064177c641dd3d488b2e05f323b81e67,2020-03-22T20:00:00Z,2,11,838,736,736,40,1,1,109,14,123
20200322,OR,161,2864,,,43,,,,,,ce0d62ce9e64793f5c0c0061df7f500c056f1f94,2020-03-22T20:00:00Z,4,43,3025,3025,3025,41,1,43,861,47,908
20200322,PA,479,4964,,,,,,,,,e55025d414359bd8039b3a89935560cdf0759885,2020-03-22T20:00:00Z,2,,5443,5443,5443,42,0,0,1198,108,1306
20200322,PR,23,183,69,,,,,,,,0687c7ff3672264c3265a35d79b30261de725d94,2020-03-22T20:00:00Z,,,275,206,206,72,0,0,40,2,42
20200322,RI,83,932,216,,,,,,,,336ba62e784bf62845374085980f220843d7ec7a,2020-03-22T20:00:00Z,,,1231,1015,1015,44,0,0,70,17,87
20200322,SC,195,1466,,,,,,,,,f3e5741d5023be2ca84d4a5214e6358c0c04ceeb,2020-03-22T20:00:00Z,3,,1661,1661,1661,45,2,0,211,43,254
20200322,SD,21,740,277,,,,,,,,941d3d4dd057bb31c2e6d38e1b899825feffd220,2020-03-22T20:00:00Z,1,,1038,761,761,46,0,0,49,7,56
20200322,TN,505,3272,,,,,,,,,fd0f694ad2179b8cf66684537a9072b0649eed59,2020-03-22T20:00:00Z,,,3777,3777,3777,47,0,0,0,134,134
20200322,TX,334,8422,,,,,,,,,b4cdb42d93deee8dd849c6c76a750d6cf2bcc16d,2020-03-22T20:00:00Z,5,,8756,8756,8756,48,0,0,2204,30,2234
20200322,UT,181,3508,,,,,,,,,3de2bbed886da550ffa13c9dc65e5535094d41bc,2020-03-22T20:00:00Z,1,,3689,3689,3689,49,1,0,1084,45,1129
20200322,VA,219,3118,,,32,,,,,,47ee4fa81f1a7aa2fadcb7ad212b0f2a82b88b1f,2020-03-22T20:00:00Z,3,32,3337,3337,3337,51,1,7,480,67,547
20200322,VI,6,,,,,,,,,,f0d0049f24eea564dc84e057f5001fe4dfeb4701,2020-03-22T20:00:00Z,,,6,6,6,78,0,0,0,0,0
20200322,VT,52,1106,,,,,,,,,a0b8449a701d2d442dc5b5fadad80a005d26261b,2020-03-22T20:00:00Z,2,,1158,1158,1158,50,0,0,327,23,350
20200322,WA,2284,43640,,,,,,,,,e11f25cc2ab36397d56303350f934b133ec6791f,2020-03-22T20:00:00Z,126,,45924,45924,45924,53,15,0,1704,242,1946
20200322,WI,385,6230,,,,,,,,,5c152a9b70d088a432901c770430f27845f16456,2020-03-22T20:00:00Z,4,,6615,6615,6615,55,0,0,1602,104,1706
20200322,WV,12,385,1,,1,,,,,,0d111a66e470107a431de577c6d88b5504353ada,2020-03-22T20:00:00Z,0,1,398,397,397,54,0,0,55,1,56
20200322,WY,24,438,,,,,,,,,750fd7dc66060691c7f4a95b90a3f9f941c5222b,2020-03-22T20:00:00Z,,,462,462,462,56,0,0,0,1,1
20200321,AK,14,758,,,0,,,,,,5c2c153aecba0fd7ce4d4fa3e861773b9e00cd7f,2020-03-21T20:00:00Z,0,0,772,772,772,02,0,0,72,2,74
20200321,AL,124,28,,,,,,,,,de15c7bdfb3b72e13399f1aaa8d69612f69f0837,2020-03-21T20:00:00Z,0,,152,152,152,01,0,0,0,43,43
20200321,AR,118,567,154,,,,,,,,be7b0d560d9725c09fd5b6c5c63b15bb489164e8,2020-03-21T20:00:00Z,,,839,685,685,05,0,0,216,22,238
20200321,AS,,,,,,,,,,,33990faa3753488ca4df5d2b72fd1f6afe43e9bf,2020-03-21T20:00:00Z,0,,0,0,0,60,0,0,0,0,0
20200321,AZ,104,240,122,,,,,,,,c4d69ffe430a0b9d8e0af64e25058aedfdcac703,2020-03-21T20:00:00Z,1,,466,344,344,04,1,0,29,39,68
20200321,CA,1279,11249,,,,,,,,,49c4e45a8661e84906ca87575ab8d30e7c494b6c,2020-03-21T20:00:00Z,24,,12528,12528,12528,06,4,0,825,216,1041
20200321,CO,363,3317,,,44,,,,,,167a0c3ceb00a06a5b8dc5ed629b4e1e38ec9ea1,2020-03-21T20:00:00Z,4,44,3680,3680,3680,08,1,44,642,86,728
20200321,CT,194,2106,,,,,,,,,7366c98d6eeab0fb8ef1f185d59d99cbd4c2a6b8,2020-03-21T20:00:00Z,4,,2300,2300,2300,09,1,0,1502,0,1502
20200321,DC,77,506,0,,,,,,,,aec17bd719975bbec3f0d91dd96a3eb1b1aaef3e,2020-03-21T20:00:00Z,1,,583,583,583,11,0,0,5,6,11
20200321,DE,45,36,,,,,,,,,9df04d2ff8e944c3501daa02149467845c6fad89,2020-03-21T20:00:00Z,0,,81,81,81,10,0,0,0,7,7
20200321,FL,658,6579,1002,,158,,,,,,9fcedaea4a2b5e2daad7c2ef3cae3d7c4a66d46c,2020-03-21T20:00:00Z,12,158,8239,7237,7237,12,2,158,4709,138,4847
20200321,GA,507,2557,,,,,,,,,fa63ec9c063c79b907568e755be9a52e3851b5e5,2020-03-21T20:00:00Z,14,,3064,3064,3064,13,1,0,591,87,678
20200321,GU,15,108,,,,,,,,,bcf4bfbdb666a8125546ac9fa1bde5a40314887c,2020-03-21T20:00:00Z,,,123,123,123,66,0,0,22,1,23
20200321,HI,37,124,,,,,,,,,5aef6714da1cfef8b0994bce03b3381f2988ed06,2020-03-21T20:00:00Z,,,161,161,161,15,0,0,0,11,11
20200321,IA,68,1049,,,,,,,,,b528ea4ecdc29227ff49d0ab40010fdb7bf04aea,2020-03-21T20:00:00Z,,,1117,1117,1117,19,0,0,407,23,430
20200321,ID,31,880,,,,,,,,,1268984bb40128971dfbbbdf403635e18e6f7435,2020-03-21T20:00:00Z,,,911,911,911,16,0,0,290,8,298
20200321,IL,753,5488,,,,,,,,,dfaf7e4b5931f46806fd364b0e61a3dbe2fe4550,2020-03-21T20:00:00Z,6,,6241,6241,6241,17,1,0,1792,168,1960
20200321,IN,126,707,,,1,,,,,,13d8880065d2c2f4c3379631774752a809f99330,2020-03-21T20:00:00Z,4,1,833,833,833,18,2,1,232,47,279
20200321,KS,55,417,,,,,,,,,0d27ae2aac0674330f6e9556a34def2a48ade762,2020-03-21T20:00:00Z,2,,472,472,472,20,1,0,0,11,11
20200321,KY,54,714,,,,,,,,,e6bdc1623c24ec023b4fea42690fb3d28619b944,2020-03-21T20:00:00Z,2,,768,768,768,21,1,0,122,7,129
20200321,LA,585,2180,,,,,,,,,f7c6c177e7b1f643227b1bc755f63bbb75468835,2020-03-21T20:00:00Z,16,,2765,2765,2765,22,4,0,1612,106,1718
20200321,MA,426,4799,,,61,,,,,,ea44031a9b4520f82e82ef24b6636ac5108f147f,2020-03-21T20:00:00Z,7,61,5225,5225,5225,25,2,61,1004,112,1116
20200321,MD,190,94,,,,,,,,,4cac298bc1adaf891591b29d4b8eb0cd3ffef248,2020-03-21T20:00:00Z,2,,284,284,284,24,1,0,0,41,41
20200321,ME,73,2264,,,,,,,,,dd280f45b75f2790185aabea6a93f1539dcd6c4a,2020-03-21T20:00:00Z,,,2337,2337,2337,23,0,0,0,16,16
20200321,MI,4543,3696,,,,,,,,,6691cb2bbe72d2abaf40892430dbb9edc0633e4f,2020-03-21T20:00:00Z,5,,8239,8239,8239,26,2,0,950,516,1466
20200321,MN,138,3952,,,,,,,,,c8e20e13bb45ac57df76285e119c0769f67c89ea,2020-03-21T20:00:00Z,1,,4090,4090,4090,27,1,0,211,23,234
20200321,MO,73,369,,,,,,,,,4c5ecaada5fac9b16c463e5e42cff715b3ad3efb,2020-03-21T20:00:00Z,3,,442,442,442,29,2,0,0,26,26
20200321,MP,0,,,,,,,,,,97c8946fa6d5bb252c7aa2f2ee65129cf5fd9dde,2020-03-21T20:00:00Z,0,,0,0,0,69,0,0,0,0,0
20200321,MS,140,695,,,,,,,,,05eb75b1e562b9e17f37c33e0678a91de01249c7,2020-03-21T20:00:00Z,1,,835,835,835,28,0,0,0,60,60
20200321,MT,20,1146,,,,,,,,,21bc115fe9533e51dfac6d8defee24a86919d9a3,2020-03-21T20:00:00Z,,,1166,1166,1166,30,0,0,215,4,219
20200321,NC,184,5092,,,,,,,,,bc8438b4be03c06d8b21bb306fa8bcade8848a98,2020-03-21T20:00:00Z,0,,5276,5276,5276,37,0,0,1996,47,2043
20200321,ND,28,1141,,,3,,,,,,e9d65a0e24737712855433e9427b090d5d58befa,2020-03-21T20:00:00Z,0,3,1169,1169,1169,38,0,3,341,8,349
20200321,NE,38,356,,,,,,,,,5ba9131cf10b134a34623b70bf8983dbc48c9272,2020-03-21T20:00:00Z,0,,394,394,394,31,0,0,116,6,122
20200321,NH,55,973,942,,,,,,,,71e8c55d1c62bedffae8403188aa39dedc642ba9,2020-03-21T20:00:00Z,,,1970,1028,1028,33,0,0,228,11,239
20200321,NJ,1327,294,40,,,,,,,,619c8150d5592b43e0b0c8a542f3ce57862c85b9,2020-03-21T20:00:00Z,16,,1661,1621,1621,34,5,0,30,437,467
20200321,NM,57,3771,,,,,,,,,5b0fa970db849e97ab1b9c07d675a9ac7ace9f7c,2020-03-21T20:00:00Z,,,3828,3828,3828,35,0,0,0,14,14
20200321,NV,124,2384,,,,,,,,,c0c98568c4165cc83bc5ee07b50589fdfb35f7e4,2020-03-21T20:00:00Z,2,,2508,2508,2508,32,1,0,392,15,407
20200321,NY,10356,35081,,1436,1603,,,,,,8e4add7ef91d7030d274a1e089368544f68a02bd,2020-03-21T20:00:00Z,44,1603,45437,45437,45437,36,9,1603,9756,3254,13010
20200321,OH,247,140,,,58,,,,,,dd1dfcf33ceacdd2502013ab34d3156f97223334,2020-03-21T20:00:00Z,3,58,387,387,387,39,2,58,0,78,78
20200321,OK,53,560,144,,10,,,,,,1503e792121ec9bc0aa951a7efe032de95f66efd,2020-03-21T20:00:00Z,1,10,757,613,613,40,0,10,22,4,26
20200321,OR,114,2003,433,,,,,,,,10b3171e833e613dedf31c1ac227cc4a45ef6ea0,2020-03-21T20:00:00Z,3,,2550,2117,2117,41,0,0,0,0,0
20200321,PA,371,3766,,,,,,,,,18df8e2622a5b9fc6b266124af168742b75d3bae,2020-03-21T20:00:00Z,2,,4137,4137,4137,42,1,0,1192,103,1295
20200321,PR,21,143,71,,,,,,,,da8e3b5ccde7f2d73b65a882224183f80e407fb8,2020-03-21T20:00:00Z,,,235,164,164,72,0,0,29,7,36
20200321,RI,66,862,290,,,,,,,,00d75088744e90ea4359ef44da37b2c1048d4897,2020-03-21T20:00:00Z,,,1218,928,928,44,0,0,62,12,74
20200321,SC,152,1255,,,,,,,,,4e3f5cbdfb98432f0e6cc8c36ace53a52b5fd93a,2020-03-21T20:00:00Z,1,,1407,1407,1407,45,0,0,422,71,493
20200321,SD,14,691,268,,,,,,,,faf893694ef24b3ff6f7e4f3332d1cf892dc1326,2020-03-21T20:00:00Z,1,,973,705,705,46,0,0,28,0,28
20200321,TN,371,3272,,,,,,,,,9944d4fad172ece09a78536be10dcc0a6baac09c,2020-03-21T20:00:00Z,,,3643,3643,3643,47,0,0,2709,143,2852
20200321,TX,304,6218,,,,,,,,,54267227a81424058326d8ead3199e15f96b8d75,2020-03-21T20:00:00Z,5,,6522,6522,6522,48,0,0,1135,110,1245
20200321,UT,136,2424,,,,,,,,,1612a05ae5f2350863da87addf0e11159a1c4d0c,2020-03-21T20:00:00Z,0,,2560,2560,2560,49,0,0,389,24,413
20200321,VA,152,2638,,,25,,,,,,d3642dd2689ddb450f271a5e4940f134feb53a28,2020-03-21T20:00:00Z,2,25,2790,2790,2790,51,0,25,427,38,465
20200321,VI,6,,,,,,,,,,8a702969528e608f86ccfa38aae03ce28d1ccb7a,2020-03-21T20:00:00Z,,,6,6,6,78,0,0,0,3,3
20200321,VT,29,779,,,,,,,,,3f90c35f316a9595018f2748e50ff309811694ef,2020-03-21T20:00:00Z,2,,808,808,808,50,0,0,0,0,0
20200321,WA,2042,41936,,,,,,,,,cd0197ba34b732696424cbfe63e1b92e17cea466,2020-03-21T20:00:00Z,111,,43978,43978,43978,53,7,0,2108,238,2346
20200321,WI,281,4628,,,,,,,,,ba16b5db1cba4db66a6ee6542b106fe8c6241158,2020-03-21T20:00:00Z,4,,4909,4909,4909,55,1,0,1173,75,1248
20200321,WV,11,330,2,,1,,,,,,f3880f455a42ec088a063f9603e227fe8aa81d3f,2020-03-21T20:00:00Z,0,1,343,341,341,54,0,1,111,4,115
20200321,WY,23,438,,,,,,,,,063d5a2701dc617e21c78eacebf5071aca0390d6,2020-03-21T20:00:00Z,,,461,461,461,56,0,0,107,4,111
20200320,AK,12,686,,,,,,,,,f5e95e78ffb0a39f678cc41f7150889f11283e91,2020-03-20T20:00:00Z,0,,698,698,698,02,0,0,254,6,260
20200320,AL,81,28,,,,,,,,,6bbe154eecf958487c0256f6d6b95eae55c038d8,2020-03-20T20:00:00Z,0,,109,109,109,01,0,0,0,13,13
20200320,AR,96,351,203,,,,,,,,a85b5e8267c40317cdb4da0571e60d619c4f1275,2020-03-20T20:00:00Z,,,650,447,447,05,0,0,41,50,91
20200320,AS,,,,,,,,,,,07e460e49bf39e109c17495d88e1fde81b6984fd,2020-03-20T20:00:00Z,0,,0,0,0,60,0,0,0,0,0
20200320,AZ,65,211,101,,,,,,,,4727c3fdde576abf2bb11deceeacd79954e5fc0e,2020-03-20T20:00:00Z,0,,377,276,276,04,0,0,36,21,57
20200320,CA,1063,10424,,,,,,,,,22cfcbb820f66309386b4bdfdf47a806dd894a62,2020-03-20T20:00:00Z,20,,11487,11487,11487,06,2,0,1637,139,1776
20200320,CO,277,2675,,,,,,,,,3cc3cb3b8ada93585da9e20600cd49332188e95c,2020-03-20T20:00:00Z,3,,2952,2952,2952,08,1,0,563,61,624
20200320,CT,194,604,,,,,,,,,8844ec1c291f1730400384b6236407c5eec4e772,2020-03-20T20:00:00Z,3,,798,798,798,09,2,0,0,98,98
20200320,DC,71,501,1,,,,,,,,555b285ce297b0e04969515fe501ec133644cabc,2020-03-20T20:00:00Z,1,,573,572,572,11,1,0,348,32,380
20200320,DE,38,36,,,,,,,,,b846106acafb3617a2651cecc862737a4e0595b3,2020-03-20T20:00:00Z,0,,74,74,74,10,0,0,0,8,8
20200320,FL,520,1870,1026,,,,,,,,18f30f4aef61df1aa3a4a339482c5ad20ea478ed,2020-03-20T20:00:00Z,10,,3416,2390,2390,12,2,0,337,130,467
20200320,GA,420,1966,,,,,,,,,c1099b472676eb4813360be325975832eeeecc23,2020-03-20T20:00:00Z,13,,2386,2386,2386,13,3,0,422,133,555
20200320,GU,14,86,,,,,,,,,159284c0d374c774364f46fa9817010818ece653,2020-03-20T20:00:00Z,,,100,100,100,66,0,0,17,2,19
20200320,HI,26,124,,,,,,,,,4a3f036b5b06c690c544eb042eb277a4a9a4d964,2020-03-20T20:00:00Z,,,150,150,150,15,0,0,31,10,41
20200320,IA,45,642,,,,,,,,,8931d868707d9cfae19d1d0bec4836030df44395,2020-03-20T20:00:00Z,,,687,687,687,19,0,0,559,7,566
20200320,ID,23,590,,,,,,,,,427bcf104280535a976cf8932de54622b12d896d,2020-03-20T20:00:00Z,,,613,613,613,16,0,0,131,12,143
20200320,IL,585,3696,,,,,,,,,e61e30bd87a3af08bb2a5424cf6eaaca3cfc48ca,2020-03-20T20:00:00Z,5,,4281,4281,4281,17,1,0,971,163,1134
20200320,IN,79,475,,,,,,,,,69bc9f151729b2c730f70ef1ed38d7b9b733d1c1,2020-03-20T20:00:00Z,2,,554,554,554,18,0,0,151,23,174
20200320,KS,44,417,,,,,,,,,a57d1e044d0fa2a45332c1043bab418d82737990,2020-03-20T20:00:00Z,1,,461,461,461,20,0,0,0,10,10
20200320,KY,47,592,,,,,,,,,5132aa1c50a7fc4af7f8ea55558e133917653621,2020-03-20T20:00:00Z,1,,639,639,639,21,0,0,138,12,150
20200320,LA,479,568,,,,,,,,,e67536ea67b77d8ca65be412882b0f4d055238f5,2020-03-20T20:00:00Z,12,,1047,1047,1047,22,4,0,110,132,242
20200320,MA,314,3795,,,,,,,,,009765885a75acdbe96e957d7a9036711a2e0085,2020-03-20T20:00:00Z,5,,4109,4109,4109,25,2,0,877,85,962
20200320,MD,149,94,,,,,,,,,9f5bf564b168c100be9bfa7869e3237c0307d9f2,2020-03-20T20:00:00Z,1,,243,243,243,24,0,0,0,42,42
20200320,ME,57,2264,,,,,,,,,0bbfa7a74e3391acd5aab61690ae8098d0a14554,2020-03-20T20:00:00Z,,,2321,2321,2321,23,0,0,260,4,264
20200320,MI,4027,2746,,,,,,,,,f1312c12fe7758511b43a9cc34b31b363ad9f7d8,2020-03-20T20:00:00Z,3,,6773,6773,6773,26,0,0,961,635,1596
20200320,MN,115,3741,,,,,,,,,4614bb4e80402ac12d217edcebc7fb8c0307722f,2020-03-20T20:00:00Z,,,3856,3856,3856,27,0,0,792,26,818
20200320,MO,47,369,,,,,,,,,4b0f45177c6372badaf3fc3cd21353d7cc037f86,2020-03-20T20:00:00Z,1,,416,416,416,29,0,0,61,23,84
20200320,MP,0,,,,,,,,,,082f47c47804486f21616c38aa13205a3fb6fbfb,2020-03-20T20:00:00Z,0,,0,0,0,69,0,0,0,0,0
20200320,MS,80,695,,,,,,,,,115279517e0a0ee05e43c6d5aed122d5b39b2670,2020-03-20T20:00:00Z,1,,775,775,775,28,1,0,143,30,173
20200320,MT,16,931,,,,,,,,,d05a98622d0fdf01680375131d34a96a6dabffe7,2020-03-20T20:00:00Z,,,947,947,947,30,0,0,170,4,174
20200320,NC,137,3096,,,,,,,,,7fb95d6505c8d7fe53b1f0b7dbe50120d88bb6c6,2020-03-20T20:00:00Z,0,,3233,3233,3233,37,0,0,688,40,728
20200320,ND,20,800,,,,,,,,,9163e5a9b67865ff295efd3f8a96912154727929,2020-03-20T20:00:00Z,0,,820,820,820,38,0,0,307,5,312
20200320,NE,32,240,,,,,,,,,4cda7034604f490921d79617c0010a5d350c0a41,2020-03-20T20:00:00Z,0,,272,272,272,31,0,0,0,5,5
20200320,NH,44,745,631,,,,,,,,17fa3bca875f292ca2284eb20eedeb139dfbfcdc,2020-03-20T20:00:00Z,,,1420,789,789,33,0,0,124,5,129
20200320,NJ,890,264,86,,,,,,,,42bf8537b56da3791417f26b573d6c19e37af697,2020-03-20T20:00:00Z,11,,1240,1154,1154,34,2,0,54,148,202
20200320,NM,43,3771,,,,,,,,,6d6b00ecb91b88b1a8eb243c140909f79393e03c,2020-03-20T20:00:00Z,,,3814,3814,3814,35,0,0,1009,8,1017
20200320,NV,109,1992,,,,,,,,,27448d6667cc2710aa2b41850b5f8993ef3f22da,2020-03-20T20:00:00Z,1,,2101,2101,2101,32,0,0,366,14,380
20200320,NY,7102,25325,,1042,,,,,,,a735d939b7040cf3631b8346871f68da6ac05505,2020-03-20T20:00:00Z,35,,32427,32427,32427,36,23,0,7193,2950,10143
20200320,OH,169,140,,,,,,,,,def0867b0c16cbafd9afe098983af7d8e0badd4c,2020-03-20T20:00:00Z,1,,309,309,309,39,1,0,0,50,50
20200320,OK,49,538,374,,,,,,,,e7f3b58b28391e52c4ba63eebe765a8da88bce50,2020-03-20T20:00:00Z,1,,961,587,587,40,0,0,72,5,77
20200320,OR,114,2003,433,,,,,,,,ce87d86e6068b6b11bf179616acd49af43d92ab8,2020-03-20T20:00:00Z,3,,2550,2117,2117,41,0,0,674,26,700
20200320,PA,268,2574,,,,,,,,,d618791d5664fb84a0a633890bae484ad6390590,2020-03-20T20:00:00Z,1,,2842,2842,2842,42,0,0,966,83,1049
20200320,PR,14,114,52,,,,,,,,045b02a40ddf42ca4604f3d36ace4f27f9fa9dd8,2020-03-20T20:00:00Z,,,180,128,128,72,0,0,58,9,67
20200320,RI,54,800,140,,,,,,,,2df5918bc646fad45cb2c82a3ee409952106a7ca,2020-03-20T20:00:00Z,,,994,854,854,44,0,0,146,10,156
20200320,SC,81,833,,,,,,,,,2b41a9dadec8fa07045ea3a0d9c92834ba77094f,2020-03-20T20:00:00Z,1,,914,914,914,45,0,0,250,21,271
20200320,SD,14,663,270,,,,,,,,0ff86be98a82aa41e2d3c093dcb848a516d082ed,2020-03-20T20:00:00Z,1,,947,677,677,46,0,0,112,3,115
20200320,TN,228,563,,,,,,,,,c30ab203ca516277f9337100529cc875d2cae47a,2020-03-20T20:00:00Z,,,791,791,791,47,0,0,214,74,288
20200320,TX,194,5083,,,,,,,,,41c1f53ffba2657e7fbd2eee03f09bebab402ec5,2020-03-20T20:00:00Z,5,,5277,5277,5277,48,2,0,2871,51,2922
20200320,UT,112,2035,,,,,,,,,df33dd66d88c6b1eddc25ca3aa7321769032d783,2020-03-20T20:00:00Z,0,,2147,2147,2147,49,0,0,587,34,621
20200320,VA,114,2211,,,,,,,,,998c78195dd294b9150ccec8e02a47681cc444d2,2020-03-20T20:00:00Z,2,,2325,2325,2325,51,0,0,382,20,402
20200320,VI,3,,,,,,,,,,8b5693fe1ff341165461c7845162147f7a4867fb,2020-03-20T20:00:00Z,,,3,3,3,78,0,0,0,0,0
20200320,VT,29,779,,,,,,,,,d08680597184a748ed263fab7f7a6137668d5566,2020-03-20T20:00:00Z,2,,808,808,808,50,2,0,134,7,141
20200320,WA,1804,39828,,,,,,,,,1ef5363ba482a4395aa001931c377d6e812c6efd,2020-03-20T20:00:00Z,104,,41632,41632,41632,53,12,0,3768,241,4009
20200320,WI,206,3455,,,,,,,,,93fb2a48a14e3d7dc1b46f9735b75d4f211b378b,2020-03-20T20:00:00Z,3,,3661,3661,3661,55,3,0,1263,51,1314
20200320,WV,7,219,13,,,,,,,,c12a447783ded752c0d37b29337ca4aa055bafab,2020-03-20T20:00:00Z,0,,239,226,226,54,0,0,76,5,81
20200320,WY,19,331,,,,,,,,,d557b1046d1d80ef9d04b645dd96406c2a94a0e6,2020-03-20T20:00:00Z,,,350,350,350,56,0,0,60,1,61
20200319,AK,6,432,,,,,,,,,5afe7032a8188d0f82e989ad852fa5d1526f6a27,2020-03-19T20:00:00Z,0,,438,438,438,02,0,0,26,0,26
20200319,AL,68,28,,,,,,,,,cab25ff0e7f7b888b8cba2df5c54273cad43f3ca,2020-03-19T20:00:00Z,0,,96,96,96,01,0,0,0,22,22
20200319,AR,46,310,113,,,,,,,,6c34774d075752263526df4bbad724959f80931e,2020-03-19T20:00:00Z,,,469,356,356,05,0,0,74,13,87
20200319,AS,,,,,,,,,,,b6dafad2357e2f121a0ff6b617fa7643d7b4774f,2020-03-19T20:00:00Z,0,,0,0,0,60,0,0,0,0,0
20200319,AZ,44,175,130,,,,,,,,76b253966cb27ac180f2a1954c05be32f66ffd3b,2020-03-19T20:00:00Z,0,,349,219,219,04,0,0,27,16,43
20200319,CA,924,8787,,,,,,,,,b9c67f8fde621d5bb8895c6a6fcbdcf8440ccf2a,2020-03-19T20:00:00Z,18,,9711,9711,9711,06,5,0,806,313,1119
20200319,CO,216,2112,,,,,,,,,f2e6f5775814d9e0574abd2a0b622a4e7b5f5c03,2020-03-19T20:00:00Z,2,,2328,2328,2328,08,0,0,495,33,528
20200319,CT,96,604,,,,,,,,,f38c4a8409f0daf8ca7de49fdae935367da520a6,2020-03-19T20:00:00Z,1,,700,700,700,09,1,0,479,28,507
20200319,DC,39,153,11,,,,,,,,a98070bbd5e9860b07b7c604f0716edae507472f,2020-03-19T20:00:00Z,0,,203,192,192,11,0,0,15,8,23
20200319,DE,30,36,,,,,,,,,468ef62e496e36ade5e3e7adf7d1c73520a9e1ec,2020-03-19T20:00:00Z,0,,66,66,66,10,0,0,0,5,5
20200319,FL,390,1533,1019,,,,,,,,502282f690274385776692ae0cd2f7cbc7af763b,2020-03-19T20:00:00Z,8,,2942,1923,1923,12,1,0,308,76,384
20200319,GA,287,1544,,,,,,,,,5b54c8e2862e3541c6cb2a4a0a6d3fc93891f218,2020-03-19T20:00:00Z,10,,1831,1831,1831,13,9,0,233,90,323
20200319,GU,12,69,,,,,,,,,f6054fe44404e56150824cf1c3bdd5b0a499e142,2020-03-19T20:00:00Z,,,81,81,81,66,0,0,12,4,16
20200319,HI,16,93,,,,,,,,,37e209ff83cb4582d9bacfc535fa7c4922611b6c,2020-03-19T20:00:00Z,,,109,109,109,15,0,0,0,2,2
20200319,IA,38,83,,,,,,,,,8f211ef3f3731062fd68bfefd2a83a9813cb34d6,2020-03-19T20:00:00Z,,,121,121,121,19,0,0,0,9,9
20200319,ID,11,459,,,,,,,,,49ac4006bb26f6313fbd5e256a6dd005a599531a,2020-03-19T20:00:00Z,,,470,470,470,16,0,0,0,2,2
20200319,IL,422,2725,,,,,,,,,8d1c449e83525fc3b5de5d1f65ad5bca7b1a14a1,2020-03-19T20:00:00Z,4,,3147,3147,3147,17,3,0,962,134,1096
20200319,IN,56,324,,,,,,,,,549ee6ea79c57957f4fa53219e3c2d6a0c287f16,2020-03-19T20:00:00Z,2,,380,380,380,18,0,0,170,17,187
20200319,KS,34,417,,,,,,,,,5f85df8ea07968d65259f84d333fdaa370cd30da,2020-03-19T20:00:00Z,1,,451,451,451,20,0,0,0,18,18
20200319,KY,35,454,,,,,,,,,4177f3c5f93abf2fa17632e734de6f33ce50ffb8,2020-03-19T20:00:00Z,1,,489,489,489,21,0,0,100,9,109
20200319,LA,347,458,,,,,,,,,5027dafbbd45c690b0ccd4fab11851328b078d81,2020-03-19T20:00:00Z,8,,805,805,805,22,2,0,123,107,230
20200319,MA,229,2918,,,,,,,,,fa92ee36d5a2b314d1f7b4277f57478c04e495bd,2020-03-19T20:00:00Z,3,,3147,3147,3147,25,1,0,803,73,876
20200319,MD,107,94,,,,,,,,,395ef22c4ab583e1674bf164aa38aa261b48edc8,2020-03-19T20:00:00Z,1,,201,201,201,24,1,0,0,22,22
20200319,ME,53,2004,,,,,,,,,dfcaae4b9738530fc8e4ddf0a4f04b7fa6615971,2020-03-19T20:00:00Z,,,2057,2057,2057,23,0,0,334,10,344
20200319,MI,3392,1785,,,,,,,,,98d5f90a47ca7b484f584e1b85134a043d8c28d0,2020-03-19T20:00:00Z,3,,5177,5177,5177,26,3,0,570,479,1049
20200319,MN,89,2949,,,,,,,,,15ba42c01ac18dca2b983dc834307fabf0ddee3d,2020-03-19T20:00:00Z,,,3038,3038,3038,27,0,0,264,12,276
20200319,MO,24,308,,,,,,,,,cfedb6ca7d4cf450995815dfbcb4faa2d8786564,2020-03-19T20:00:00Z,1,,332,332,332,29,1,0,55,11,66
20200319,MP,0,,,,,,,,,,961b453a4be423f3a4011ff1980a42db7a8340bd,2020-03-19T20:00:00Z,0,,0,0,0,69,0,0,0,0,0
20200319,MS,50,552,,,,,,,,,dae6b6c859147288aa564d8f7bc329019a566105,2020-03-19T20:00:00Z,,,602,602,602,28,0,0,73,16,89
20200319,MT,12,761,,,,,,,,,d9c5be53988efc31dec70e48b4659ef2d519c28e,2020-03-19T20:00:00Z,,,773,773,773,30,0,0,262,2,264
20200319,NC,97,2408,,,,,,,,,c38bf0911f7d0887fec0c237fd024b7c65965c1d,2020-03-19T20:00:00Z,0,,2505,2505,2505,37,0,0,621,34,655
20200319,ND,15,493,,,,,,,,,d3478e7e297de62112f0c14e326c630dd4f1a304,2020-03-19T20:00:00Z,0,,508,508,508,38,0,0,225,9,234
20200319,NE,27,240,,,,,,,,,4e4708969869d61b06e4fb88260cc8e193593984,2020-03-19T20:00:00Z,0,,267,267,267,31,0,0,34,3,37
20200319,NH,39,621,231,,,,,,,,6a5e7d979626aa494679faa93ea4660bdb959e56,2020-03-19T20:00:00Z,,,891,660,660,33,0,0,108,13,121
20200319,NJ,742,210,74,,,,,,,,15bfbbb8a65d6a6c68720f955ec0c0cbbc4e133f,2020-03-19T20:00:00Z,9,,1026,952,952,34,4,0,20,315,335
20200319,NM,35,2762,,,,,,,,,4de22e24a9577d6c8e4ded64bacfc2cab31257ea,2020-03-19T20:00:00Z,,,2797,2797,2797,35,0,0,436,7,443
20200319,NV,95,1626,,,,,,,,,2083071a1b29de96ebbd99cd42fc6d1393cdcd03,2020-03-19T20:00:00Z,1,,1721,1721,1721,32,0,0,1458,40,1498
20200319,NY,4152,18132,,617,,,,,,,21413d59a11c7ab127b22b222446c598d8b4e4cf,2020-03-19T20:00:00Z,12,,22284,22284,22284,36,0,0,5917,1770,7687
20200319,OH,119,140,,,,,,,,,d5861e1be38df98f3ebf32584dad71eed414cc1a,2020-03-19T20:00:00Z,,,259,259,259,39,0,0,0,31,31
20200319,OK,44,466,250,,,,,,,,47631b0fa53981cf4d35fb5e03bc92da1d876375,2020-03-19T20:00:00Z,1,,760,510,510,40,1,0,88,15,103
20200319,OR,88,1329,437,,,,,,,,94d69640761fa3b2766f0ab482a1e62e4f77550e,2020-03-19T20:00:00Z,3,,1854,1417,1417,41,0,0,211,13,224
20200319,PA,185,1608,,,,,,,,,a87671ef28a0d908f73c46b699f698799347b071,2020-03-19T20:00:00Z,1,,1793,1793,1793,42,0,0,421,52,473
20200319,PR,5,56,29,,,,,,,,aa15323ebfa43315d7dbf51bcabc710f6b5beeeb,2020-03-19T20:00:00Z,,,90,61,61,72,0,0,25,0,25
20200319,RI,44,654,334,,,,,,,,73a0d7c823d278e0ae3e43cbd1ed84cde858ff90,2020-03-19T20:00:00Z,,,1032,698,698,44,0,0,114,11,125
20200319,SC,60,583,,,,,,,,,c77461930fa9d479778eb04f8d31984d2a83951e,2020-03-19T20:00:00Z,1,,643,643,643,45,0,0,0,0,0
20200319,SD,11,551,385,,,,,,,,528b99ca6d1a66773889f83a40c35991c7e8c8f7,2020-03-19T20:00:00Z,1,,947,562,562,46,0,0,0,0,0
20200319,TN,154,349,,,,,,,,,c2e339b7624135eb23a1174d4bd161349012b165,2020-03-19T20:00:00Z,,,503,503,503,47,0,0,0,56,56
20200319,TX,143,2212,,,,,,,,,cde417be86facde0b4cc168d73b067ee838a6131,2020-03-19T20:00:00Z,3,,2355,2355,2355,48,1,0,388,60,448
20200319,UT,78,1448,,,,,,,,,14c2a5b7bb32c8085b1e5f993e554fd89e37af52,2020-03-19T20:00:00Z,0,,1526,1526,1526,49,0,0,1317,15,1332
20200319,VA,94,1829,,,,,,,,,db038d6305387b5dff8657cfd63a0637f4ebeae4,2020-03-19T20:00:00Z,2,,1923,1923,1923,51,1,0,628,17,645
20200319,VI,3,,,,,,,,,,1835143ace8e569fbfcf4767b81d889b2ebde7fb,2020-03-19T20:00:00Z,,,3,3,3,78,0,0,0,1,1
20200319,VT,22,645,,,,,,,,,d34ef0b0b994165133a21fa0a4c2329b5131e162,2020-03-19T20:00:00Z,,,667,667,667,50,0,0,53,3,56
20200319,WA,1563,36060,,,,,,,,,045bdd720f64cdb8f6d47d27ae6d53b0069666b0,2020-03-19T20:00:00Z,92,,37623,37623,37623,53,10,0,4218,149,4367
20200319,WI,155,2192,,,,,,,,,04cf4cb3009a0ce03e8c1a25c0fab069f3b6e5bc,2020-03-19T20:00:00Z,,,2347,2347,2347,55,0,0,615,49,664
20200319,WV,2,143,3,,,,,,,,c23463a2d10fb3bc76b7e446714b77ece8a03d77,2020-03-19T20:00:00Z,0,,148,145,145,54,0,0,21,1,22
20200319,WY,18,271,,,,,,,,,9a473d25d0a19ff6338eb5f0dde81887ec30bef5,2020-03-19T20:00:00Z,,,289,289,289,56,0,0,93,3,96
20200318,AK,6,406,,,,,,,,,3b2473258ab7d7b06177a9dfdfdd5755b97dde05,2020-03-18T20:00:00Z,0,,412,412,412,02,0,0,72,3,75
20200318,AL,46,28,,,,,,,,,45a12e7b90dfc3888e7a67b4f579327e80d6dee0,2020-03-18T20:00:00Z,0,,74,74,74,01,0,0,0,10,10
20200318,AR,33,236,50,,,,,,,,ded89e51af058017c83cf8859504494a02b8e23a,2020-03-18T20:00:00Z,,,319,269,269,05,0,0,39,11,50
20200318,AS,,,,,,,,,,,faffd79b60116d673decbba86b9c2c733ca84d32,2020-03-18T20:00:00Z,0,,0,0,0,60,0,0,0,0,0
20200318,AZ,28,148,102,,,,,,,,290a6fabe096478efca8ac5c81bbd38ac2d36bbe,2020-03-18T20:00:00Z,0,,278,176,176,04,0,0,6,8,14
20200318,CA,611,7981,,,,,,,,,646da42647f99037e2c2b31faf21a04c5b5ff197,2020-03-18T20:00:00Z,13,,8592,8592,8592,06,2,0,0,128,128
20200318,CO,183,1617,,,,,,,,,3f3bba2f3fd791c0e1d4324bc8ff2a6f62de7ec7,2020-03-18T20:00:00Z,2,,1800,1800,1800,08,1,0,561,23,584
20200318,CT,68,125,,,,,,,,,bad4eb54adc44121dd8d251113c0f8ba0473fec5,2020-03-18T20:00:00Z,,,193,193,193,09,0,0,0,27,27
20200318,DC,31,138,1,,,,,,,,c19840607398e049b6c94859e2e5488bb8fd65cc,2020-03-18T20:00:00Z,,,170,169,169,11,0,0,34,9,43
20200318,DE,25,36,,,,,,,,,200085798af7e505bcb7c4edfc0813a35aceaed6,2020-03-18T20:00:00Z,,,61,61,61,10,0,0,0,9,9
20200318,FL,314,1225,954,,,,,,,,780fc846fbf000c950f78cc64d78b6224aba330a,2020-03-18T20:00:00Z,7,,2493,1539,1539,12,1,0,285,128,413
20200318,GA,197,1311,,,,,,,,,7c4abc91d1b496bb4b6e90a2b568750290d62c25,2020-03-18T20:00:00Z,1,,1508,1508,1508,13,0,0,1311,51,1362
20200318,GU,8,57,,,,,,,,,488b4b65842850fef461324d0a98fcc0653805c8,2020-03-18T20:00:00Z,,,65,65,65,66,0,0,16,3,19
20200318,HI,14,93,,,,,,,,,1b7f39d7fd4e1c744f40516e4ee967f0d9424d86,2020-03-18T20:00:00Z,,,107,107,107,15,0,0,93,4,97
20200318,IA,29,83,,,,,,,,,744296249158ada7fe673054c1d488a847a13e78,2020-03-18T20:00:00Z,,,112,112,112,19,0,0,0,6,6
20200318,ID,9,459,,,,,,,,,b7e35d1fce1508552a80b1509dd6dc1789ecc16e,2020-03-18T20:00:00Z,,,468,468,468,16,0,0,113,2,115
20200318,IL,288,1763,,,,,,,,,5a530936a08eac49cd05347cded3d2e47e4e7bbf,2020-03-18T20:00:00Z,1,,2051,2051,2051,17,0,0,423,129,552
20200318,IN,39,154,,,,,,,,,df609a8d40db459b3c9d18cb5a964ff9b160c4f0,2020-03-18T20:00:00Z,2,,193,193,193,18,0,0,25,9,34
20200318,KS,16,417,,,,,,,,,45de05a2adf705367c4fdaff13311bb37da1073a,2020-03-18T20:00:00Z,1,,433,433,433,20,0,0,35,1,36
20200318,KY,26,354,,,,,,,,,4226afce757dadaf205f1611a61e21839adef8bf,2020-03-18T20:00:00Z,1,,380,380,380,21,0,0,59,4,63
20200318,LA,240,335,,,,,,,,,dad1c0a1eff89b6afadb6c2403054966c897f0e2,2020-03-18T20:00:00Z,6,,575,575,575,22,2,0,49,69,118
20200318,MA,156,2115,,,,,,,,,76e503b0a79542330cf55816e487022e1de48c99,2020-03-18T20:00:00Z,2,,2271,2271,2271,25,2,0,482,38,520
20200318,MD,85,94,,,,,,,,,1f4768a9dad6648329e433e8ef1c1dfd4b40e53c,2020-03-18T20:00:00Z,,,179,179,179,24,0,0,0,28,28
20200318,ME,43,1670,,,,,,,,,6b89b002933569c5cdf827aed8b17d83a64131e4,2020-03-18T20:00:00Z,,,1713,1713,1713,23,0,0,367,11,378
20200318,MI,2913,1215,,,,,,,,,537719f8b2a5b289f0e7d4410bd55683c458df15,2020-03-18T20:00:00Z,,,4128,4128,4128,26,0,0,589,520,1109
20200318,MN,77,2685,,,,,,,,,2778d416bab07054feed2ec1321f3c1a9d3ccb19,2020-03-18T20:00:00Z,,,2762,2762,2762,27,0,0,409,17,426
20200318,MO,13,253,,,,,,,,,494c3a4a7f0b3d056f0796c5451a94a65db87f24,2020-03-18T20:00:00Z,0,,266,266,266,29,0,0,46,5,51
20200318,MP,0,,,,,,,,,,5473ea484274ea891441c085e860db0a828a9441,2020-03-18T20:00:00Z,0,,0,0,0,69,0,0,0,0,0
20200318,MS,34,479,,,,,,,,,d9aef306232106ab3338341222f0fc21ee44f555,2020-03-18T20:00:00Z,,,513,513,513,28,0,0,111,13,124
20200318,MT,10,499,,,,,,,,,31ded3437234cc23d5ddf95effe31b6bd14bf5d3,2020-03-18T20:00:00Z,,,509,509,509,30,0,0,196,2,198
20200318,NC,63,1787,,,,,,,,,bc1bbd225ef32227a7efee396646e6930f31637a,2020-03-18T20:00:00Z,0,,1850,1850,1850,37,0,0,1313,23,1336
20200318,ND,6,268,,,,,,,,,3fb86878e20e5d7952aa8b8e58e8f8e3db35e0f6,2020-03-18T20:00:00Z,0,,274,274,274,38,0,0,48,3,51
20200318,NE,24,206,,,,,,,,,fa4b37682bc4e4c9977832d28b6bee342ad73bfc,2020-03-18T20:00:00Z,,,230,230,230,31,0,0,0,3,3
20200318,NH,26,513,208,,,,,,,,379d9ffea7e7ca663fa8076e64b67a0abdff891c,2020-03-18T20:00:00Z,,,747,539,539,33,0,0,158,9,167
20200318,NJ,427,190,21,,,,,,,,cd982339aab35ead35248c6c7d3f97f69aedc106,2020-03-18T20:00:00Z,5,,638,617,617,34,2,0,27,160,187
20200318,NM,28,2326,,,,,,,,,9d7631bd34bff01009e3691eaf8a89a9020f1a60,2020-03-18T20:00:00Z,,,2354,2354,2354,35,0,0,1077,5,1082
20200318,NV,55,168,,,,,,,,,143e93252ed96f1da9e57b213aabbffc9a94e028,2020-03-18T20:00:00Z,1,,223,223,223,32,0,0,0,0,0
20200318,NY,2382,12215,,416,,,,,,,096c853c14035eeb3c0201e737fec4d7cf85e6a1,2020-03-18T20:00:00Z,12,,14597,14597,14597,36,5,0,6709,682,7391
20200318,OH,88,140,,,,,,,,,9e018d5062cb6300ba638be07cb64b0e75faf66f,2020-03-18T20:00:00Z,,,228,228,228,39,0,0,0,21,21
20200318,OK,29,378,110,,,,,,,,0d0abb08b10d42019c2c2193f46d2fdc388fc740,2020-03-18T20:00:00Z,,,517,407,407,40,0,0,131,12,143
20200318,OR,75,1118,361,,,,,,,,417e054b02ae4a5d4a0a2a5870a419a30ae285db,2020-03-18T20:00:00Z,3,,1554,1193,1193,41,3,0,429,28,457
20200318,PA,133,1187,,,,,,,,,5ae5b594dffb150d8fa0ee38e56fa1cffab40bcf,2020-03-18T20:00:00Z,1,,1320,1320,1320,42,1,0,308,37,345
20200318,PR,5,31,21,,,,,,,,2d5405cfdbd83c8717f23b7ebc2f454316248e7c,2020-03-18T20:00:00Z,,,57,36,36,72,0,0,18,0,18
20200318,RI,33,540,334,,,,,,,,d30ec58cfb6debb199f0a3dab56dea6d8b658293,2020-03-18T20:00:00Z,,,907,573,573,44,0,0,137,10,147
20200318,SC,60,583,,,,,,,,,1b0a7b83efeb9ea6127ac5e0dbd268700c8b7ffd,2020-03-18T20:00:00Z,1,,643,643,643,45,0,0,272,27,299
20200318,SD,11,551,350,,,,,,,,517b7759b69709dc0bbfc3a4795c6257a3d8695a,2020-03-18T20:00:00Z,1,,912,562,562,46,1,0,0,0,0
20200318,TN,98,349,,,,,,,,,ef95fc12bc281034aad01fc4c18c9518ad68fc18,2020-03-18T20:00:00Z,,,447,447,447,47,0,0,19,25,44
20200318,TX,83,1824,,,,,,,,,2467c07184fc5405454f97f8f267669095674a74,2020-03-18T20:00:00Z,2,,1907,1907,1907,48,1,0,620,19,639
20200318,UT,63,131,,,,,,,,,9966240ca7479f6c30465b22f5b5250bc4e46f44,2020-03-18T20:00:00Z,0,,194,194,194,49,0,0,0,12,12
20200318,VA,77,1201,,,,,,,,,ce7119e82540f46da33ce3ad8566b387de75c4c2,2020-03-18T20:00:00Z,1,,1278,1278,1278,51,0,0,240,10,250
20200318,VI,2,,,,,,,,,,9c10ba6e96c6e228fefe05742b8102eedbc33b8b,2020-03-18T20:00:00Z,,,2,2,2,78,0,0,0,0,0
20200318,VT,19,592,,,,,,,,,adc018bdef2b12d859e026881ce104495a7a3736,2020-03-18T20:00:00Z,,,611,611,611,50,0,0,97,9,106
20200318,WA,1414,31842,,,,,,,,,23e2ccc21086840e3f90ae222f57f3cd14f6dc9b,2020-03-18T20:00:00Z,82,,33256,33256,33256,53,4,0,4474,174,4648
20200318,WI,106,1577,,,,,,,,,c6687fa3edbbc8d56cf9953ddbf05a0988642570,2020-03-18T20:00:00Z,,,1683,1683,1683,55,0,0,539,34,573
20200318,WV,1,122,14,,,,,,,,59817e48b32e3f860eed291a8785c1af5c5fc047,2020-03-18T20:00:00Z,0,,137,123,123,54,0,0,42,1,43
20200318,WY,15,178,,,,,,,,,326e4562919b82e68eb5cf65710387eef18815f2,2020-03-18T20:00:00Z,,,193,193,193,56,0,0,83,5,88
20200317,AK,3,334,,,,,,,,,f783749da875f73ada5b29daa00edffb6e10ae11,2020-03-17T20:00:00Z,0,,337,337,337,02,0,0,191,2,193
20200317,AL,36,28,,,,,,,,,27d195514d6511642ecafb4148f51bd1cf06894d,2020-03-17T20:00:00Z,0,,64,64,64,01,0,0,0,8,8
20200317,AR,22,197,41,,,,,,,,411518ea767313995c4b1d3dcc31cdf917851e0e,2020-03-17T20:00:00Z,,,260,219,219,05,0,0,65,0,65
20200317,AS,,,,,,,,,,,e45f93e9d9d4d1f58980dacbb28ac3d97d9b9d94,2020-03-17T20:00:00Z,,,,,,60,0,0,0,0,0
20200317,AZ,20,142,66,,,,,,,,89437a1c0aef047c82cd8a566761763bae43c5bf,2020-03-17T20:00:00Z,0,,228,162,162,04,0,0,17,2,19
20200317,CA,483,7981,,,,,,,,,3a5a29b79b4583de68455525d065127db6a3e97b,2020-03-17T20:00:00Z,11,,8464,8464,8464,06,5,0,0,148,148
20200317,CO,160,1056,,,,,,,,,cd89a731d2b24e3f2b854af3811047aa4dc58515,2020-03-17T20:00:00Z,1,,1216,1216,1216,08,0,0,429,29,458
20200317,CT,41,125,,,,,,,,,6da5216bce6b0623b87352f8e83a1825342475e8,2020-03-17T20:00:00Z,,,166,166,166,09,0,0,0,15,15
20200317,DC,22,104,0,,,,,,,,920a77b7fb3c7caea23a46e351f576caf34d15d5,2020-03-17T20:00:00Z,,,126,126,126,11,0,0,8,5,13
20200317,DE,16,36,,,,,,,,,cda3d06e346fadcb4155d46e80ed29de996cb64b,2020-03-17T20:00:00Z,,,52,52,52,10,0,0,0,8,8
20200317,FL,186,940,872,,,,,,,,326863b36e37f814b53ae8a8ac35ff314dba227c,2020-03-17T20:00:00Z,6,,1998,1126,1126,12,2,0,256,45,301
20200317,GA,146,,,,,,,,,,6d29d5d7a269b24f93abacce353e78bdd6d779e5,2020-03-17T20:00:00Z,1,,146,146,146,13,0,0,0,25,25
20200317,GU,5,41,,,,,,,,,0e4694acd5fc6e905760489233fa2e4adb3fe162,2020-03-17T20:00:00Z,,,46,46,46,66,0,0,18,2,20
20200317,HI,10,,,,,,,,,,0fad73741929efc5016cc6898bf79a04f3b32541,2020-03-17T20:00:00Z,,,10,10,10,15,0,0,0,3,3
20200317,IA,23,83,,,,,,,,,39b42e43a67060a6680cc19a597e43f758ae9c4b,2020-03-17T20:00:00Z,,,106,106,106,19,0,0,0,1,1
20200317,ID,7,346,,,,,,,,,da76cc722dd92af48de842b866731dd5feecedf5,2020-03-17T20:00:00Z,,,353,353,353,16,0,0,81,2,83
20200317,IL,159,1340,,,,,,,,,ac5f0af8ee2b49bbec18da6a8780ae3e6fccbaa4,2020-03-17T20:00:00Z,1,,1499,1499,1499,17,1,0,408,66,474
20200317,IN,30,129,,,,,,,,,9116db98bc9050e3933e80a7afcf74ef82d7e826,2020-03-17T20:00:00Z,2,,159,159,159,18,1,0,14,6,20
20200317,KS,15,382,,,,,,,,,44e5c9df55fec7dfe79bcd4ecb086fe131bb3782,2020-03-17T20:00:00Z,1,,397,397,397,20,0,0,216,4,220
20200317,KY,22,295,,,,,,,,,15eb2cbe48fa8cbaa6eefad032de090f954964cd,2020-03-17T20:00:00Z,1,,317,317,317,21,0,0,61,1,62
20200317,LA,171,286,,,,,,,,,50610ebbdeaa7907b12726f42106e71733e456f5,2020-03-17T20:00:00Z,4,,457,457,457,22,2,0,98,57,155
20200317,MA,118,1633,,,,,,,,,0e7e247e4780adedc1d5c79a1bfa72d78a5d0f8f,2020-03-17T20:00:00Z,,,1751,1751,1751,25,0,0,434,21,455
20200317,MD,57,94,,,,,,,,,3b1218c8eb03fb526e4527aee06fb0fd45fb84d6,2020-03-17T20:00:00Z,,,151,151,151,24,0,0,0,20,20
20200317,ME,32,1303,,,,,,,,,a0e2d3e219d03ae226d39b22f6fb58f3a7962d68,2020-03-17T20:00:00Z,,,1335,1335,1335,23,0,0,539,15,554
20200317,MI,2393,626,,,,,,,,,f90248265cd8b3b66154b412adbf713eb53b7b2b,2020-03-17T20:00:00Z,,,3019,3019,3019,26,0,0,354,460,814
20200317,MN,60,2276,,,,,,,,,300095ac1a8a4816dc84236f74f9b294078551f2,2020-03-17T20:00:00Z,,,2336,2336,2336,27,0,0,437,6,443
20200317,MO,8,207,,,,,,,,,54626aca3649c044d3040c7e2016a1ad31c9785e,2020-03-17T20:00:00Z,0,,215,215,215,29,0,0,43,2,45
20200317,MP,0,,,,,,,,,,6adf0f2f9d5d342ee6f48691e7c933cfbb9ee4ab,2020-03-17T20:00:00Z,,,0,0,0,69,0,0,0,0,0
20200317,MS,21,368,,,,,,,,,6d8126cab2847762c6c6ae011f9e1a4490be20f6,2020-03-17T20:00:00Z,,,389,389,389,28,0,0,91,9,100
20200317,MT,8,303,,,,,,,,,5913952660eba91acbb7ea2118012f069237a417,2020-03-17T20:00:00Z,,,311,311,311,30,0,0,105,1,106
20200317,NC,40,474,,,,,,,,,68df9675138cd54797b057149f2b83186228ba6a,2020-03-17T20:00:00Z,0,,514,514,514,37,0,0,178,7,185
20200317,ND,3,220,0,,,,,,,,44da03edf8d7792eb57915c2b50406c83c0000f2,2020-03-17T20:00:00Z,0,,223,223,223,38,0,0,97,2,99
20200317,NE,21,206,,,,,,,,,8ee48fa5b23a524e017e3402f8a5ffcd74e18e7e,2020-03-17T20:00:00Z,,,227,227,227,31,0,0,36,3,39
20200317,NH,17,355,195,,,,,,,,3d90b42fa44eb1f26bc9dad858c0b267b6bb8320,2020-03-17T20:00:00Z,,,567,372,372,33,0,0,84,4,88
20200317,NJ,267,163,55,,,,,,,,245514c59d21a39ce3fcce7909de2f2aea8521fd,2020-03-17T20:00:00Z,3,,485,430,430,34,1,0,43,89,132
20200317,NM,23,1249,,,,,,,,,dc445586a909cec38c6b3ddd4d313d3933909382,2020-03-17T20:00:00Z,,,1272,1272,1272,35,0,0,683,6,689
20200317,NV,55,168,,,,,,,,,5b582da8f08144c39d99e58a22bd3542fa42bcfb,2020-03-17T20:00:00Z,1,,223,223,223,32,0,0,0,10,10
20200317,NY,1700,5506,,325,,,,,,,f2a3ffc806f515db94d5c249b3589f391cd5ef62,2020-03-17T20:00:00Z,7,,7206,7206,7206,36,0,0,963,750,1713
20200317,OH,67,140,,,,,,,,,97daf301defc7356d1af9ba55e9397bb8155fe7c,2020-03-17T20:00:00Z,,,207,207,207,39,0,0,0,17,17
20200317,OK,17,247,82,,,,,,,,e1c323cb75eb122e2b034a5370eaad9e5a86d4fa,2020-03-17T20:00:00Z,,,346,264,264,40,0,0,73,7,80
20200317,OR,47,689,184,,,,,,,,898565e2b6b936a739713bd0e523449fdf478069,2020-03-17T20:00:00Z,,,920,736,736,41,0,0,110,8,118
20200317,PA,96,879,,,,,,,,,9a374eb05235860321c532550f87da84d649fcfd,2020-03-17T20:00:00Z,,,975,975,975,42,0,0,209,20,229
20200317,PR,5,13,4,,,,,,,,62bea2a6c0d3c6ef1d1578056f4e0bbc64ebf66a,2020-03-17T20:00:00Z,,,22,18,18,72,0,0,4,0,4
20200317,RI,23,403,149,,,,,,,,0af317dcf6c8e418367a5c24318e6f994d1fe826,2020-03-17T20:00:00Z,,,575,426,426,44,0,0,95,2,97
20200317,SC,33,311,,,,,,,,,b5f1adfc0baaf72f68c6ac1ac0ed09497346cca7,2020-03-17T20:00:00Z,1,,344,344,344,45,0,0,76,5,81
20200317,SD,11,551,35,,,,,,,,4f349aafd2814d07c34bcd70c3df3e11ebdce938,2020-03-17T20:00:00Z,,,597,562,562,46,0,0,57,1,58
20200317,TN,73,330,,,,,,,,,87b5c6f12a10d9e22646015aa7f6ff734f74a432,2020-03-17T20:00:00Z,,,403,403,403,47,0,0,60,21,81
20200317,TX,64,1204,,,,,,,,,70f6533b6999b27f73a6c5b316d3d22b8ef5519b,2020-03-17T20:00:00Z,1,,1268,1268,1268,48,1,0,1204,7,1211
20200317,UT,51,131,,,,,,,,,a54698d3d8c9e6d9e9d82f50535716a7107b8ab7,2020-03-17T20:00:00Z,0,,182,182,182,49,0,0,0,12,12
20200317,VA,67,961,,,,,,,,,fc691ef55223c03d5038f969b84154d360731887,2020-03-17T20:00:00Z,1,,1028,1028,1028,51,0,0,523,16,539
20200317,VI,2,,,,,,,,,,e1264b6e170d5381e6ba419101f02c93331ff4f3,2020-03-17T20:00:00Z,,,2,2,2,78,0,0,0,1,1
20200317,VT,10,495,,,,,,,,,7ed042b1658ff87b1bc58e97924f28365b3a934d,2020-03-17T20:00:00Z,,,505,505,505,50,0,0,74,2,76
20200317,WA,1240,27368,,,,,,,,,3f81315bedeeaa675690c3709965102d6eb72e62,2020-03-17T20:00:00Z,78,,28608,28608,28608,53,9,0,4388,173,4561
20200317,WI,72,1038,,,,,,,,,8c430e85d8bacf4fcd9637ea1fc9d554eac52d2c,2020-03-17T20:00:00Z,,,1110,1110,1110,55,0,0,534,25,559
20200317,WV,0,80,4,,,,,,,,f2463136e4acc78a08320ea32d916ae7a9a305e8,2020-03-17T20:00:00Z,0,,84,80,80,54,0,0,0,0,0
20200317,WY,10,95,,,,,,,,,bc3cae6af97386e715211063c8994c0a9d1c031f,2020-03-17T20:00:00Z,,,105,105,105,56,0,0,95,7,102
20200316,AK,1,143,,,,,,,,,e46478b4ac464fb5c40587abd00b920b5f8e7c73,2020-03-16T20:00:00Z,0,,144,144,144,02,0,0,0,0,0
20200316,AL,28,28,40,,,,,,,,3efe0ea61bb6932f1d608f9e24d38fcafaa2c04c,2020-03-16T20:00:00Z,0,,96,56,56,01,0,0,0,16,16
20200316,AR,22,132,14,,,,,,,,78bd45495c24cce3ba85c7f24609a179c43478eb,2020-03-16T20:00:00Z,,,168,154,154,05,0,0,29,6,35
20200316,AS,,,,,,,,,,,40355f49a87c433dafdd8148cab5cd5fcb7327ab,2020-03-16T20:00:00Z,,,,,,60,,,,,
20200316,AZ,18,125,63,,,,,,,,a2961931f5c5f76a42773e7477d509b59b5cd133,2020-03-16T20:00:00Z,0,,206,143,143,04,0,0,4,6,10
20200316,CA,335,7981,,,,,,,,,ae22555d7ccc020a6fc6268f759c981a681af584,2020-03-16T20:00:00Z,6,,8316,8316,8316,06,1,0,7065,42,7107
20200316,CO,131,627,,,,,,,,,dda059810b70b49f0451aef63be8a4ae6d3af3f2,2020-03-16T20:00:00Z,1,,758,758,758,08,0,0,0,0,0
20200316,CT,26,125,,,,,,,,,4d722259eb940d98fdcc976b9bc97308a3e902c0,2020-03-16T20:00:00Z,,,151,151,151,09,0,0,0,6,6
20200316,DC,17,96,7,,,,,,,,8997b7eeb6bd9be4fb4ad8a4094301be4add08b0,2020-03-16T20:00:00Z,,,120,113,113,11,0,0,17,1,18
20200316,DE,8,36,32,,,,,,,,d04addb5ab1cce5bea6da60bd864abdaf9f40c33,2020-03-16T20:00:00Z,,,76,44,44,10,0,0,0,2,2
20200316,FL,141,684,514,,,,,,,,e53cf48d45ec818ea2d56d271277e6ec5a5b49bd,2020-03-16T20:00:00Z,4,,1339,825,825,12,0,0,6,25,31
20200316,GA,121,,,,,,,,,,c6fa2c88408c5bb21156b21e12fac3816f255ea9,2020-03-16T20:00:00Z,1,,121,121,121,13,0,0,0,22,22
20200316,GU,3,23,,,,,,,,,f7bbc72cc2925b0cf37ca0d2a707d2dd196619ba,2020-03-16T20:00:00Z,,,26,26,26,66,,,,,
20200316,HI,7,,,,,,,,,,6379c60c70b54b8df2bfed1f9beac3fbfe2117f5,2020-03-16T20:00:00Z,,,7,7,7,15,0,0,0,5,5
20200316,IA,22,83,,,,,,,,,abdd281192ae660bb7cf448cc358f37058a4e726,2020-03-16T20:00:00Z,,,105,105,105,19,0,0,0,4,4
20200316,ID,5,265,,,,,,,,,cbadc8d7244f7abc2f70ffd4efcbd3930be6c7c3,2020-03-16T20:00:00Z,,,270,270,270,16,0,0,91,0,91
20200316,IL,93,932,,,,,,,,,f03443451f7889148543ffce5c6fb97993c13d33,2020-03-16T20:00:00Z,,,1025,1025,1025,17,0,0,483,29,512
20200316,IN,24,115,,,,,,,,,5476decd48ecb1589f9d22a297cf69d1bc5e0355,2020-03-16T20:00:00Z,1,,139,139,139,18,1,0,13,5,18
20200316,KS,11,166,,,,,,,,,2871e7c581aba789a9a80042471dbd062cd8b05a,2020-03-16T20:00:00Z,1,,177,177,177,20,0,0,31,3,34
20200316,KY,21,234,,,,,,,,,9faf39847096593b80a7c2410e9e5bc7f8ae66f2,2020-03-16T20:00:00Z,1,,255,255,255,21,1,0,95,5,100
20200316,LA,114,188,,,,,,,,,3f35dae7522ba88d8e79d20093816c3614734dcb,2020-03-16T20:00:00Z,2,,302,302,302,22,0,0,32,23,55
20200316,MA,97,1199,,,,,,,,,15fa3c6d98b3e9f9023a1cb8929a12299fc18530,2020-03-16T20:00:00Z,,,1296,1296,1296,25,0,0,615,33,648
20200316,MD,37,94,,,,,,,,,8148e20f78522f18bb64c3736befeed3747a96b2,2020-03-16T20:00:00Z,,,131,131,131,24,0,0,0,6,6
20200316,ME,17,764,,,,,,,,,a6b88539313f6c2cd8136b76c0c53475b3b0dd34,2020-03-16T20:00:00Z,,,781,781,781,23,0,0,673,14,687
20200316,MI,1933,272,30,,,,,,,,29319d0631530d88b2c0b404a6419788640b7381,2020-03-16T20:00:00Z,,,2235,2205,2205,26,0,0,67,453,520
20200316,MN,54,1839,,,,,,,,,3419334f30420a634b19a07442d629553af687b3,2020-03-16T20:00:00Z,,,1893,1893,1893,27,0,0,452,19,471
20200316,MO,6,164,,,,,,,,,ef353ee3f27c62c9da40b468889b6e5f7873daf2,2020-03-16T20:00:00Z,0,,170,170,170,29,0,0,42,1,43
20200316,MP,0,,,,,,,,,,645c528660cf04b553855f4e4d0ab78f35e60078,2020-03-16T20:00:00Z,,,0,0,0,69,,,,,
20200316,MS,12,277,,,,,,,,,68fb32e431d415106a70ff158d981d8bb680d5ab,2020-03-16T20:00:00Z,,,289,289,289,28,0,0,193,2,195
20200316,MT,7,198,,,,,,,,,dee9f30c86457abd5cb9c810f7f31a3af246e5e2,2020-03-16T20:00:00Z,,,205,205,205,30,0,0,95,0,95
20200316,NC,33,296,151,,,,,,,,db9b565837a4d41e965e15ccb7b4d5063ae76924,2020-03-16T20:00:00Z,0,,480,329,329,37,0,0,69,1,70
20200316,ND,1,123,0,,,,,,,,41479c4ca4bf1f2bbc321cbe00058d9ca9ed023c,2020-03-16T20:00:00Z,0,,124,124,124,38,0,0,28,0,28
20200316,NE,18,170,,,,,,,,,27f99533a3a45cdfe5408436300f1d84dc36ee38,2020-03-16T20:00:00Z,,,188,188,188,31,0,0,90,1,91
20200316,NH,13,271,95,,,,,,,,6324e7ef14adbe0db61808a796bbc0e9d9373431,2020-03-16T20:00:00Z,,,379,284,284,33,0,0,0,0,0
20200316,NJ,178,120,20,,,,,,,,e3047f52c8b8718510b744979fca9f7ac16351b3,2020-03-16T20:00:00Z,2,,318,298,298,34,0,0,0,80,80
20200316,NM,17,566,,,,,,,,,48d7bfddefd90fde1d6499cc0b200237e976e758,2020-03-16T20:00:00Z,,,583,583,583,35,0,0,84,4,88
20200316,NV,45,168,,,,,,,,,203840ffb87a4baf59f78144da9357ea01a27ac2,2020-03-16T20:00:00Z,1,,213,213,213,32,1,0,0,24,24
20200316,NY,950,4543,,,,,,,,,994a65ba75be3681f76ff4612eb8fde85cff81cd,2020-03-16T20:00:00Z,7,,5493,5493,5493,36,4,0,0,221,221
20200316,OH,50,140,361,,,,,,,,70ad02c336e95158080519cbea8b21e47de47958,2020-03-16T20:00:00Z,,,551,190,190,39,0,0,1,14,15
20200316,OK,10,174,29,,,,,,,,e0d2929770055843abe54cd9ac80c1f407fdfcd3,2020-03-16T20:00:00Z,,,213,184,184,40,0,0,56,1,57
20200316,OR,39,579,182,,,,,,,,962d85e67d8cf64e5ef102b345d18ae50baa0624,2020-03-16T20:00:00Z,,,800,618,618,41,0,0,159,3,162
20200316,PA,76,670,,,,,,,,,96a8a61c47aef3aefddcc68815b03b9de9e6ffa7,2020-03-16T20:00:00Z,,,746,746,746,42,0,0,465,13,478
20200316,PR,5,9,,,,,,,,,be5aca3aa4f7fa2a722127a99ec083fd3b982671,2020-03-16T20:00:00Z,,,14,14,14,72,,,,,
20200316,RI,21,308,149,,,,,,,,e0244de4eb603b25d36700707a95bdb8289a5928,2020-03-16T20:00:00Z,,,478,329,329,44,0,0,37,1,38
20200316,SC,28,235,,,,,,,,,825f415faf293db6c2a614650fd3d37c694e56e8,2020-03-16T20:00:00Z,1,,263,263,263,45,1,0,81,9,90
20200316,SD,10,494,0,,,,,,,,b2a38c6ba820cb1329f93d990e27a8100d7b2fb5,2020-03-16T20:00:00Z,,,504,504,504,46,0,0,167,1,168
20200316,TN,52,270,,,,,,,,,9feabfdc22803b2d1bc85122f421cfcaa6b45cb7,2020-03-16T20:00:00Z,,,322,322,322,47,0,0,113,13,126
20200316,TX,57,,,,,,,,,,1f4d7ef872f54f1f40fe0560f536c9baa94b1637,2020-03-16T20:00:00Z,,,57,57,57,48,0,0,0,1,1
20200316,UT,39,131,,,,,,,,,3cf1e0acd5d5d07d3c45fa784a7e6f11796c467b,2020-03-16T20:00:00Z,0,,170,170,170,49,0,0,0,11,11
20200316,VA,51,438,,,,,,,,,097556061009dcaa83f48a5fbc6b952b751300fe,2020-03-16T20:00:00Z,1,,489,489,489,51,0,0,75,6,81
20200316,VI,1,,,,,,,,,,5af3baba47f6d5e3e1b4090940bb299a160a1c9f,2020-03-16T20:00:00Z,,,1,1,1,78,,,,,
20200316,VT,8,421,,,,,,,,,0bfc2ddcde18514ed799a3832e1136ca8bc745dc,2020-03-16T20:00:00Z,,,429,429,429,50,0,0,73,4,77
20200316,WA,1067,22980,,,,,,,,,1ff80b89965367d295040912813bbca6e3f87c00,2020-03-16T20:00:00Z,69,,24047,24047,24047,53,12,0,4608,128,4736
20200316,WI,47,504,,,,,,,,,a2e7539f5f950647edc9fab483be3672a3ca189e,2020-03-16T20:00:00Z,,,551,551,551,55,0,0,191,14,205
20200316,WV,0,80,4,,,,,,,,24af6da70ac0da2f7126fe3a29931ee7d556ffe6,2020-03-16T20:00:00Z,0,,84,80,80,54,0,0,42,0,42
20200316,WY,3,,,,,,,,,,b67f6088687e03e5ed66f4f27410a2bf8e4032f9,2020-03-16T20:00:00Z,,,3,3,3,56,0,0,0,0,0
20200315,AK,1,143,,,,,,,,,5c3a16f75070d1643f1528b5e75fb7dac0171d13,2020-03-15T20:00:00Z,0,,144,144,144,02,0,0,0,0,0
20200315,AL,12,28,46,,,,,,,,bc792edfeb4365aed8c64e6ff682049380018d28,2020-03-15T20:00:00Z,0,,86,40,40,01,0,0,6,6,12
20200315,AR,16,103,30,,,,,,,,35929378624bc11a7dd1d28474862f8edfab3a18,2020-03-15T20:00:00Z,,,149,119,119,05,0,0,38,4,42
20200315,AZ,12,121,50,,,,,,,,7a4427cac62eb283ec726e86ffa9fb6f331bac4a,2020-03-15T20:00:00Z,0,,183,133,133,04,0,0,0,0,0
20200315,CA,293,916,,,,,,,,,5e5e85687553cddbfc767524eedc40d04efeb98a,2020-03-15T20:00:00Z,5,,1209,1209,1209,06,0,0,0,41,41
20200315,CO,131,627,,,,,,,,,0da7e45df3e95846c2ea7d169ec15485902fe3b5,2020-03-15T20:00:00Z,1,,758,758,758,08,0,0,17,30,47
20200315,CT,20,125,,,,,,,,,47afb6e02464043555eaf5e2053829e84eb805be,2020-03-15T20:00:00Z,,,145,145,145,09,0,0,0,9,9
20200315,DC,16,79,20,,,,,,,,46da8be5fe41851c0bb75f94651e557a2f0c6386,2020-03-15T20:00:00Z,,,115,95,95,11,0,0,30,6,36
20200315,DE,6,36,32,,,,,,,,f5b3a2976e58c2202cc5aded47704c39fa65e343,2020-03-15T20:00:00Z,,,74,42,42,10,0,0,0,0,0
20200315,FL,116,678,454,,,,,,,,fbbf82f88fa5a3c2bbdf7f937c2752c5ba3ce6df,2020-03-15T20:00:00Z,4,,1248,794,794,12,1,0,200,39,239
20200315,GA,99,,,,,,,,,,df40a5921f9dfc96b45398288e6075bd6b97fd81,2020-03-15T20:00:00Z,1,,99,99,99,13,0,0,0,33,33
20200315,HI,2,,,,,,,,,,0a69a6018c0bce8b9bfbe6b1dd88a8f031a0a025,2020-03-15T20:00:00Z,,,2,2,2,15,0,0,0,0,0
20200315,IA,18,83,,,,,,,,,fdf73baeeb8118faed38a3ad4be3449414432f07,2020-03-15T20:00:00Z,,,101,101,101,19,0,0,0,1,1
20200315,ID,5,174,,,,,,,,,4472c728ff3ae897133063dc6b945fc03c35c382,2020-03-15T20:00:00Z,,,179,179,179,16,0,0,0,3,3
20200315,IL,64,449,195,,,,,,,,f6c2094de686cbf02f6bb9ac79925336ade7255e,2020-03-15T20:00:00Z,,,708,513,513,17,0,0,133,18,151
20200315,IN,19,102,,,,,,,,,d4516efe0a7e4050cd6326b64b549f9cb1923a61,2020-03-15T20:00:00Z,0,,121,121,121,18,0,0,28,4,32
20200315,KS,8,135,,,,,,,,,868c75937b225e6321886b68d3a125642646a48a,2020-03-15T20:00:00Z,1,,143,143,143,20,0,0,42,2,44
20200315,KY,16,139,,,,,,,,,d0dfc75f33be8db126e19af366618eaa6af0055b,2020-03-15T20:00:00Z,,,155,155,155,21,0,0,0,2,2
20200315,LA,91,156,,,,,,,,,e12d7af383c2482c7845ba7e6403df009076bfde,2020-03-15T20:00:00Z,2,,247,247,247,22,2,0,47,22,69
20200315,MA,64,584,,,,,,,,,24bf65af13c0a5fa541e3c2da1081cf2a4d6d943,2020-03-15T20:00:00Z,,,648,648,648,25,0,0,584,26,610
20200315,MD,31,94,,,,,,,,,12fc1449714a30e3dece18babc0d6f18a249ec11,2020-03-15T20:00:00Z,,,125,125,125,24,0,0,0,5,5
20200315,ME,3,91,17,,,,,,,,b9373f5ff8eecc4882df5e99ca65029c7ab54a5e,2020-03-15T20:00:00Z,,,111,94,94,23,0,0,0,0,0
20200315,MI,1480,205,26,,,,,,,,09fc24831d1175112329f54087d0a933591da80e,2020-03-15T20:00:00Z,,,1711,1685,1685,26,0,0,0,284,284
20200315,MN,35,1387,,,,,,,,,00afbc28ae28d28e85eb0ca606fac9847ee7eec5,2020-03-15T20:00:00Z,,,1422,1422,1422,27,0,0,540,14,554
20200315,MO,5,122,,,,,,,,,5ad3d82f98f7d9f284ef9895cb6f8e76d23c7f34,2020-03-15T20:00:00Z,0,,127,127,127,29,0,0,32,1,33
20200315,MS,10,84,,,,,,,,,5442e46cc16cedbeeb93a0f0ff9a04740dc62690,2020-03-15T20:00:00Z,,,94,94,94,28,0,0,0,4,4
20200315,MT,7,103,57,,,,,,,,d5c7b708dac192fb53a5453064d7c4fa04726b5d,2020-03-15T20:00:00Z,,,167,110,110,30,0,0,0,2,2
20200315,NC,32,227,151,,,,,,,,403dec9507ef0b9ac81864a597d016782cc2527b,2020-03-15T20:00:00Z,,,410,259,259,37,0,0,90,9,99
20200315,ND,1,95,4,,,,,,,,2745e3ea870fcafa773e34d392d65a6d79da5002,2020-03-15T20:00:00Z,0,,100,96,96,38,0,0,41,0,41
20200315,NE,17,80,33,,,,,,,,558bc35b9327ee76d681d0b1357e4c4f73ef8039,2020-03-15T20:00:00Z,,,130,97,97,31,0,0,0,3,3
20200315,NH,13,271,95,,,,,,,,803b79b258e66f237ca1ebf9a8fcde18477cac13,2020-03-15T20:00:00Z,,,379,284,284,33,0,0,59,6,65
20200315,NJ,98,120,34,,,,,,,,cb6357bcd5b00b85173d23a8bd8f41fdb1b098f0,2020-03-15T20:00:00Z,2,,252,218,218,34,1,0,23,48,71
20200315,NM,13,482,,,,,,,,,b95e350ae2b5693dcb353e7c00b01f855a971762,2020-03-15T20:00:00Z,,,495,495,495,35,0,0,245,3,248
20200315,NV,21,168,164,,,,,,,,5c87854db60a5e7331ad07237ca83ba7ebcf7af0,2020-03-15T20:00:00Z,,,353,189,189,32,0,0,0,1,1
20200315,NY,729,4543,,,,,,,,,963f632b5d1577cd5cf9b6c332a912c2fdebea16,2020-03-15T20:00:00Z,3,,5272,5272,5272,36,3,0,1764,205,1969
20200315,OH,36,139,350,,,,,,,,0f9665fdbfb9c2db97a7b8cca0dd02a8dd3fcd41,2020-03-15T20:00:00Z,,,525,175,175,39,0,0,89,23,112
20200315,OK,9,118,12,,,,,,,,c94b4a8b7a6943e47f2b18b0830094b3b5b847aa,2020-03-15T20:00:00Z,,,139,127,127,40,0,0,82,5,87
20200315,OR,36,420,225,,,,,,,,ee34e334d60acd6c6786608eaf502ef3469b027a,2020-03-15T20:00:00Z,,,681,456,456,41,0,0,83,6,89
20200315,PA,63,205,183,,,,,,,,b456aca3dcfc156e659cf9d83c9b906acb7c5ae5,2020-03-15T20:00:00Z,,,451,268,268,42,0,0,0,16,16
20200315,RI,20,271,57,,,,,,,,84f802e7560c1a892f234e2cb31b236fb075f6f5,2020-03-15T20:00:00Z,,,348,291,291,44,0,0,73,0,73
20200315,SC,19,154,,,,,,,,,75ba73b3bb3053eb03805d2812d5c2e4395f1b6f,2020-03-15T20:00:00Z,,,173,173,173,45,0,0,44,6,50
20200315,SD,9,327,6,,,,,,,,fa88e329d335599e26ea9fd7b6eea1fb83b0c06a,2020-03-15T20:00:00Z,,,342,336,336,46,0,0,145,0,145
20200315,TN,39,157,,,,,,,,,0d4cfb67c9ea0c68b1210ef9b0a90d12b748672f,2020-03-15T20:00:00Z,,,196,196,196,47,0,0,27,7,34
20200315,TX,56,,,,,,,,,,5703287c6d3b6d2f1e4e3de43cc125edafaa598a,2020-03-15T20:00:00Z,,,56,56,56,48,0,0,0,5,5
20200315,UT,28,131,,,,,,,,,557e214eba87dfaba62c598c539e3a281022e741,2020-03-15T20:00:00Z,0,,159,159,159,49,0,0,0,22,22
20200315,VA,45,363,,,,,,,,,8cb2bceeeb5e766ece4e5e0141e5c46174a1c784,2020-03-15T20:00:00Z,1,,408,408,408,51,1,0,246,15,261
20200315,VT,4,348,,,,,,,,,c240b0b7e625d08e14362a93fac37a9cb859d539,2020-03-15T20:00:00Z,,,352,352,352,50,0,0,121,0,121
20200315,WA,939,18372,,,,,,,,,af4c68ef40d09f98ee818311e46f782cdcaf44fc,2020-03-15T20:00:00Z,57,,19311,19311,19311,53,6,0,1589,133,1722
20200315,WI,33,313,,,,,,,,,76f9cefe3cbfb28b81648f15bcc59d6507801772,2020-03-15T20:00:00Z,,,346,346,346,55,0,0,144,14,158
20200315,WV,0,38,1,,,,,,,,36d80d812a5ba34def01d46af9f6a7760b182f43,2020-03-15T20:00:00Z,0,,39,38,38,54,0,0,12,0,12
20200315,WY,3,,,,,,,,,,74566767a2c99e0bdfd11a6e545fd9ed02e9e716,2020-03-15T20:00:00Z,,,3,3,3,56,0,0,0,1,1
20200314,AK,1,143,,,,,,,,,51927c4e4dbfbb223d7918b147e2506f73550900,2020-03-14T20:00:00Z,0,,144,144,144,02,0,0,84,0,84
20200314,AL,6,22,46,,,,,,,,5c89c1e4d5be4e39281e7629e2d8969f9d54bb00,2020-03-14T20:00:00Z,,,74,28,28,01,0,0,11,5,16
20200314,AR,12,65,26,,,,,,,,551428a90628981e98f1a49df229dc8e2a8a6bfe,2020-03-14T20:00:00Z,,,103,77,77,05,0,0,35,3,38
20200314,AZ,12,121,50,,,,,,,,c40ab8d2dcf6deaeecfa0bab73a691ec90124122,2020-03-14T20:00:00Z,0,,183,133,133,04,0,0,27,3,30
20200314,CA,252,916,,,,,,,,,bfe38009fc5e230d310f823f106a0947b1a2bce3,2020-03-14T20:00:00Z,5,,1168,1168,1168,06,1,0,0,50,50
20200314,CO,101,610,,,,,,,,,8247505b13764c1e92a341ef32b62d362e995ca1,2020-03-14T20:00:00Z,1,,711,711,711,08,1,0,86,29,115
20200314,CT,11,125,,,,,,,,,149bffa1dda5d74304599eb67e85167eb9cc7940,2020-03-14T20:00:00Z,,,136,136,136,09,0,0,26,5,31
20200314,DC,10,49,10,,,,,,,,8da2326fcb3ada2f8eb58b168fa3cfd71a21ad34,2020-03-14T20:00:00Z,,,69,59,59,11,0,0,29,0,29
20200314,DE,6,36,32,,,,,,,,ddc0cc501e0b9f023ee1294fe142fcf25fd092b9,2020-03-14T20:00:00Z,,,74,42,42,10,0,0,6,2,8
20200314,FL,77,478,221,,,,,,,,96d30f3427bff70e4f87d99ae5c42be36a0034ac,2020-03-14T20:00:00Z,3,,776,555,555,12,1,0,0,27,27
20200314,GA,66,,,,,,,,,,97be6babd64500d6ebd30859d68fc26fff2e4848,2020-03-14T20:00:00Z,1,,66,66,66,13,0,0,0,24,24
20200314,HI,2,,,,,,,,,,b958c9810a3946b62408f0111a12c70f54049101,2020-03-14T20:00:00Z,,,2,2,2,15,0,0,0,0,0
20200314,IA,17,83,,,,,,,,,e4c108405861a595205e19c9154417a48c5aae91,2020-03-14T20:00:00Z,,,100,100,100,19,0,0,0,1,1
20200314,ID,2,174,,,,,,,,,952932b75b80cd3991df8a8c7db4f64acce89d58,2020-03-14T20:00:00Z,,,176,176,176,16,0,0,43,2,45
20200314,IL,46,316,82,,,,,,,,9ce71ff3b9101f5ced145411c578a9b370c032a8,2020-03-14T20:00:00Z,,,444,362,362,17,0,0,22,14,36
20200314,IN,15,74,,,,,,,,,14f3f66fde7e3e752f7f5e81e40cb946e7bca3af,2020-03-14T20:00:00Z,0,,89,89,89,18,0,0,13,3,16
20200314,KS,6,93,,,,,,,,,278e3c9e3e9f10641ced32dcb4caaa1d4a3b141d,2020-03-14T20:00:00Z,1,,99,99,99,20,1,0,0,0,0
20200314,KY,14,139,,,,,,,,,53ea76cd7050bee2da9a57fca2b4538d1926af6d,2020-03-14T20:00:00Z,,,153,153,153,21,0,0,32,3,35
20200314,LA,69,109,,,,,,,,,c80c2be31c70d2b05d47fb0b55f9297f827690f7,2020-03-14T20:00:00Z,,,178,178,178,22,0,0,72,33,105
20200314,MA,38,,,,,,,,,,890b1628d45851f544c69d584618fdb36f232d35,2020-03-14T20:00:00Z,,,38,38,38,25,0,0,0,15,15
20200314,MD,26,94,,,,,,,,,8fefdbf242c49256c9711173cc7a195bdfeaf897,2020-03-14T20:00:00Z,,,120,120,120,24,0,0,0,9,9
20200314,ME,3,91,17,,,,,,,,f8e0701ef750fd7833940e085f356967698a709e,2020-03-14T20:00:00Z,,,111,94,94,23,0,0,0,0,0
20200314,MI,1196,205,26,,,,,,,,3d48e2414257cbaf0f316c284d283c7c64c15194,2020-03-14T20:00:00Z,,,1427,1401,1401,26,0,0,72,251,323
20200314,MN,21,847,,,,,,,,,43db9c125581cdb0eaed4688c2bcc3692d524ccd,2020-03-14T20:00:00Z,,,868,868,868,27,0,0,306,7,313
20200314,MO,4,90,,,,,,,,,5220c08925c1338bbc1ababb24afaf6558a68b9c,2020-03-14T20:00:00Z,0,,94,94,94,29,0,0,19,2,21
20200314,MS,6,84,,,,,,,,,262146bdcf966d7bd2b95df77b8c19d904242248,2020-03-14T20:00:00Z,,,90,90,90,28,0,0,43,2,45
20200314,MT,5,103,,,,,,,,,3b3767d29a7f2c8246d957b64ab51b460e66230c,2020-03-14T20:00:00Z,,,108,108,108,30,0,0,48,4,52
20200314,NC,23,137,,,,,,,,,1097b4e88ff28fd47bd79effc50736bcc4f98d4d,2020-03-14T20:00:00Z,,,160,160,160,37,0,0,51,8,59
20200314,ND,1,54,14,,,,,,,,a52a443da4b61469c6be7d12ad2fe848c421dd0f,2020-03-14T20:00:00Z,0,,69,55,55,38,0,0,15,0,15
20200314,NE,14,80,33,,,,,,,,936f44463ab4c62d7cf30fc400ef265c45f8b3f5,2020-03-14T20:00:00Z,,,127,94,94,31,0,0,0,1,1
20200314,NH,7,212,31,,,,,,,,8df5e37a5d8dabbb6fb2821a99d3d0d90b27fc85,2020-03-14T20:00:00Z,,,250,219,219,33,0,0,118,1,119
20200314,NJ,50,97,80,,,,,,,,0b8634c5fd4e1160dde841c792bf7c6fc9315232,2020-03-14T20:00:00Z,1,,227,147,147,34,0,0,0,0,0
20200314,NM,10,237,,,,,,,,,0085a52176e881bb6ad037e0c30af4f74d9489f9,2020-03-14T20:00:00Z,,,247,247,247,35,0,0,47,0,47
20200314,NV,20,168,,,,,,,,,2e60e44122a1faf4a4351249cef4569aeb6b4a89,2020-03-14T20:00:00Z,,,188,188,188,32,0,0,0,9,9
20200314,NY,524,2779,,,,,,,,,f28c39ca671c26d022ff2556494ad8767765eb93,2020-03-14T20:00:00Z,,,3303,3303,3303,36,0,0,0,103,103
20200314,OH,13,50,159,,,,,,,,fc63d6218734893ad458fb97af8018f3a1ec1ad5,2020-03-14T20:00:00Z,,,222,63,63,39,0,0,0,0,0
20200314,OK,4,36,37,,,,,,,,c73b103132566a7e2d3c71510adc6def73b88940,2020-03-14T20:00:00Z,,,77,40,40,40,0,0,0,1,1
20200314,OR,30,337,157,,,,,,,,1400911ca9d80be2f8e342c113a1df4d70338602,2020-03-14T20:00:00Z,,,524,367,367,41,0,0,0,0,0
20200314,PA,47,205,150,,,,,,,,d18f94522023cea299270dcc1602530f2ddc0dc4,2020-03-14T20:00:00Z,,,402,252,252,42,0,0,65,6,71
20200314,RI,20,198,57,,,,,,,,398dbebda7a13f625f8978b5e493f80fa0c06bc4,2020-03-14T20:00:00Z,,,275,218,218,44,0,0,56,6,62
20200314,SC,13,110,,,,,,,,,f59023a910249b3d8b3511ae10d8f11517a1c519,2020-03-14T20:00:00Z,,,123,123,123,45,0,0,35,1,36
20200314,SD,9,182,3,,,,,,,,df4f632f3d3f47fd86232363e123ffd6096af646,2020-03-14T20:00:00Z,,,194,191,191,46,0,0,109,0,109
20200314,TN,32,130,,,,,,,,,6becf2091344bee8d3a7f0a0a437ccf76ed9dd53,2020-03-14T20:00:00Z,,,162,162,162,47,0,0,14,6,20
20200314,TX,51,,,,,,,,,,8a47a6e610ae58718993de453b89aa3908c67fbd,2020-03-14T20:00:00Z,,,51,51,51,48,0,0,0,12,12
20200314,UT,6,131,,,,,,,,,577b43eb324c0ae69322cc15f477ca37d5daf36b,2020-03-14T20:00:00Z,,,137,137,137,49,0,0,0,0,0
20200314,VA,30,117,,,,,,,,,33f505467e5a143bd0ecda4d5622091a48ad3d2e,2020-03-14T20:00:00Z,,,147,147,147,51,0,0,0,0,0
20200314,VT,4,227,,,,,,,,,570d73d25152c4e93987f89a83b40ff5480a7682,2020-03-14T20:00:00Z,,,231,231,231,50,0,0,85,2,87
20200314,WA,806,16783,,,,,,,,,6bf00b641b898b030eaf708a414e1dbf96afc38c,2020-03-14T20:00:00Z,51,,17589,17589,17589,53,4,0,2185,104,2289
20200314,WI,19,169,,,,,,,,,8f1ed69b1d5723cbd5b18d1ec332fa4f83bde08a,2020-03-14T20:00:00Z,,,188,188,188,55,0,0,0,0,0
20200314,WV,0,26,5,,,,,,,,7e27957cf04398b64db2982ccd580fd5455ffebb,2020-03-14T20:00:00Z,,,31,26,26,54,0,0,9,0,9
20200314,WY,2,,,,,,,,,,00d1959cf22a0162be10edb9d849b320e1db37e7,2020-03-14T20:00:00Z,,,2,2,2,56,0,0,0,1,1
20200313,AK,1,59,,,,,,,,,96bc2169cdd09b20fceb23dd67dc70a956094851,2020-03-13T20:00:00Z,0,,60,60,60,02,0,0,13,1,14
20200313,AL,1,11,,,,,,,,,b9e856f0b5f6b1893dbe080ee99cbebd5723f4f8,2020-03-13T20:00:00Z,,,12,12,12,01,0,0,1,1,2
20200313,AR,9,30,22,,,,,,,,a6aff5e9908d4f1a167655d035338e838ba8cdba,2020-03-13T20:00:00Z,,,61,39,39,05,0,0,6,3,9
20200313,AZ,9,94,40,,,,,,,,68c52c41afcca5a93045251c1a7e05b086b85767,2020-03-13T20:00:00Z,0,,143,103,103,04,0,0,12,0,12
20200313,CA,202,916,,,,,,,,,bb817225b0e56a4c1051b2e6550b5ae85e06487c,2020-03-13T20:00:00Z,4,,1118,1118,1118,06,0,0,0,0,0
20200313,CO,72,524,,,,,,,,,f081206fdd232801c4719c7b15f928e95e16c0a4,2020-03-13T20:00:00Z,,,596,596,596,08,0,0,226,27,253
20200313,CT,6,99,,,,,,,,,682c544537c9fb686f945084a154361a3c8a386f,2020-03-13T20:00:00Z,,,105,105,105,09,0,0,10,0,10
20200313,DC,10,20,,,,,,,,,47405f5c12651491f7aaeeadcf98a21f5290298e,2020-03-13T20:00:00Z,,,30,30,30,11,0,0,0,0,0
20200313,DE,4,30,10,,,,,,,,01a39bf98baae6616556fc98432b0eab5ec19d21,2020-03-13T20:00:00Z,,,44,34,34,10,0,0,7,0,7
20200313,FL,50,478,221,,,,,,,,e2f015841b99a9056a83e88b541e2f27fe57bdea,2020-03-13T20:00:00Z,2,,749,528,528,12,0,0,177,18,195
20200313,GA,42,,,,,,,,,,a1b71ddadb4a8d03aab0ae5ee76889c2cdefe5bf,2020-03-13T20:00:00Z,1,,42,42,42,13,1,0,0,11,11
20200313,HI,2,,,,,,,,,,d517fed5e44222b8e9ec35423adff6841571d310,2020-03-13T20:00:00Z,,,2,2,2,15,0,0,0,0,0
20200313,IA,16,83,29,,,,,,,,9a4dc657b7cf736b9c1a23162cb7bd246891b602,2020-03-13T20:00:00Z,,,128,99,99,19,0,0,16,2,18
20200313,ID,0,131,,,,,,,,,b1671d598b98d1510491784f4c280a368ba8c39e,2020-03-13T20:00:00Z,,,131,131,131,16,0,0,38,0,38
20200313,IL,32,294,92,,,,,,,,3a4c6b2710e412f845b0c387c44def3dba4d011b,2020-03-13T20:00:00Z,,,418,326,326,17,0,0,28,7,35
20200313,IN,12,61,,,,,,,,,6a95bce7fff18ca959c83513dc8e4b4b8458d719,2020-03-13T20:00:00Z,,,73,73,73,18,0,0,9,0,9
20200313,KS,6,93,,,,,,,,,8633a26e1f484f8d6832c17efdb6e638ffb3515e,2020-03-13T20:00:00Z,,,99,99,99,20,0,0,52,2,54
20200313,KY,11,107,,,,,,,,,4d515c6fe8ed706c415382ef87cfa9236ac4e09c,2020-03-13T20:00:00Z,,,118,118,118,21,0,0,51,3,54
20200313,LA,36,37,,,,,,,,,78393fa814aa0caf1ae4f6056e80e21adf672bf2,2020-03-13T20:00:00Z,,,73,73,73,22,0,0,0,22,22
20200313,MA,23,,,,,,,,,,a40e6b46a78cdba67454df69aa24df5586db2211,2020-03-13T20:00:00Z,,,23,23,23,25,0,0,0,15,15
20200313,MD,17,94,,,,,,,,,32d329849128913476d4a0773fea76a4b3e2b083,2020-03-13T20:00:00Z,,,111,111,111,24,0,0,0,5,5
20200313,ME,3,91,17,,,,,,,,8ecdd4f1eb3ad0874071c97b48e3bc8ae16edf37,2020-03-13T20:00:00Z,,,111,94,94,23,0,0,26,2,28
20200313,MI,945,133,26,,,,,,,,f532160c7cd2aba3ca450b21c2c4a81099342d44,2020-03-13T20:00:00Z,,,1104,1078,1078,26,0,0,42,243,285
20200313,MN,14,541,,,,,,,,,094cc2b8f1b021d450e7d7fa08596000fc7f4e05,2020-03-13T20:00:00Z,,,555,555,555,27,0,0,234,5,239
20200313,MO,2,71,,,,,,,,,4d53392cae812d4039af40a07e38bc5fe77212fb,2020-03-13T20:00:00Z,,,73,73,73,29,0,0,7,1,8
20200313,MS,4,41,,,,,,,,,9fc8f265d6c9e8b4883399e23c0b0190c2686599,2020-03-13T20:00:00Z,,,45,45,45,28,0,0,0,3,3
20200313,MT,1,55,,,,,,,,,3190b3a30f1124eebbb4e9bccd677cf22f2ae6c0,2020-03-13T20:00:00Z,,,56,56,56,30,0,0,21,0,21
20200313,NC,15,86,,,,,,,,,9b22973bdb1a321a3b9cc273f6250675bf95124b,2020-03-13T20:00:00Z,,,101,101,101,37,0,0,26,3,29
20200313,ND,1,39,12,,,,,,,,16823997d9c4db1ae19dccaba18481746cfe85cf,2020-03-13T20:00:00Z,0,,52,40,40,38,0,0,27,0,27
20200313,NE,13,80,33,,,,,,,,72bf9214dd1c1c24ce38fd46893604d18cc124f7,2020-03-13T20:00:00Z,,,126,93,93,31,0,0,0,3,3
20200313,NH,6,94,21,,,,,,,,ce083d3bb0b226ff0599d533768ad2b62f892b40,2020-03-13T20:00:00Z,,,121,100,100,33,0,0,0,0,0
20200313,NJ,50,97,80,,,,,,,,dd9375b158d3020716fe7e1d759d510332c818e3,2020-03-13T20:00:00Z,1,,227,147,147,34,0,0,23,20,43
20200313,NM,10,190,,,,,,,,,5e21e22aacd1a08b396a2c457c553776e3c8bedf,2020-03-13T20:00:00Z,,,200,200,200,35,0,0,35,5,40
20200313,NV,11,168,,,,,,,,,5c86c34f504be7bf2a593223447a7f2d5f18877a,2020-03-13T20:00:00Z,,,179,179,179,32,0,0,0,4,4
20200313,NY,421,2779,,,,,,,,,a0a0e2997c411014ef2cd98b9502387730f585c7,2020-03-13T20:00:00Z,,,3200,3200,3200,36,0,0,2687,205,2892
20200313,OH,13,50,159,,,,,,,,fe5ed1e40f012163a6510cabdea90e044e5e56ab,2020-03-13T20:00:00Z,,,222,63,63,39,0,0,20,8,28
20200313,OK,3,36,37,,,,,,,,41b22c1ee50041708e574581687a0c4155caa8aa,2020-03-13T20:00:00Z,,,76,39,39,40,0,0,0,0,0
20200313,OR,30,337,157,,,,,,,,ee29420a1ee3ce2e33cdf966ecbdfc575d26206b,2020-03-13T20:00:00Z,,,524,367,367,41,0,0,51,11,62
20200313,PA,41,140,130,,,,,,,,1b1cf720a3254db83abcb451d397a731f9fdf38a,2020-03-13T20:00:00Z,,,311,181,181,42,0,0,24,19,43
20200313,RI,14,142,29,,,,,,,,3b21b07952531010abf6628fe837a9f97fd33797,2020-03-13T20:00:00Z,,,185,156,156,44,0,0,48,9,57
20200313,SC,12,75,,,,,,,,,89ac68f7349872023eb4ba7e8d49e17e3221b4cc,2020-03-13T20:00:00Z,,,87,87,87,45,0,0,27,2,29
20200313,SD,9,73,11,,,,,,,,9a7c944cb0774212146d5eecb0aa11b12de52eb6,2020-03-13T20:00:00Z,,,93,82,82,46,0,0,46,1,47
20200313,TN,26,116,,,,,,,,,5dd412ea26ef8d20d55a6410d59726087883cd99,2020-03-13T20:00:00Z,,,142,142,142,47,0,0,37,8,45
20200313,TX,39,,,,,,,,,,3964195c15cc0e37c244f112bcbae5789a5c6489,2020-03-13T20:00:00Z,,,39,39,39,48,0,0,0,16,16
20200313,UT,6,131,,,,,,,,,610050cffa209508ec65a9bf756ef16d617d69c5,2020-03-13T20:00:00Z,,,137,137,137,49,0,0,0,2,2
20200313,VA,30,117,,,,,,,,,d2ecd673874966076229036999033a3993ffed2b,2020-03-13T20:00:00Z,,,147,147,147,51,0,0,0,13,13
20200313,VT,2,142,,,,,,,,,a02dcfb55e5f9ed028f6328c61b41408533038c1,2020-03-13T20:00:00Z,,,144,144,144,50,0,0,45,0,45
20200313,WA,702,14598,,,,,,,,,da223308e5f985db2f620d6fff892100b27ad346,2020-03-13T20:00:00Z,47,,15300,15300,15300,53,3,0,4027,151,4178
20200313,WI,19,169,,,,,,,,,3936ef13cd65e7b15ac22d0d981357b9f6dcce8d,2020-03-13T20:00:00Z,,,188,188,188,55,0,0,85,11,96
20200313,WV,0,17,4,,,,,,,,10eb8c5e07049f2c299d03ef30ceb60a49142335,2020-03-13T20:00:00Z,,,21,17,17,54,0,0,10,0,10
20200313,WY,1,,,,,,,,,,610cc4a0b9c9015f6214bfe928f0acf116f8b75c,2020-03-13T20:00:00Z,,,1,1,1,56,0,0,0,0,0
20200312,AK,0,46,14,,,,,,,,89cc53e36928b9f7a247981e3f6540630bbf521e,2020-03-12T20:00:00Z,0,,60,46,46,02,0,0,0,0,0
20200312,AL,0,10,,,,,,,,,34204c36040e342af491e5329aca50e88f2cbaba,2020-03-12T20:00:00Z,,,10,10,10,01,0,0,0,0,0
20200312,AR,6,24,20,,,,,,,,fe5ece5453dac3d08b87f1ab7a10e00bf7cfdfc9,2020-03-12T20:00:00Z,,,50,30,30,05,0,0,12,6,18
20200312,AZ,9,82,24,,,,,,,,542a30820399e2d4ec7a2787e6760577326f402d,2020-03-12T20:00:00Z,,,115,91,91,04,0,0,23,0,23
20200312,CA,202,916,,,,,,,,,8dd3541eb41a6171cc6bbf05632f8d9bb4570490,2020-03-12T20:00:00Z,4,,1118,1118,1118,06,4,0,0,45,45
20200312,CO,45,298,,,,,,,,,fef01602b9d42355347ffd39fc33776f6d251c7e,2020-03-12T20:00:00Z,,,343,343,343,08,0,0,47,17,64
20200312,CT,6,89,,,,,,,,,438f9707c60dbf6c5042c0686dfa479170d3471a,2020-03-12T20:00:00Z,,,95,95,95,09,0,0,18,3,21
20200312,DC,10,20,,,,,,,,,2afd9cde94fa8693b5eb2da4552eecf9452ad2c0,2020-03-12T20:00:00Z,,,30,30,30,11,0,0,0,5,5
20200312,DE,4,23,14,,,,,,,,0cfca14a0bd4e74cc01ef2a9030f65643237496d,2020-03-12T20:00:00Z,,,41,27,27,10,0,0,6,3,9
20200312,FL,32,301,147,,,,,,,,e30f5e735d56d705f8ed9768797ed07fc2d8173a,2020-03-12T20:00:00Z,2,,480,333,333,12,0,0,0,4,4
20200312,GA,31,,,,,,,,,,b54e3a842da88ee7e2685e1625d6b47466982662,2020-03-12T20:00:00Z,,,31,31,31,13,0,0,0,9,9
20200312,HI,2,,,,,,,,,,448f4f6242f8f4d56b53911f8f41f857fea624ad,2020-03-12T20:00:00Z,,,2,2,2,15,0,0,0,0,0
20200312,IA,14,67,24,,,,,,,,c66bca36e23ed4238801da6edce433a068219c83,2020-03-12T20:00:00Z,,,105,81,81,19,0,0,21,1,22
20200312,ID,0,93,,,,,,,,,ea688b0e32219776fd27b38e03bee45e42111379,2020-03-12T20:00:00Z,,,93,93,93,16,0,0,26,0,26
20200312,IL,25,266,76,,,,,,,,f521fa0222b25b297e082e1285cb6efc89a5b552,2020-03-12T20:00:00Z,,,367,291,291,17,0,0,22,6,28
20200312,IN,12,52,,,,,,,,,dcfcf297a028962a948869e94197bbe14be0bd93,2020-03-12T20:00:00Z,,,64,64,64,18,0,0,19,2,21
20200312,KS,4,41,,,,,,,,,332ee3bb9b5f431704d8cd139631096cf6e7551b,2020-03-12T20:00:00Z,,,45,45,45,20,0,0,0,3,3
20200312,KY,8,56,,,,,,,,,cebe01b90cd5896a2bdea84cba4ee4b563f24ee9,2020-03-12T20:00:00Z,,,64,64,64,21,0,0,10,0,10
20200312,LA,14,37,,,,,,,,,90d5fc83d9f4c831c653f38b96e49251057d9cb7,2020-03-12T20:00:00Z,,,51,51,51,22,0,0,0,8,8
20200312,MA,8,,,,,,,,,,cb45ec4c3465b258b1a1976578cdb272119f90e8,2020-03-12T20:00:00Z,,,8,8,8,25,,,,,
20200312,MD,12,94,,,,,,,,,08b84f6b613a011507c9190271ec545191ee68bb,2020-03-12T20:00:00Z,,,106,106,106,24,0,0,0,3,3
20200312,ME,1,65,20,,,,,,,,b39c56076bac0a4ddd2e88d3f04d0c785d75732d,2020-03-12T20:00:00Z,,,86,66,66,23,0,0,23,1,24
20200312,MI,702,91,27,,,,,,,,74155341404d09da59405465245832fca16f954b,2020-03-12T20:00:00Z,,,820,793,793,26,0,0,34,205,239
20200312,MN,9,307,,,,,,,,,523bdda158c8db3de757d18a38756ffe1ce9b21b,2020-03-12T20:00:00Z,,,316,316,316,27,0,0,90,4,94
20200312,MO,1,64,,,,,,,,,5b415b8bf401db354d5f6a778e699e7eb170976d,2020-03-12T20:00:00Z,,,65,65,65,29,0,0,64,0,64
20200312,MS,1,41,,,,,,,,,6aad8ec86cdaa93329eeda6aa46670dd6ca609b1,2020-03-12T20:00:00Z,,,42,42,42,28,0,0,21,1,22
20200312,MT,1,34,,,,,,,,,4b8bef9b3d9fa1079cbd7be5288076fb401598c1,2020-03-12T20:00:00Z,,,35,35,35,30,0,0,13,1,14
20200312,NC,12,60,,,,,,,,,7442624a12322777c7110f0101d61d097da12ade,2020-03-12T20:00:00Z,,,72,72,72,37,0,0,60,5,65
20200312,ND,1,12,14,,,,,,,,101ef2bb022ea0209aaa020d3e2852b8964d9134,2020-03-12T20:00:00Z,,,27,13,13,38,0,0,5,1,6
20200312,NE,10,80,33,,,,,,,,a4238a2a6795e1cd4e971a336c36e526d59e25d7,2020-03-12T20:00:00Z,,,123,90,90,31,0,0,33,5,38
20200312,NH,6,94,21,,,,,,,,7e575bc7e2ffdb783ca744e42ac10956980b5aba,2020-03-12T20:00:00Z,,,121,100,100,33,0,0,56,2,58
20200312,NJ,30,74,20,,,,,,,,5f40e6cdda7648d658eedd3a5e5bf0f027c9b374,2020-03-12T20:00:00Z,1,,124,104,104,34,0,0,17,6,23
20200312,NM,5,155,,,,,,,,,d358c1f38d0d81a3f4719e9a593a533ccee69a30,2020-03-12T20:00:00Z,,,160,160,160,35,0,0,68,2,70
20200312,NV,7,168,,,,,,,,,8328b62027a10326d300d9fbe07f651846ae2f52,2020-03-12T20:00:00Z,,,175,175,175,32,0,0,0,2,2
20200312,NY,216,92,,,,,,,,,78ea2217b81c0eba25ec04b1196199ad81793ead,2020-03-12T20:00:00Z,,,308,308,308,36,0,0,0,0,0
20200312,OH,5,30,52,,,,,,,,e53fb02834680a20508e2d3bf535470016d3407a,2020-03-12T20:00:00Z,,,87,35,35,39,0,0,9,1,10
20200312,OK,3,36,4,,,,,,,,0695ce1aed2deb9062e4a75ce05c7d5fbb2b3975,2020-03-12T20:00:00Z,,,43,39,39,40,0,0,21,1,22
20200312,OR,19,286,62,,,,,,,,842079fddc7a5740cd7252af4ef8f126bb9784d9,2020-03-12T20:00:00Z,,,367,305,305,41,0,0,0,0,0
20200312,PA,22,116,81,,,,,,,,bb985e06b75f251244341704b20d6b0c3daa27c1,2020-03-12T20:00:00Z,,,219,138,138,42,0,0,28,6,34
20200312,RI,5,94,8,,,,,,,,ddc07b8ec93f55583d98d5fff9c8d922808f6f98,2020-03-12T20:00:00Z,,,107,99,99,44,0,0,0,0,0
20200312,SC,10,48,,,,,,,,,691f174c432862e793e830327356b4d500cea11b,2020-03-12T20:00:00Z,,,58,58,58,45,0,0,16,1,17
20200312,SD,8,27,11,,,,,,,,47b6b8df0ade463177dd058de543bf80295b9b74,2020-03-12T20:00:00Z,,,46,35,35,46,0,0,14,3,17
20200312,TN,18,79,,,,,,,,,6e03cc4e5261258b7a5b8901327389775888ec5f,2020-03-12T20:00:00Z,,,97,97,97,47,0,0,29,11,40
20200312,TX,23,,,,,,,,,,35761868039ccd3294dc3e7e548781c129b39185,2020-03-12T20:00:00Z,,,23,23,23,48,0,0,0,2,2
20200312,UT,4,131,,,,,,,,,f2f3cbbd89fcfd9045a7ece563a5d84bc969009a,2020-03-12T20:00:00Z,,,135,135,135,49,0,0,131,2,133
20200312,VA,17,117,,,,,,,,,4d7e98639658d0746cb09b19b3fe2285f875af3b,2020-03-12T20:00:00Z,,,134,134,134,51,0,0,57,8,65
20200312,VT,2,97,,,,,,,,,7279c174377b4d61c1a6e3f40530ad2505b9a9a8,2020-03-12T20:00:00Z,,,99,99,99,50,0,0,35,1,36
20200312,WA,551,10571,,,,,,,,,f831d08b1cc85a0b4e785790c4f3e20a506ab0d5,2020-03-12T20:00:00Z,44,,11122,11122,11122,53,4,0,3594,70,3664
20200312,WI,8,84,,,,,,,,,95e71f1997094b8460d58d94f2899a4b774e8a1d,2020-03-12T20:00:00Z,,,92,92,92,55,0,0,41,5,46
20200312,WV,0,7,1,,,,,,,,f0363560bc99a7f3bb66a17c11ced07c055ec423,2020-03-12T20:00:00Z,,,8,7,7,54,0,0,4,0,4
20200312,WY,1,,,,,,,,,,c8b2e0e377fc5c379d3775630a3ae430fb21861b,2020-03-12T20:00:00Z,,,1,1,1,56,0,0,0,1,1
20200311,AK,0,46,14,,,,,,,,38875040d04adb926bb80da9c4eeed89e944d306,2020-03-11T20:00:00Z,0,,60,46,46,02,0,0,23,0,23
20200311,AL,0,10,,,,,,,,,e4593577708b6182b9126434908df283def67838,2020-03-11T20:00:00Z,,,10,10,10,01,0,0,10,0,10
20200311,AR,0,12,14,,,,,,,,655d51e087ae7e668a3932904fd2764bc1fe3a9a,2020-03-11T20:00:00Z,,,26,12,12,05,0,0,0,0,0
20200311,AZ,9,59,32,,,,,,,,fc3cab43e403773ab7bee5f42d8dd1ccc405c3d5,2020-03-11T20:00:00Z,,,100,68,68,04,0,0,8,3,11
20200311,CA,157,916,,,,,,,,,5b964b8b4ae1c9c7ef6daba3357363e3abc15fc2,2020-03-11T20:00:00Z,,,1073,1073,1073,06,0,0,226,24,250
20200311,CO,28,251,,,,,,,,,9b7a26b306bf3d4ed340b3decc9409cfd98c94a7,2020-03-11T20:00:00Z,,,279,279,279,08,0,0,109,16,125
20200311,CT,3,71,,,,,,,,,c99636f2a99205c741fd1f78c991a31f4b2c23d5,2020-03-11T20:00:00Z,,,74,74,74,09,0,0,17,1,18
20200311,DC,5,20,15,,,,,,,,71b585cf49baefd551d06676e7954dc71f2a64e8,2020-03-11T20:00:00Z,,,40,25,25,11,0,0,3,0,3
20200311,DE,1,17,2,,,,,,,,9bc125877399e695097bfde306db2dc3cf015ec3,2020-03-11T20:00:00Z,,,20,18,18,10,0,0,0,1,1
20200311,FL,28,301,147,,,,,,,,3fdf9b7b837d64d12ac78cb3c27b3e075e5b91d0,2020-03-11T20:00:00Z,2,,476,329,329,12,2,0,79,9,88
20200311,GA,22,,,,,,,,,,11817b5a695d27b1ffda2ebe492653bca8075308,2020-03-11T20:00:00Z,,,22,22,22,13,0,0,0,5,5
20200311,HI,2,,,,,,,,,,ff1bcb7f451b4534cf4cb3660cd288cb0aecd55e,2020-03-11T20:00:00Z,,,2,2,2,15,0,0,0,0,0
20200311,IA,13,46,27,,,,,,,,77b0abb25053b84dfa901e4bc749840c4d626415,2020-03-11T20:00:00Z,,,86,59,59,19,0,0,14,5,19
20200311,ID,0,67,,,,,,,,,25d42d5a1f05b6d80d04134977322867c07531b1,2020-03-11T20:00:00Z,,,67,67,67,16,0,0,26,0,26
20200311,IL,19,244,63,,,,,,,,1f62279f30c95b7b5b306bd94b9172a3f9a3b94c,2020-03-11T20:00:00Z,,,326,263,263,17,0,0,0,0,0
20200311,IN,10,33,,,,,,,,,5733cad52da8fd692ae6386e05e95fa3faf2c337,2020-03-11T20:00:00Z,,,43,43,43,18,0,0,3,4,7
20200311,KS,1,41,,,,,,,,,1b65c26cb311dbfa7aa49f1aab7df29d4100afd6,2020-03-11T20:00:00Z,,,42,42,42,20,0,0,24,0,24
20200311,KY,8,46,,,,,,,,,fc0fc1ddfd9df01dee163a7f07ef68f158f1dcc7,2020-03-11T20:00:00Z,,,54,54,54,21,0,0,18,2,20
20200311,LA,6,37,,,,,,,,,4923914a2b53558e2c4f3c3e417339a9c725cee5,2020-03-11T20:00:00Z,,,43,43,43,22,0,0,26,5,31
20200311,MD,9,94,,,,,,,,,d63a695f033bd1727a5d48dc63cfc733e465f19f,2020-03-11T20:00:00Z,,,103,103,103,24,0,0,5,3,8
20200311,ME,0,42,5,,,,,,,,56ac39adce93990d2bea6abfff4e3e0c2fac2886,2020-03-11T20:00:00Z,,,47,42,42,23,0,0,22,0,22
20200311,MI,497,57,18,,,,,,,,4606279a91801f7b0fea463939eda7643d7aa752,2020-03-11T20:00:00Z,,,572,554,554,26,0,0,18,139,157
20200311,MN,5,217,,,,,,,,,6ffc74c710267d31359ae6c99715670db75e09e5,2020-03-11T20:00:00Z,,,222,222,222,27,0,0,85,2,87
20200311,MO,1,,,,,,,,,,f38403847cc3922fa5b7b5f616f4398deb2e6827,2020-03-11T20:00:00Z,,,1,1,1,29,0,0,0,0,0
20200311,MS,0,20,,,,,,,,,74f4ed2b75d893f6f2e2a8c45254056db6fe2eec,2020-03-11T20:00:00Z,,,20,20,20,28,0,0,20,0,20
20200311,MT,0,21,,,,,,,,,7f8109a13dd2e5346e22790e352899f32ce51387,2020-03-11T20:00:00Z,,,21,21,21,30,0,0,6,0,6
20200311,NC,7,,,,,,,,,,a47c27a5eb23e60bf9953697c72ea9eea9bf12fc,2020-03-11T20:00:00Z,,,7,7,7,37,0,0,0,0,0
20200311,ND,0,7,6,,,,,,,,f611bed2dbd16399f91bc8000106ae8aaf8cebe3,2020-03-11T20:00:00Z,,,13,7,7,38,0,0,1,0,1
20200311,NE,5,47,16,,,,,,,,fe99e1327ca6570995bfa945ae61ff53a32b57c1,2020-03-11T20:00:00Z,,,68,52,52,31,0,0,0,2,2
20200311,NH,4,38,5,,,,,,,,04ca9fceda7e94b04987880c53564cf1816ad713,2020-03-11T20:00:00Z,,,47,42,42,33,0,0,0,0,0
20200311,NJ,24,57,20,,,,,,,,22b493a9273eb0fcbef1d9438567b97aca475b07,2020-03-11T20:00:00Z,1,,101,81,81,34,1,0,13,9,22
20200311,NM,3,87,,,,,,,,,31d78422b55f96cea7974b12f74b206caea012fc,2020-03-11T20:00:00Z,,,90,90,90,35,0,0,18,3,21
20200311,NV,5,168,,,,,,,,,2cf372124199b53471bb78cd3c8b32fa8b2c89c6,2020-03-11T20:00:00Z,,,173,173,173,32,0,0,154,4,158
20200311,NY,216,92,,,,,,,,,6fbded3854324c39522ab7fdb01d2087f60e2d2b,2020-03-11T20:00:00Z,,,308,308,308,36,0,0,0,43,43
20200311,OH,4,21,24,,,,,,,,7def7afdab71c143358b5a2f7e6043abe2b1a58c,2020-03-11T20:00:00Z,,,49,25,25,39,0,0,7,1,8
20200311,OK,2,15,11,,,,,,,,5ec52c041a7fed2461a75cd7d7b69c16408ed016,2020-03-11T20:00:00Z,,,28,17,17,40,0,0,0,0,0
20200311,OR,19,286,62,,,,,,,,a0862d7ffbd817d0c1174d1060d000628f3e2d56,2020-03-11T20:00:00Z,,,367,305,305,41,0,0,73,4,77
20200311,PA,16,88,54,,,,,,,,a091f3d8c6f3ea5bfda8fc4fe1ac96d182dcb110,2020-03-11T20:00:00Z,,,158,104,104,42,0,0,88,4,92
20200311,RI,5,94,24,,,,,,,,2a70fe659d1a0d6b02523db6b2a5f49859afc8b9,2020-03-11T20:00:00Z,,,123,99,99,44,0,0,36,2,38
20200311,SC,9,32,,,,,,,,,9f0ba59beda560436e4c7086a310d705a164a73f,2020-03-11T20:00:00Z,,,41,41,41,45,0,0,8,2,10
20200311,SD,5,13,2,,,,,,,,e7ff0dfa7e6bd84d5f7633f98e650bd9fef932b6,2020-03-11T20:00:00Z,,,20,18,18,46,0,0,2,5,7
20200311,TN,7,50,,,,,,,,,0531f9d13df3db8ea79200191ddd853777674c53,2020-03-11T20:00:00Z,,,57,57,57,47,0,0,50,0,50
20200311,TX,21,,,,,,,,,,091b385894d0ae05bb6ea5bb6a7272ba6340a7c9,2020-03-11T20:00:00Z,,,21,21,21,48,0,0,0,8,8
20200311,UT,2,,,,,,,,,,76c94894d50c365d4846731e5cecb0f05021007f,2020-03-11T20:00:00Z,,,2,2,2,49,0,0,0,0,0
20200311,VA,9,60,,,,,,,,,a815f0d7942b6f1baa509e533e21d81829a3028d,2020-03-11T20:00:00Z,,,69,69,69,51,0,0,7,1,8
20200311,VT,1,62,,,,,,,,,c8f0f13f72669b1a4b6bde7505772ae78d229919,2020-03-11T20:00:00Z,,,63,63,63,50,0,0,22,0,22
20200311,WA,481,6977,,,,,,,,,b0dde0ec40873ebc672799dd7b5adcc391122ed0,2020-03-11T20:00:00Z,40,,7458,7458,7458,53,3,0,2127,84,2211
20200311,WI,3,43,,,,,,,,,cd76c7d7754176cb52177b3b9327eeeb6752d492,2020-03-11T20:00:00Z,,,46,46,46,55,0,0,7,1,8
20200311,WV,0,3,2,,,,,,,,d4710e9f30d17c17211938eeec385ecf4bc5b2f0,2020-03-11T20:00:00Z,,,5,3,3,54,0,0,1,0,1
20200311,WY,0,,,,,,,,,,b2a970a45b39b2c7ec078c35757610c22241c0f6,2020-03-11T20:00:00Z,,,0,0,0,56,0,0,0,0,0
20200310,AK,0,23,9,,,,,,,,d6e4bd2740be5e71db68c77d0f3030577cd25c19,2020-03-10T20:00:00Z,0,,32,23,23,02,0,0,0,0,0
20200310,AL,0,0,0,,,,,,,,d77d1bec988a8d98086652dbe2ec43647b585934,2020-03-10T20:00:00Z,,,0,0,0,01,0,0,0,0,0
20200310,AR,0,12,3,,,,,,,,76ed6d1dfa326d78b8fc7277b42229fbfb98b6a8,2020-03-10T20:00:00Z,,,15,12,12,05,0,0,0,0,0
20200310,AZ,6,51,27,,,,,,,,5dcc8301933ff5a560e3f87228a47f11150d6833,2020-03-10T20:00:00Z,,,84,57,57,04,0,0,7,1,8
20200310,CA,133,690,,,,,,,,,0d0ac26ba210e002c4cef8b50e8305df0d25daea,2020-03-10T20:00:00Z,,,823,823,823,06,0,0,0,19,19
20200310,CO,12,142,1,,,,,,,,69761082125ab448f7ae1bd685e412afa79151b6,2020-03-10T20:00:00Z,,,155,154,154,08,0,0,9,3,12
20200310,CT,2,54,,,,,,,,,75db1306a0c3b31835dc1c30f84f59c0a1029937,2020-03-10T20:00:00Z,,,56,56,56,09,0,0,8,1,9
20200310,DC,5,17,2,,,,,,,,5ba08a29ba9ee29378b41ef76d6d3d0c369f679c,2020-03-10T20:00:00Z,,,24,22,22,11,0,0,3,4,7
20200310,DE,0,17,3,,,,,,,,a31ea8cf78fa49489859b210157dc22e5260bb01,2020-03-10T20:00:00Z,,,20,17,17,10,0,0,2,0,2
20200310,FL,19,222,155,,,,,,,,28a9eb3913e7fc74070cec1d31d47aaac19e37fe,2020-03-10T20:00:00Z,,,396,241,241,12,0,0,82,1,83
20200310,GA,17,,,,,,,,,,a132882a6ceb7fe633651eb8a444d54b2abf057d,2020-03-10T20:00:00Z,,,17,17,17,13,0,0,0,5,5
20200310,HI,2,,,,,,,,,,2200379e92b872f68070789c24b448f9e633a242,2020-03-10T20:00:00Z,,,2,2,2,15,0,0,0,0,0
20200310,IA,8,32,11,,,,,,,,0339432703c45d77e65b4663ab034cdef1ba1231,2020-03-10T20:00:00Z,,,51,40,40,19,0,0,6,5,11
20200310,ID,0,41,,,,,,,,,3398df61adeea88796c0151991e91767f23fc23b,2020-03-10T20:00:00Z,,,41,41,41,16,0,0,0,0,0
20200310,IL,19,244,63,,,,,,,,61d4b2c48b0bcc01290ae69bcaf6239f7addecee,2020-03-10T20:00:00Z,,,326,263,263,17,0,0,53,12,65
20200310,IN,6,30,,,,,,,,,4fbecba581f9cdd1d759e98a8d4bc184c0f49b18,2020-03-10T20:00:00Z,,,36,36,36,18,0,0,30,4,34
20200310,KS,1,17,21,,,,,,,,d0b4ac6984434e6749c3bb46fc10b7693b8078df,2020-03-10T20:00:00Z,,,39,18,18,20,0,0,6,0,6
20200310,KY,6,28,,,,,,,,,fb7dfcd14029c819e924cd14118e37cc9ea2a536,2020-03-10T20:00:00Z,,,34,34,34,21,0,0,11,2,13
20200310,LA,1,11,,,,,,,,,0cbd4af0d2d6d254ceee5f1d76f6f82e4a2c11d4,2020-03-10T20:00:00Z,,,12,12,12,22,0,0,6,0,6
20200310,MD,6,89,,,,,,,,,8f118d594d196858544dc7c24bc999d3c9843b04,2020-03-10T20:00:00Z,,,95,95,95,24,0,0,16,1,17
20200310,ME,0,20,5,,,,,,,,6d6c02b7fd92ae263c4abcb613d6f26636decd1f,2020-03-10T20:00:00Z,,,25,20,20,23,0,0,19,0,19
20200310,MI,358,39,24,,,,,,,,3e4a39aed98cca92c58aec0c948bd34e7c057f4b,2020-03-10T20:00:00Z,,,421,397,397,26,0,0,3,104,107
20200310,MN,3,132,,,,,,,,,a8bd7312aff6c319969c4284aea579180470d47b,2020-03-10T20:00:00Z,,,135,135,135,27,0,0,52,1,53
20200310,MO,1,,,,,,,,,,1c34a0d3912ffb4d44146d0a8411b013fe7248fc,2020-03-10T20:00:00Z,,,1,1,1,29,0,0,0,0,0
20200310,MS,0,,,,,,,,,,32252d133f8ee8b943fd708c3090d079ce45f7f2,2020-03-10T20:00:00Z,,,0,0,0,28,0,0,0,0,0
20200310,MT,0,15,,,,,,,,,f250ac19e94bd81dd095fe875f429e4570af3286,2020-03-10T20:00:00Z,,,15,15,15,30,0,0,4,0,4
20200310,NC,7,,,,,,,,,,7820bb5206372383942ee45994aaac2274420d5f,2020-03-10T20:00:00Z,,,7,7,7,37,0,0,0,5,5
20200310,ND,0,6,2,,,,,,,,e0805fa5b5182659ea70ca569733d8ba876ad01d,2020-03-10T20:00:00Z,,,8,6,6,38,0,0,6,0,6
20200310,NE,3,47,16,,,,,,,,2eceb89898abf1c18dc8d4e151aa6a9b7f24bd44,2020-03-10T20:00:00Z,,,66,50,50,31,0,0,11,0,11
20200310,NH,4,38,5,,,,,,,,db5511251d15682916c0b2c7d18c8e042946c86c,2020-03-10T20:00:00Z,,,47,42,42,33,0,0,0,0,0
20200310,NJ,15,44,20,,,,,,,,894e37aeac26176f2ecbaeae4a2a73ec49d66177,2020-03-10T20:00:00Z,,,79,59,59,34,0,0,9,4,13
20200310,NM,0,69,,,,,,,,,9c36987288c350a2183bb8af37efa35702813c0d,2020-03-10T20:00:00Z,,,69,69,69,35,0,0,12,0,12
20200310,NV,1,14,,,,,,,,,2652231f26f2a40d4b1d719fee236b966c061283,2020-03-10T20:00:00Z,,,15,15,15,32,0,0,0,0,0
20200310,NY,173,92,,,,,,,,,193f85893cecb99d063a03060bc4802d2d6458f1,2020-03-10T20:00:00Z,,,265,265,265,36,0,0,0,31,31
20200310,OH,3,14,15,,,,,,,,c226bdb43a781003d1620baf6ee7b55ad00c8b50,2020-03-10T20:00:00Z,,,32,17,17,39,0,0,3,0,3
20200310,OK,2,15,11,,,,,,,,fe6cb3ee7ed6b8df044b4274f1235f2c35195542,2020-03-10T20:00:00Z,,,28,17,17,40,0,0,7,1,8
20200310,OR,15,213,67,,,,,,,,b124f2b2f232984d5c0185a54ad7f85bb988a90a,2020-03-10T20:00:00Z,,,295,228,228,41,0,0,48,1,49
20200310,PA,12,,,,,,,,,,7dd8e8b438f07cd82021188efd5b91468b8ce15e,2020-03-10T20:00:00Z,,,12,12,12,42,0,0,0,2,2
20200310,RI,3,58,6,,,,,,,,36e67adb05ce8d558f0aefe09b0c328e5a79e54f,2020-03-10T20:00:00Z,,,67,61,61,44,0,0,28,0,28
20200310,SC,7,24,,,,,,,,,dd5f3a1e885292f8e8c6d3160128a1c49b84da8c,2020-03-10T20:00:00Z,,,31,31,31,45,0,0,0,0,0
20200310,SD,0,11,0,,,,,,,,f2608368ec96bfd0baf5e23ac0640cb2cb6fba1c,2020-03-10T20:00:00Z,,,11,11,11,46,0,0,6,0,6
20200310,TN,7,,,,,,,,,,51d7454f0a63341e7d33e9bc17ec4203c1d7b5eb,2020-03-10T20:00:00Z,,,7,7,7,47,0,0,0,4,4
20200310,TX,13,,,,,,,,,,eea92c2654f734808ae61461bd187a8ae737ede5,2020-03-10T20:00:00Z,,,13,13,13,48,0,0,0,1,1
20200310,UT,2,,,,,,,,,,466b66d0cbac6da0ff5069cee893a6e5774b3809,2020-03-10T20:00:00Z,,,2,2,2,49,0,0,0,1,1
20200310,VA,8,53,,,,,,,,,50c5f90ad518306f2aa6cfa2d4aa8f9c6b89f6eb,2020-03-10T20:00:00Z,,,61,61,61,51,0,0,15,5,20
20200310,VT,1,40,,,,,,,,,1ef4d4eeca815cb3358eed86bfdd2b22a7faacc9,2020-03-10T20:00:00Z,,,41,41,41,50,0,0,6,0,6
20200310,WA,397,4850,,,,,,,,,f2b3134f98482fb308c3d51c12af375ec0a341d6,2020-03-10T20:00:00Z,37,,5247,5247,5247,53,2,0,1677,48,1725
20200310,WI,2,36,,,,,,,,,6547fab519037da58609fee7229c4673423a5614,2020-03-10T20:00:00Z,,,38,38,38,55,0,0,0,1,1
20200310,WV,0,2,3,,,,,,,,a0f64043e0dbb8a0390316af34e6ae60a7913160,2020-03-10T20:00:00Z,,,5,2,2,54,0,0,0,0,0
20200310,WY,0,0,0,,,,,,,,7386ca913797703a8f0738ff599605f36db6d06b,2020-03-10T20:00:00Z,,,0,0,0,56,0,0,0,0,0
20200309,AK,0,23,9,,,,,,,,cb85c1929806141b01e896a52de54771863ed0e4,2020-03-09T20:00:00Z,0,,32,23,23,02,0,0,9,0,9
20200309,AL,0,,,,,,,,,,3c15dbef6838aa05f46554b8f49c5d96677df531,2020-03-09T20:00:00Z,,,0,0,0,01,0,0,0,0,0
20200309,AR,0,12,0,,,,,,,,5ef70cfa2d033bc17949f85ed40a9a63e9ea95df,2020-03-09T20:00:00Z,,,12,12,12,05,0,0,6,0,6
20200309,AZ,5,44,7,,,,,,,,34a29bfcfa1a71c92fe460039d78f6bb8bf65e60,2020-03-09T20:00:00Z,,,56,49,49,04,0,0,0,0,0
20200309,CA,114,690,,,,,,,,,6af63e3581f76d44b6446c5c221d5a2dd96f5a24,2020-03-09T20:00:00Z,,,804,804,804,06,0,0,228,26,254
20200309,CO,9,133,,,,,,,,,b23d501869c0a98edd0eedb4d3393fa413a2532b,2020-03-09T20:00:00Z,,,142,142,142,08,0,0,29,1,30
20200309,CT,1,46,,,,,,,,,77af98908db8db59c3733c28b2b979a5dfbd11d7,2020-03-09T20:00:00Z,,,47,47,47,09,0,0,17,0,17
20200309,DC,1,14,3,,,,,,,,01c063fd1289fc23b3b7be3d4aea3307b50f5040,2020-03-09T20:00:00Z,,,18,15,15,11,0,0,4,0,4
20200309,DE,0,15,3,,,,,,,,966cd7a363b1718847965e750f4e76527e4f3d3f,2020-03-09T20:00:00Z,,,18,15,15,10,0,0,5,0,5
20200309,FL,18,140,115,,,,,,,,318b0f35925b3b172b90b2faa9823d23882636b6,2020-03-09T20:00:00Z,,,273,158,158,12,0,0,22,1,23
20200309,GA,12,,,,,,,,,,279f6e8110f21f2cb9b2d1ff1e6841afa1c0af40,2020-03-09T20:00:00Z,,,12,12,12,13,0,0,0,5,5
20200309,HI,2,,,,,,,,,,e8c71d4ebcb3a9aed28d52d363088faa8aa067e2,2020-03-09T20:00:00Z,,,2,2,2,15,0,0,0,1,1
20200309,IA,3,26,8,,,,,,,,2d4f00730c4f5721f4da3d4ba82eebff77c5e4e2,2020-03-09T20:00:00Z,,,37,29,29,19,0,0,11,3,14
20200309,ID,0,41,,,,,,,,,cebad76e979c6b393b559632dcfef8e1cb9ccd0c,2020-03-09T20:00:00Z,,,41,41,41,16,0,0,14,0,14
20200309,IL,7,191,44,,,,,,,,3fe26606e274da04428ec1f3e932c98cf64e5b49,2020-03-09T20:00:00Z,,,242,198,198,17,0,0,0,1,1
20200309,IN,2,,,,,,,,,,d82e74b7662ac9fc6dcad52693089393fd73c192,2020-03-09T20:00:00Z,,,2,2,2,18,0,0,0,0,0
20200309,KS,1,11,0,,,,,,,,ce8f496b64774484ba055b88fe463cfea2c4ecaf,2020-03-09T20:00:00Z,,,12,12,12,20,0,0,0,0,0
20200309,KY,4,17,,,,,,,,,ea273e790c71c42e501ffeb854c765c4ed3d91e0,2020-03-09T20:00:00Z,,,21,21,21,21,0,0,4,3,7
20200309,LA,1,5,,,,,,,,,34ed705a6d35331063fd0d6d7867baca1fefe36c,2020-03-09T20:00:00Z,,,6,6,6,22,0,0,0,1,1
20200309,MD,5,73,,,,,,,,,21d797080b2facbf18276350a712ba702c1db616,2020-03-09T20:00:00Z,,,78,78,78,24,0,0,21,2,23
20200309,ME,0,1,,,,,,,,,fc7ef15fa0bc2846fd0a361a454006c43ff5a50c,2020-03-09T20:00:00Z,,,1,1,1,23,0,0,0,0,0
20200309,MI,254,36,11,,,,,,,,12439b1570bf0a2f43b1aa54c5664fc47bc56172,2020-03-09T20:00:00Z,,,301,290,290,26,0,0,10,86,96
20200309,MN,2,80,,,,,,,,,2fe8a8c39e6d7656c053b0ddc487d11d014d7968,2020-03-09T20:00:00Z,,,82,82,82,27,0,0,32,1,33
20200309,MO,1,,,,,,,,,,2ae8fc33a8f32d0393f6509589e5aa2db017a1a7,2020-03-09T20:00:00Z,,,1,1,1,29,0,0,0,0,0
20200309,MS,0,,,,,,,,,,2b1e959c40e1d97cbd4fdb3af6d146176cb72a7a,2020-03-09T20:00:00Z,,,0,0,0,28,0,0,0,0,0
20200309,MT,0,11,,,,,,,,,f94a2e3b32545cbd6e401cfc4e8094305bd8e6ac,2020-03-09T20:00:00Z,,,11,11,11,30,0,0,0,0,0
20200309,NC,2,,,,,,,,,,36a7efc53186e6278555d0eb1f7f7780868cfc03,2020-03-09T20:00:00Z,,,2,2,2,37,0,0,0,0,0
20200309,ND,0,0,,,,,,,,,59a9fe03c914e9211dd5546b982a478f5b7e46d8,2020-03-09T20:00:00Z,,,0,0,0,38,0,0,0,0,0
20200309,NE,3,36,9,,,,,,,,aacea49d265183a389da9f54170298fc8d6a486e,2020-03-09T20:00:00Z,,,48,39,39,31,0,0,19,2,21
20200309,NH,4,38,5,,,,,,,,95d9f3370e5979350a25379b65c7f98b077c7213,2020-03-09T20:00:00Z,,,47,42,42,33,0,0,0,0,0
20200309,NJ,11,35,14,,,,,,,,e0df6d08dc91c5afd18e9f35f22aa322b4b0f0ce,2020-03-09T20:00:00Z,,,60,46,46,34,0,0,4,5,9
20200309,NM,0,57,0,,,,,,,,a766e1775bcbafa6817f7b2f15a9292652caba5c,2020-03-09T20:00:00Z,,,57,57,57,35,0,0,9,0,9
20200309,NV,1,14,,,,,,,,,83d025cf17543e497cd5063608e45dc9cfa44fb8,2020-03-09T20:00:00Z,,,15,15,15,32,0,0,0,0,0
20200309,NY,142,92,,,,,,,,,260a070d28ed40a35e8b31aca5f4ab3352dc9ba8,2020-03-09T20:00:00Z,,,234,234,234,36,0,0,0,37,37
20200309,OH,3,11,5,,,,,,,,40edb3ac44427394a2fb18a1b4cd4064b7e67672,2020-03-09T20:00:00Z,,,19,14,14,39,0,0,1,3,4
20200309,OK,1,8,10,,,,,,,,8b689e9e2ad67a6b028c2431bedd2cec040154e0,2020-03-09T20:00:00Z,,,19,9,9,40,0,0,0,0,0
20200309,OR,14,165,52,,,,,,,,f5a1974166b2872d9568b45083f043611e5c5652,2020-03-09T20:00:00Z,,,231,179,179,41,0,0,65,0,65
20200309,PA,10,,,,,,,,,,4554632818538c57d0520a7bfb83132dd6c055d9,2020-03-09T20:00:00Z,,,10,10,10,42,0,0,0,4,4
20200309,RI,3,30,6,,,,,,,,c95620757ddb4993da77d7d25126c990fa386efe,2020-03-09T20:00:00Z,,,39,33,33,44,0,0,0,0,0
20200309,SC,7,24,,,,,,,,,230947ecf1cd935a64d923210a6ffb285ea513bd,2020-03-09T20:00:00Z,,,31,31,31,45,0,0,16,5,21
20200309,SD,0,5,0,,,,,,,,207d9a28c6c82c49caa4472678725e844f8a1836,2020-03-09T20:00:00Z,,,5,5,5,46,0,0,0,0,0
20200309,TN,3,,,,,,,,,,2ca1b9768f605daaa7c62ae41b8b6f94c63d1a80,2020-03-09T20:00:00Z,,,3,3,3,47,0,0,0,0,0
20200309,TX,12,,,,,,,,,,c3bedfa0a6b278f333e5bdb9fde59e674715bfb1,2020-03-09T20:00:00Z,,,12,12,12,48,0,0,0,4,4
20200309,UT,1,,,,,,,,,,fa208666968a4489a5cde79e40c08bdddece1361,2020-03-09T20:00:00Z,,,1,1,1,49,0,0,0,0,0
20200309,VA,3,38,9,,,,,,,,de39b29dd1a1a173788fc7a0f22b44ccb7899f1c,2020-03-09T20:00:00Z,,,50,41,41,51,0,0,2,1,3
20200309,VT,1,34,,,,,,,,,26c656cc1971e9a2bde7f9614ffe7ef51900c432,2020-03-09T20:00:00Z,,,35,35,35,50,0,0,6,0,6
20200309,WA,349,3173,,,,,,,,,39635afec50e4510efba5fb3f7aa35bc2eb2a8e0,2020-03-09T20:00:00Z,35,,3522,3522,3522,53,4,0,965,100,1065
20200309,WI,1,36,,,,,,,,,e29cff75f4e2deeb5547eee65bcb33cdc75c2fd8,2020-03-09T20:00:00Z,,,37,37,37,55,0,0,5,0,5
20200309,WV,0,2,3,,,,,,,,8e4b9a84bdbba65581c2287854f03105e8e97149,2020-03-09T20:00:00Z,,,5,2,2,54,0,0,0,0,0
20200309,WY,0,,,,,,,,,,c052da9af9257ed5150197a38c4d1cf9cb5992b0,2020-03-09T20:00:00Z,,,0,0,0,56,0,0,0,0,0
20200308,AK,0,14,6,,,,,,,,c4287ed1763571e32d9c109b0e8d38d1c66dfb98,2020-03-08T20:00:00Z,0,,20,14,14,02,0,0,2,0,2
20200308,AL,0,,,,,,,,,,dc8486565b986e301a3cb52dda7d6014007253e4,2020-03-08T20:00:00Z,,,0,0,0,01,0,0,0,0,0
20200308,AR,0,6,0,,,,,,,,6263c0cd4836c8418421de9e16b86212a90ea53f,2020-03-08T20:00:00Z,,,6,6,6,05,0,0,0,0,0
20200308,AZ,5,44,7,,,,,,,,7fab3faf304af2d21cf805b897dbe16c6cf1a5c6,2020-03-08T20:00:00Z,,,56,49,49,04,0,0,0,0,0
20200308,CA,88,462,,,,,,,,,39ba303e6c33d759f657dfaa835f2714a49ecc37,2020-03-08T20:00:00Z,,,550,550,550,06,0,0,0,19,19
20200308,CO,8,104,,,,,,,,,999728a960c0e35c7bfce426d19eef24c7fd3e64,2020-03-08T20:00:00Z,,,112,112,112,08,0,0,49,0,49
20200308,CT,1,29,8,,,,,,,,9af238ecf88478ebbe90c92437c721d9fd8e6d17,2020-03-08T20:00:00Z,,,38,30,30,09,0,0,29,1,30
20200308,DC,1,10,0,,,,,,,,49cc05969337862100d6dac922ca02efcccd9c37,2020-03-08T20:00:00Z,,,11,11,11,11,0,0,2,1,3
20200308,DE,0,10,0,,,,,,,,55e0c22b683f94999c6a852f5432d86ffe73ebae,2020-03-08T20:00:00Z,,,10,10,10,10,0,0,0,0,0
20200308,FL,17,118,108,,,,,,,,58118fa0e29d8d1a2b018270736aa4e15f658ed0,2020-03-08T20:00:00Z,,,243,135,135,12,0,0,18,3,21
20200308,GA,7,,,,,,,,,,e234f04216762da88bc69c82ae358ca0e126a20e,2020-03-08T20:00:00Z,,,7,7,7,13,0,0,0,1,1
20200308,HI,1,,,,,,,,,,94350220775a3b6e5fda814910579f1b46265ab8,2020-03-08T20:00:00Z,,,1,1,1,15,0,0,0,0,0
20200308,IA,0,15,2,,,,,,,,ed9e73a744bebf0b1f7f5bda0383d3fe3134e20c,2020-03-08T20:00:00Z,,,17,15,15,19,0,0,0,0,0
20200308,ID,0,27,,,,,,,,,9445d66db16882680e8502f339ebcea0f5762ccd,2020-03-08T20:00:00Z,,,27,27,27,16,0,0,0,0,0
20200308,IL,6,191,44,,,,,,,,6c7bf5170846973ebb63a9ac680596f733cf5a5d,2020-03-08T20:00:00Z,,,241,197,197,17,0,0,0,0,0
20200308,IN,2,,,,,,,,,,ba3578ffa6ce7f594b1afdeb97b4e26c421cf59f,2020-03-08T20:00:00Z,,,2,2,2,18,0,0,0,1,1
20200308,KS,1,11,0,,,,,,,,d7a2adf7af3c56e40d1a75f02da8878c2e934ccd,2020-03-08T20:00:00Z,,,12,12,12,20,0,0,0,1,1
20200308,KY,1,13,,,,,,,,,1930ced9af77c060162cc04abf6f9d53d28c39ac,2020-03-08T20:00:00Z,,,14,14,14,21,0,0,4,0,4
20200308,LA,0,5,,,,,,,,,f0cd89bf8cfc3f22372a64bbf45ae165e5845bb1,2020-03-08T20:00:00Z,,,5,5,5,22,0,0,5,0,5
20200308,MD,3,52,,,,,,,,,cbac8d376b30d5d5e04172efbb77aa9f9d49942b,2020-03-08T20:00:00Z,,,55,55,55,24,0,0,11,0,11
20200308,ME,0,1,,,,,,,,,a44c270bd2fd674f7bf3ffcf3b9042baa0c7d8b2,2020-03-08T20:00:00Z,,,1,1,1,23,0,0,0,0,0
20200308,MI,168,26,10,,,,,,,,8955bea8f7edc16d43081e5b969c48c3f1e3050e,2020-03-08T20:00:00Z,,,204,194,194,26,0,0,8,40,48
20200308,MN,1,48,,,,,,,,,3bb2cdf04d3b3fa3eaea091fd099d444818650e2,2020-03-08T20:00:00Z,,,49,49,49,27,0,0,0,0,0
20200308,MO,1,,,,,,,,,,61c8364771bfe55687a47ce4650d8614e697d7ca,2020-03-08T20:00:00Z,,,1,1,1,29,0,0,0,1,1
20200308,MS,0,,,,,,,,,,2d0d4688d015247af02eab6b55ae72e221d8ac7c,2020-03-08T20:00:00Z,,,0,0,0,28,0,0,0,0,0
20200308,MT,0,11,,,,,,,,,cdb6980828a9f676bf55fdd84394dfd3d2619c80,2020-03-08T20:00:00Z,,,11,11,11,30,0,0,0,0,0
20200308,NC,2,,,,,,,,,,550aef8aafb9d182e2c2db40483a3c4030f9fa27,2020-03-08T20:00:00Z,,,2,2,2,37,0,0,0,0,0
20200308,ND,0,0,,,,,,,,,e1b82af26658ba59e5450a632559324dab21d186,2020-03-08T20:00:00Z,,,0,0,0,38,0,0,0,0,0
20200308,NE,1,17,5,,,,,,,,0a814283723e80c081ea9aced87caae627354a77,2020-03-08T20:00:00Z,,,23,18,18,31,0,0,0,0,0
20200308,NH,4,38,5,,,,,,,,ecfe42d37126f9471a8c8176b24545e96c32c1d5,2020-03-08T20:00:00Z,,,47,42,42,33,0,0,18,2,20
20200308,NJ,6,31,0,,,,,,,,1e8aab109a7c26892276d26946a56c0163edcd84,2020-03-08T20:00:00Z,,,37,37,37,34,0,0,31,2,33
20200308,NM,0,48,0,,,,,,,,3ae3b323e6fccff2c838538447fffa389d9e5f4a,2020-03-08T20:00:00Z,,,48,48,48,35,0,0,0,0,0
20200308,NV,1,14,,,,,,,,,def0cb8fc381af9358ec1023f361e556ab9f9ded,2020-03-08T20:00:00Z,,,15,15,15,32,0,0,0,0,0
20200308,NY,105,92,,,,,,,,,f6d3b78f41cadeaf08e72f35692a9619d70aad07,2020-03-08T20:00:00Z,,,197,197,197,36,0,0,0,29,29
20200308,OH,0,10,4,,,,,,,,7e8d292bba63ea4513c06f2051dea6861b470916,2020-03-08T20:00:00Z,,,14,10,10,39,0,0,1,0,1
20200308,OK,1,8,2,,,,,,,,b6018ab69b18e7cd1a1cdabcf009e65d0f07e5ee,2020-03-08T20:00:00Z,,,11,9,9,40,0,0,8,0,8
20200308,OR,14,100,53,,,,,,,,882f37383b337cc29b83d8317156e4a4311f6627,2020-03-08T20:00:00Z,,,167,114,114,41,0,0,23,7,30
20200308,PA,6,,,,,,,,,,f2288aed4a67fb77f86fc35e3988a70e0db037ac,2020-03-08T20:00:00Z,,,6,6,6,42,0,0,0,2,2
20200308,RI,3,30,12,,,,,,,,1f2994a89f2153e8cbf70397cf042a16351be821,2020-03-08T20:00:00Z,,,45,33,33,44,0,0,0,1,1
20200308,SC,2,8,,,,,,,,,db7aefd437c9ae1600b9c0b62d4f9344d3a99dc7,2020-03-08T20:00:00Z,,,10,10,10,45,0,0,0,0,0
20200308,SD,0,5,0,,,,,,,,a54f67d9f8d3c7647c20085e8d59e40c6290250b,2020-03-08T20:00:00Z,,,5,5,5,46,0,0,0,0,0
20200308,TN,3,,,,,,,,,,55ca27b24b97bbb5f61d3c7d3db93ad7f41f6240,2020-03-08T20:00:00Z,,,3,3,3,47,0,0,0,2,2
20200308,TX,8,,,,,,,,,,be48d5d3143d163568736568b389b7bcae8fe816,2020-03-08T20:00:00Z,,,8,8,8,48,0,0,0,0,0
20200308,UT,1,,,,,,,,,,3687612a6d76e15f8a889cdb629d2dda034d897b,2020-03-08T20:00:00Z,,,1,1,1,49,0,0,0,0,0
20200308,VA,2,36,6,,,,,,,,3e12d0328ad20d41eb4f57a4fd4143d65e263a97,2020-03-08T20:00:00Z,,,44,38,38,51,0,0,5,2,7
20200308,VT,1,28,,,,,,,,,2393fda9fc64b4825ff4d3456139404c6fdeffaa,2020-03-08T20:00:00Z,,,29,29,29,50,0,0,12,1,13
20200308,WA,249,2208,60,,,,,,,,254fc4532258acac8e264065306ae79de7606faf,2020-03-08T20:00:00Z,31,,2517,2457,2457,53,4,0,462,67,529
20200308,WI,1,31,12,,,,,,,,b834c9b5c7a55a60692aace16160db4e77576973,2020-03-08T20:00:00Z,,,44,32,32,55,0,0,0,0,0
20200308,WV,0,2,3,,,,,,,,4baf5efaa3462e45c3a086d03ba4bf9376b10202,2020-03-08T20:00:00Z,,,5,2,2,54,0,0,0,0,0
20200308,WY,0,,,,,,,,,,04b812c8dbb7bd7a7c1c24bb7e3b1116fb1cfa96,2020-03-08T20:00:00Z,,,0,0,0,56,0,0,0,0,0
20200307,AK,0,12,2,,,,,,,,909b7d55ced8b1311528d716923608f030dc8226,2020-03-07T21:00:00Z,0,,14,12,12,02,0,0,4,0,4
20200307,AL,0,,,,,,,,,,1d94a3b00af81e57b35a00c0eeaa339ec76d962a,2020-03-07T21:00:00Z,,,0,0,0,01,,,,,
20200307,AR,0,6,0,,,,,,,,bdba8d05662d7b38e7309c5baa49cd20b63a536b,2020-03-07T21:00:00Z,,,6,6,6,05,0,0,0,0,0
20200307,AZ,5,44,7,,,,,,,,0c334b56af3108711bb907f46599a84bd536ac1d,2020-03-07T21:00:00Z,,,56,49,49,04,0,0,11,2,13
20200307,CA,69,462,,,,,,,,,311a213f5744c6b33147c107519218e8d9f55d23,2020-03-07T21:00:00Z,,,531,531,531,06,0,0,0,9,9
20200307,CO,8,55,69,,,,,,,,b3e767a79aa144a708ff8d26dd77311725722068,2020-03-07T21:00:00Z,,,132,63,63,08,0,0,9,6,15
20200307,CT,0,,,,,,,,,,d9e680a00789072a49cb76e097d4229667366ed7,2020-03-07T21:00:00Z,,,0,0,0,09,,,,,
20200307,DC,0,8,1,,,,,,,,e11c537902c2e50281d5f0474f9627885a7d2687,2020-03-07T21:00:00Z,,,9,8,8,11,0,0,0,0,0
20200307,DE,0,10,0,,,,,,,,7eadaaa0b57573c2bdbc9a8e6cb4491819bdebe3,2020-03-07T21:00:00Z,,,10,10,10,10,0,0,0,0,0
20200307,FL,14,100,88,,,,,,,,8e5302ac32c92ff9ad0d33eac5dbb7fadb2633fc,2020-03-07T21:00:00Z,,,202,114,114,12,0,0,45,5,50
20200307,GA,6,,,,,,,,,,300c65424c0683e4fe3b738ffa83c73e6e166987,2020-03-07T21:00:00Z,,,6,6,6,13,0,0,0,4,4
20200307,HI,1,,,,,,,,,,fdf9b14d1375f62ec31807e17621275a28a68e35,2020-03-07T21:00:00Z,,,1,1,1,15,,,,,
20200307,IA,0,15,2,,,,,,,,57014c410bdcf67c766c3bde093c62bf971bf561,2020-03-07T21:00:00Z,,,17,15,15,19,0,0,0,0,0
20200307,ID,0,27,,,,,,,,,4f4e0071fd17623d671266cb5b4d8f4a998e7635,2020-03-07T21:00:00Z,,,27,27,27,16,,,,,
20200307,IL,6,191,44,,,,,,,,0617c3d41d4b13ac629144876a75a2d391036742,2020-03-07T21:00:00Z,,,241,197,197,17,0,0,11,1,12
20200307,IN,1,,,,,,,,,,341ab30a48c34775d1b7fb9b4a82dea3d4bdff65,2020-03-07T21:00:00Z,,,1,1,1,18,0,0,0,0,0
20200307,KS,0,11,2,,,,,,,,3423d332e782b75c00baf7159c3aa95ea8927439,2020-03-07T21:00:00Z,,,13,11,11,20,0,0,7,0,7
20200307,KY,1,9,,,,,,,,,48c3d48fed83cfd2f32e9dbf06e7e1410d3e0fe6,2020-03-07T21:00:00Z,,,10,10,10,21,0,0,2,1,3
20200307,LA,0,,,,,,,,,,b7526761c843e52a6bd2a5e89719a7ed71cc0b5e,2020-03-07T21:00:00Z,,,0,0,0,22,,,,,
20200307,MD,3,41,,,,,,,,,b2d7275372012956019c1ac4675a486072ad50c0,2020-03-07T21:00:00Z,,,44,44,44,24,0,0,15,0,15
20200307,ME,0,1,,,,,,,,,78aa7cd66f9ed0076403ca7ace6b9725577d669a,2020-03-07T21:00:00Z,,,1,1,1,23,,,,,
20200307,MI,128,18,9,,,,,,,,03a5d353203118cadc5b2e6c3848c40f506ac849,2020-03-07T21:00:00Z,,,155,146,146,26,0,0,10,30,40
20200307,MN,1,48,,,,,,,,,dff67d839a61d912b7f7b0aa8a8eee5450a0add1,2020-03-07T21:00:00Z,,,49,49,49,27,0,0,12,1,13
20200307,MO,0,,,,,,,,,,9a6811180ce7cb71ab44738976d76cc4d0c0367c,2020-03-07T21:00:00Z,,,0,0,0,29,,,,,
20200307,MS,0,,,,,,,,,,8fd30f9053208bfd268115213ef81816a8d68513,2020-03-07T21:00:00Z,,,0,0,0,28,,,,,
20200307,MT,0,11,,,,,,,,,c798a10143524f3b801c3c12385d46f0d5445c45,2020-03-07T21:00:00Z,,,11,11,11,30,,,,,
20200307,NC,2,,,,,,,,,,430c5790ef495a5f85b57fec34083672077f2925,2020-03-07T21:00:00Z,,,2,2,2,37,0,0,0,0,0
20200307,ND,0,0,,,,,,,,,fd7ee9e623951efec04cf75ce2f3bcadec68ab35,2020-03-07T21:00:00Z,,,0,0,0,38,,,,,
20200307,NE,1,17,5,,,,,,,,f005dd04ec69b52d21ffd219b42d10b897d2ddf8,2020-03-07T21:00:00Z,,,23,18,18,31,0,0,0,1,1
20200307,NH,2,20,3,,,,,,,,c3cf83675171ed0cb3ea76ec42d8087ed0549f2a,2020-03-07T21:00:00Z,,,25,22,22,33,0,0,0,0,0
20200307,NJ,4,,1,,,,,,,,baa3a70b588e2de1d71ef9323e1fd51c2ddd7bf2,2020-03-07T21:00:00Z,,,5,4,4,34,0,0,0,3,3
20200307,NM,0,48,0,,,,,,,,d4fe05fba86ad47f27ecc0a2843641fc598e7ee2,2020-03-07T21:00:00Z,,,48,48,48,35,0,0,32,0,32
20200307,NV,1,14,,,,,,,,,ff7e53fb3780e09b6df2422f8b4c69da6e7984d0,2020-03-07T21:00:00Z,,,15,15,15,32,0,0,0,0,0
20200307,NY,76,92,236,,,,,,,,53a82f90b4d4a28a5b06248b1e4c78e9229312dd,2020-03-07T21:00:00Z,,,404,168,168,36,0,0,0,43,43
20200307,OH,0,9,5,,,,,,,,c69dfa83b8288b3843884ff6e720c8496b379d9f,2020-03-07T21:00:00Z,,,14,9,9,39,0,0,1,0,1
20200307,OK,1,,,,,,,,,,a289923d68e5122aaffefddb8b334840537c641f,2020-03-07T21:00:00Z,,,1,1,1,40,,,,,
20200307,OR,7,77,40,,,,,,,,46f67721ac9c9e4bf2223020998c4d83fcc7f249,2020-03-07T21:00:00Z,,,124,84,84,41,0,0,13,4,17
20200307,PA,4,,,,,,,,,,062165de38bf4ef54e8456000bb3d8a0ed14a6a4,2020-03-07T21:00:00Z,,,4,4,4,42,0,0,0,2,2
20200307,RI,2,30,,,,,,,,,9235e76ca0650027d60ea79ed06e02846b6fcdb8,2020-03-07T21:00:00Z,,,32,32,32,44,0,0,13,-1,12
20200307,SC,2,8,,,,,,,,,8544336c14b8c734fc20a32a015006d676c30244,2020-03-07T21:00:00Z,,,10,10,10,45,0,0,3,2,5
20200307,SD,0,5,0,,,,,,,,f9c85d0328866ae577e24ba09e3c4be8f679563c,2020-03-07T21:00:00Z,,,5,5,5,46,,,,,
20200307,TN,1,,,,,,,,,,1052cb0a616ff027ac81ae4e021811dfcde09418,2020-03-07T21:00:00Z,,,1,1,1,47,0,0,0,0,0
20200307,TX,8,,,,,,,,,,9442e419a19fb5a72a0c4f5541eb6988e51a4011,2020-03-07T21:00:00Z,,,8,8,8,48,0,0,0,3,3
20200307,UT,1,,,,,,,,,,a85957691ce29b13c25a9fa29751a40218bf593d,2020-03-07T21:00:00Z,,,1,1,1,49,,,,,
20200307,VA,0,31,7,,,,,,,,6e84c7d2e592ebc2a18731e74f79dbd87b2a9867,2020-03-07T21:00:00Z,,,38,31,31,51,0,0,10,0,10
20200307,VT,0,16,,,,,,,,,ff9af8b98a1d797de0df45f07ebcd9cd6f10d588,2020-03-07T21:00:00Z,,,16,16,16,50,0,0,8,0,8
20200307,WA,182,1746,66,,,,,,,,1b58b3a06a9c63e74a1d10dd96832589342c867c,2020-03-07T21:00:00Z,27,,1994,1928,1928,53,1,0,368,32,400
20200307,WI,1,31,12,,,,,,,,6ed08976196b8624bb1e5ae7c5fa420f672cd583,2020-03-07T21:00:00Z,,,44,32,32,55,0,0,0,0,0
20200307,WV,0,2,3,,,,,,,,709d5b8a2116344cd59199a1b319fae5f11d6bca,2020-03-07T21:00:00Z,,,5,2,2,54,0,0,1,0,1
20200307,WY,0,,,,,,,,,,265de6c0d476b4e78ad567a501a52ea9d1846184,2020-03-07T21:00:00Z,,,0,0,0,56,,,,,
20200306,AK,0,8,1,,,,,,,,afd8084305ea1ec41b5746d77dfc27eed92e555f,2020-03-06T21:00:00Z,0,,9,8,8,02,,,,,
20200306,AR,0,6,0,,,,,,,,baadb217d3fcf5f4811488adcd8f345a2a29e391,2020-03-06T21:00:00Z,,,6,6,6,05,,,,,
20200306,AZ,3,33,15,,,,,,,,bcfcf56b97c3f10a640d25f6148abbc1f17fa07d,2020-03-06T21:00:00Z,,,51,36,36,04,0,0,5,1,6
20200306,CA,60,462,,,,,,,,,ed5984edee3bf6ee9bc3b89bc15e52f3bdade592,2020-03-06T21:00:00Z,,,522,522,522,06,0,0,0,7,7
20200306,CO,2,46,30,,,,,,,,2affe95a8de9524f8e77344a5a354729331024fa,2020-03-06T21:00:00Z,,,78,48,48,08,0,0,27,2,29
20200306,DC,0,8,1,,,,,,,,0916c062b23fb7dafb1a661e9e93554b146102bc,2020-03-06T21:00:00Z,,,9,8,8,11,0,0,2,0,2
20200306,DE,0,10,0,,,,,,,,ce64a0188bd545e3f624bf5c958ad5a308f7c042,2020-03-06T21:00:00Z,,,10,10,10,10,,,,,
20200306,FL,9,55,51,,,,,,,,ec1d19fd312871b78238dee947a1614eb253b818,2020-03-06T21:00:00Z,,,115,64,64,12,0,0,24,0,24
20200306,GA,2,,,,,,,,,,d6ae73ad152b1a4b8de98e45e77180669400ec85,2020-03-06T21:00:00Z,,,2,2,2,13,0,0,0,0,0
20200306,IA,0,15,2,,,,,,,,73ace108c09e0e8391d16fb4cc771e1dd2107a8a,2020-03-06T21:00:00Z,,,17,15,15,19,,,,,
20200306,IL,5,180,35,,,,,,,,cea4d67d62c223cc0e6e983c16ec4eb1e7e287e7,2020-03-06T21:00:00Z,,,220,185,185,17,0,0,15,0,15
20200306,IN,1,,,,,,,,,,57d3744352ffb9db87fd1bf34f0a80df811443d2,2020-03-06T21:00:00Z,,,1,1,1,18,,,,,
20200306,KS,0,4,0,,,,,,,,69d9379255fba9dc0e12dc3d34568cf662050519,2020-03-06T21:00:00Z,,,4,4,4,20,,,,,
20200306,KY,0,7,3,,,,,,,,d14490bb62ff36a14f6d7d3983dcc37a6213f306,2020-03-06T21:00:00Z,,,10,7,7,21,,,,,
20200306,MD,3,26,12,,,,,,,,1fa11fd8e4ccf23cd88dad0abf8f2ed09692b6f7,2020-03-06T21:00:00Z,,,41,29,29,24,0,0,9,3,12
20200306,MI,98,8,8,,,,,,,,ec49ca56f5a15fa1d7ab227db8ee518383b80bd1,2020-03-06T21:00:00Z,,,114,106,106,26,0,0,0,26,26
20200306,MN,0,36,,,,,,,,,e5132c799bd8a985ee5eebaa58cc91fe172d2252,2020-03-06T21:00:00Z,,,36,36,36,27,,,,,
20200306,NC,2,,,,,,,,,,7dc32933c444ad3ead82aae5b70360d952aa26f5,2020-03-06T21:00:00Z,,,2,2,2,37,0,0,0,1,1
20200306,NE,0,17,5,,,,,,,,f6a3dae478e443059d53552df4bcdfcbf1df1562,2020-03-06T21:00:00Z,,,22,17,17,31,0,0,0,0,0
20200306,NH,2,20,3,,,,,,,,cb6d3e65ea48c1b73ea053bd4fff5effe820cd79,2020-03-06T21:00:00Z,,,25,22,22,33,0,0,4,0,4
20200306,NJ,1,,,,,,,,,,c1ebdfb1febe7a106dd31b8742d983a21185c3bf,2020-03-06T21:00:00Z,,,1,1,1,34,0,0,0,0,0
20200306,NM,0,16,0,,,,,,,,a7fdde839cc24edda883ae6eded317516823f0d3,2020-03-06T21:00:00Z,,,16,16,16,35,,,,,
20200306,NV,1,14,,,,,,,,,987c6d506024afbec19c37ec86dbb2f36578a842,2020-03-06T21:00:00Z,,,15,15,15,32,0,0,0,0,0
20200306,NY,33,92,236,,,,,,,,18e7306085561597629e7ffac110572b1aa9f9e5,2020-03-06T21:00:00Z,,,361,125,125,36,0,0,16,11,27
20200306,OH,0,8,2,,,,,,,,053530986545d47250674a6c7891318414ac402d,2020-03-06T21:00:00Z,,,10,8,8,39,0,0,1,0,1
20200306,OR,3,64,28,,,,,,,,8c2cf703264be22af405b67f312c031ee48a2c49,2020-03-06T21:00:00Z,,,95,67,67,41,0,0,19,0,19
20200306,PA,2,,,,,,,,,,3ce04ca60daa0171a4965e6870cd5710345e8669,2020-03-06T21:00:00Z,,,2,2,2,42,,,,,
20200306,RI,3,17,,,,,,,,,132069fe25a4d56033778fb0b12c743931e65638,2020-03-06T21:00:00Z,,,20,20,20,44,0,0,0,1,1
20200306,SC,0,5,,,,,,,,,3b871b1d4242a1fb3eb15e01fdb317126da865b0,2020-03-06T21:00:00Z,,,5,5,5,45,0,0,0,0,0
20200306,TN,1,,,,,,,,,,c08f2fdfc2a48fde032229c9b4181788db59f9f3,2020-03-06T21:00:00Z,,,1,1,1,47,0,0,0,0,0
20200306,TX,5,,,,,,,,,,cd363e289639a9dfe6b4575b0f64f46900a7901b,2020-03-06T21:00:00Z,,,5,5,5,48,0,0,0,4,4
20200306,VA,0,21,10,,,,,,,,d226abb632c34f9036421499b7f6c7bc248bb483,2020-03-06T21:00:00Z,,,31,21,21,51,0,0,3,0,3
20200306,VT,0,8,,,,,,,,,a4dec17604c465729da7a9dfe9e9ec4426c32672,2020-03-06T21:00:00Z,,,8,8,8,50,,,,,
20200306,WA,150,1378,,,,,,,,,e6fe8da1e3e54775eddbe49e87aa0bdd448ac68a,2020-03-06T21:00:00Z,26,,1528,1528,1528,53,6,0,435,53,488
20200306,WI,1,31,12,,,,,,,,b96ccd39757d6ceed4a2d639e0095b3d8f8f3434,2020-03-06T21:00:00Z,,,44,32,32,55,0,0,12,0,12
20200306,WV,0,1,4,,,,,,,,68d062b16bb06f20eabeb52ee79544ec7a511018,2020-03-06T21:00:00Z,,,5,1,1,54,,,,,
20200305,AZ,2,28,6,,,,,,,,3e94b739062d1c0306f5279361451cd382171ccf,2020-03-05T21:00:00Z,,,36,30,30,04,0,0,1,0,1
20200305,CA,53,462,,,,,,,,,ce0755ed64d8d97da631569ac60cacb5e301a000,2020-03-05T21:00:00Z,,,515,515,515,06,0,0,0,0,0
20200305,CO,0,19,21,,,,,,,,e45a58fa7b4795ecc217438ff041a6bd2b925fe3,2020-03-05T21:00:00Z,,,40,19,19,08,,,,,
20200305,DC,0,6,2,,,,,,,,86141ea62e1c9a456849cf2f2196a31ac9669154,2020-03-05T21:00:00Z,,,8,6,6,11,,,,,
20200305,FL,9,31,69,,,,,,,,d7d91ffc92fbbfad57ff361b0193d3f7df25b958,2020-03-05T21:00:00Z,,,109,40,40,12,0,0,7,7,14
20200305,GA,2,,,,,,,,,,4247fbf0514b9492027b2328f3f2dc0b2e45f063,2020-03-05T21:00:00Z,,,2,2,2,13,0,0,0,0,0
20200305,IL,5,165,27,,,,,,,,b4c9428d01eee9c65c8053a8cd8af2b28f9d7440,2020-03-05T21:00:00Z,,,197,170,170,17,0,0,41,1,42
20200305,MD,0,17,14,,,,,,,,0d90494b997e148552cd6034f5f347e1d5afb802,2020-03-05T21:00:00Z,,,31,17,17,24,,,,,
20200305,MI,72,8,0,,,,,,,,4a992bf64f4a07cb05d05455dfbc9e029ed9b7bd,2020-03-05T21:00:00Z,,,80,80,80,26,0,0,8,20,28
20200305,NC,1,,,,,,,,,,d3f8875e94e71c97de0283327b26f1feca9172e0,2020-03-05T21:00:00Z,,,1,1,1,37,0,0,0,0,0
20200305,NE,0,17,5,,,,,,,,5a0d06bda6fe7a3d859877a222126a595c97fc61,2020-03-05T21:00:00Z,,,22,17,17,31,,,,,
20200305,NH,2,16,4,,,,,,,,7e34f4dacfe1b54e984b2725002f97e08fbae32d,2020-03-05T21:00:00Z,,,22,18,18,33,0,0,6,0,6
20200305,NJ,1,,,,,,,,,,80fa3d5297f9e2b3a46fa82bf816c002d9da0976,2020-03-05T21:00:00Z,,,1,1,1,34,,,,,
20200305,NV,1,14,,,,,,,,,c75ee774e7c6ee7ca098db7e8bdd27109e94471a,2020-03-05T21:00:00Z,,,15,15,15,32,,,,,
20200305,NY,22,76,24,,,,,,,,a5eb1a3c895ee3acd8c87b19363bab6d581b3933,2020-03-05T21:00:00Z,,,122,98,98,36,0,0,28,16,44
20200305,OH,0,7,3,,,,,,,,1bbd3319a4e6db7805828c6b8588392ceb2ad0f0,2020-03-05T21:00:00Z,,,10,7,7,39,,,,,
20200305,OR,3,45,13,,,,,,,,99211bd19ed97ed9d4cf2ff512e5df794b13f3b8,2020-03-05T21:00:00Z,,,61,48,48,41,0,0,16,0,16
20200305,RI,2,17,,,,,,,,,0cb8184c9f75efd169366f854e083f655d5d8587,2020-03-05T21:00:00Z,,,19,19,19,44,0,0,6,0,6
20200305,SC,0,5,,,,,,,,,dd1265c2ed9b63d775342c5be9e03be78801ba0c,2020-03-05T21:00:00Z,,,5,5,5,45,0,0,0,0,0
20200305,TN,1,,,,,,,,,,d6b98cde0f741d1de22a669e2bcbdd2455e12b8a,2020-03-05T21:00:00Z,,,1,1,1,47,,,,,
20200305,TX,1,,,,,,,,,,d7dc50f88fb103b81e0745b9f7824ed7ee6c1738,2020-03-05T21:00:00Z,,,1,1,1,48,0,0,0,0,0
20200305,VA,0,18,3,,,,,,,,c34566b6ec1573923e494c44f1c6b744fed9b3ad,2020-03-05T21:00:00Z,,,21,18,18,51,,,,,
20200305,WA,97,943,,,,,,,,,607fa82d89fd1cea25af16768b4a8e7c7483798a,2020-03-05T21:00:00Z,20,,1040,1040,1040,53,4,0,312,21,333
20200305,WI,1,19,6,,,,,,,,3620b6a39cef411a89d895ac830c5c954ce63541,2020-03-05T21:00:00Z,,,26,20,20,55,0,0,0,0,0
20200304,AZ,2,27,5,,,,,,,,f9b5336be00388e0549a6e35cfbe7ec911597df2,2020-03-04T21:00:00Z,,,34,29,29,04,,,,,
20200304,CA,53,462,,,,,,,,,e89c69dcaf7f202257af579a58f86c340eee886a,2020-03-04T21:00:00Z,,,515,515,515,06,,,,,
20200304,FL,2,24,16,,,,,,,,827f5f46040136c1b1901fef08f15b03805c57f5,2020-03-04T21:00:00Z,,,42,26,26,12,,,,,
20200304,GA,2,,,,,,,,,,5a4b97663e22df521e97a56f67c3f458eafb2e59,2020-03-04T21:00:00Z,,,2,2,2,13,,,,,
20200304,IL,4,124,27,,,,,,,,c99302904c1de329aeb568cdf92affb6dd5921ad,2020-03-04T21:00:00Z,,,155,128,128,17,,,,,
20200304,MI,52,,,,,,,,,,50cc0fb10791e6f2cb774135dd28ee2c6fc0f942,2020-03-04T21:00:00Z,,,52,52,52,26,0,0,0,18,18
20200304,NC,1,,,,,,,,,,0361de92db7c1867144ce35f0d61e1588f3a13d5,2020-03-04T21:00:00Z,,,1,1,1,37,,,,,
20200304,NH,2,10,7,,,,,,,,57c57bb5f40efbba8ab043701700324b09ac602d,2020-03-04T21:00:00Z,,,19,12,12,33,,,,,
20200304,NY,6,48,24,,,,,,,,0e095e2b3db515b00d892276e6cac6912b1e0111,2020-03-04T21:00:00Z,,,78,54,54,36,,,,,
20200304,OR,3,29,18,,,,,,,,d63f4cf486a6d2f86062b9af1bd46955abd90cb9,2020-03-04T21:00:00Z,,,50,32,32,41,,,,,
20200304,RI,2,11,,,,,,,,,577f034e9cef2b6ed639a0ad879ad6a0c9d464fb,2020-03-04T21:00:00Z,,,13,13,13,44,0,0,5,0,5
20200304,SC,0,5,,,,,,,,,b244652e8adea8d1cc5d5961f023465f579156e0,2020-03-04T21:00:00Z,,,5,5,5,45,,,,,
20200304,TX,1,,,,,,,,,,d29839e81cae6ba53df2d1a1d7bfeddfd4fc8509,2020-03-04T21:00:00Z,,,1,1,1,48,,,,,
20200304,WA,76,631,,,,,,,,,8bf7a2e451a638418ba7cd0bb5a5afb37836dee6,2020-03-04T21:00:00Z,16,,707,707,707,53,2,0,204,18,222
20200304,WI,1,19,6,,,,,,,,c1fede94be9a426dc9c3b5d26d33b9f168fec21c,2020-03-04T21:00:00Z,,,26,20,20,55,,,,,
20200303,MI,34,,,,,,,,,,fd660f6b972506bb4cd22c405ccc50fe1bc78034,2020-03-03T21:00:00Z,,,34,34,34,26,0,0,0,16,16
20200303,RI,2,6,,,,,,,,,2178a2f31e1a9100543e0beeea446d5520c2eeaa,2020-03-03T21:00:00Z,,,8,8,8,44,0,0,6,1,7
20200303,WA,58,427,,,,,,,,,b95fd6daa06045878705b4885a42f61c740f07de,2020-03-03T21:00:00Z,14,,485,485,485,53,3,0,198,24,222
20200302,MI,18,,,,,,,,,,f3f4de102c6a551d77afba110d25593544389fea,2020-03-02T21:00:00Z,,,18,18,18,26,0,0,0,9,9
20200302,RI,1,,,,,,,,,,6049ac06541847a4b2afaaef7ea4b08defbc8d8d,2020-03-02T21:00:00Z,,,1,1,1,44,0,0,0,0,0
20200302,WA,34,229,,,,,,,,,4687fefcced1054fd282f4a28f8f00ed26fbd2bf,2020-03-02T21:00:00Z,11,,263,263,263,53,3,0,148,4,152
20200301,MI,9,,,,,,,,,,32031e8ccdd5e7665b34254420b0a13603a06f23,2020-03-01T21:00:00Z,,,9,9,9,26,,,,,
20200301,RI,1,,,,,,,,,,a988931eea2a273da2fbabc46829f2afaf5eb0af,2020-03-01T21:00:00Z,,,1,1,1,44,,,,,
20200301,WA,30,81,,,,,,,,,baada06c39baedbdef93b3329a88f9c8bb415e4a,2020-03-01T21:00:00Z,8,,111,111,111,53,3,0,58,12,70
20200229,WA,18,23,,,,,,,,,8e71684cac1345c56d901e9145d3ec9f4a2b04c0,2020-02-29T21:00:00Z,5,,41,41,41,53,1,0,23,9,32
20200228,WA,9,,,,,,,,,,d89ae68938d114a40da5cf3a26c2a9e1301713a6,2020-02-28T21:00:00Z,4,,9,9,9,53,2,0,0,7,7
20200227,WA,2,,,,,,,,,,5c5bed3cadd96a874e13a2f58fb6026c05cb8204,2020-02-27T21:00:00Z,2,,2,2,2,53,0,0,0,0,0
20200226,WA,2,,,,,,,,,,e4da6c63d3d1bed301648ab7e96cad3ca6f0c984,2020-02-26T21:00:00Z,2,,2,2,2,53,2,0,0,0,0
20200225,WA,2,,,,,,,,,,68dc2f361ec0699c027370cc8a12cedd3b2f57b2,2020-02-25T21:00:00Z,,,2,2,2,53,0,0,0,0,0
20200224,WA,2,,,,,,,,,,7a2455094f6696e6faf83899ec20b7bddfe24126,2020-02-24T21:00:00Z,,,2,2,2,53,0,0,0,0,0
20200223,WA,2,,,,,,,,,,cc05fc1bf2ca804190d87169cc4f4b43bac23182,2020-02-23T21:00:00Z,,,2,2,2,53,0,0,0,0,0
20200222,WA,2,,,,,,,,,,0b0c39f4a18bade675668306af136ab2f53697fe,2020-02-22T21:00:00Z,,,2,2,2,53,0,0,0,0,0
20200221,WA,2,,,,,,,,,,eaff5214cdc4093f59ce5263f18e38fbeb77494f,2020-02-21T21:00:00Z,,,2,2,2,53,0,0,0,0,0
20200220,WA,2,,,,,,,,,,d12c28e16b6c035d831f66f1f2ff4e21428d8410,2020-02-20T21:00:00Z,,,2,2,2,53,0,0,0,0,0
20200219,WA,2,,,,,,,,,,33a0bde3a78c103d70d40f0e4b082e0924bb88a9,2020-02-19T21:00:00Z,,,2,2,2,53,0,0,0,0,0
20200218,WA,2,,,,,,,,,,94e59f706a1ba4aa5625505a161a75ece80a2da7,2020-02-18T21:00:00Z,,,2,2,2,53,0,0,0,0,0
20200217,WA,2,,,,,,,,,,3f8596d7c483dba78113e8d0d65ed4d99a6d04a7,2020-02-17T21:00:00Z,,,2,2,2,53,0,0,0,0,0
20200216,WA,2,,,,,,,,,,af9516a222c7f704d59d4e6d6195e6dca877916f,2020-02-16T21:00:00Z,,,2,2,2,53,0,0,0,0,0
20200215,WA,2,,,,,,,,,,0b9c33043957b09ee2efbfe857464c77ef941b10,2020-02-15T21:00:00Z,,,2,2,2,53,0,0,0,0,0
20200214,WA,2,,,,,,,,,,8dfd28c8d7682539add565c210d8a0f70993edf4,2020-02-14T21:00:00Z,,,2,2,2,53,0,0,0,0,0
20200213,WA,2,,,,,,,,,,5bdde2575d31ba09e348483d4ac4c60e0e3dfea4,2020-02-13T21:00:00Z,,,2,2,2,53,0,0,0,0,0
20200212,WA,2,,,,,,,,,,fd56c52779001fe578fa700d170055d8b36b6159,2020-02-12T21:00:00Z,,,2,2,2,53,0,0,0,0,0
20200211,WA,2,,,,,,,,,,1c7c51ebe96c06f3c1cefb071f1ab57ff61e2496,2020-02-11T21:00:00Z,,,2,2,2,53,0,0,0,0,0
20200210,WA,2,,,,,,,,,,ff9c0bcb7288f5f6e85046a96a89aca422e939dd,2020-02-10T21:00:00Z,,,2,2,2,53,0,0,0,0,0
20200209,WA,2,,,,,,,,,,e8120b7135f2fc4c57551fd8554a82cb385271b0,2020-02-09T21:00:00Z,,,2,2,2,53,0,0,0,0,0
20200208,WA,2,,,,,,,,,,3718ec25876bd3354eb87168a1ee3374198dd439,2020-02-08T21:00:00Z,,,2,2,2,53,0,0,0,0,0
20200207,WA,2,,,,,,,,,,c8987a6f7b6bda4a108b0bfbbfba4c9c206dbdf2,2020-02-07T21:00:00Z,,,2,2,2,53,0,0,0,1,1
20200206,WA,1,,,,,,,,,,77480a3b7eef8ef3f86746ba93a3c41a9f028eab,2020-02-06T21:00:00Z,,,1,1,1,53,0,0,0,0,0
20200205,WA,1,,,,,,,,,,9953c7552e586867ae42a8fc6b1957e653f2ab3c,2020-02-05T21:00:00Z,,,1,1,1,53,0,0,0,0,0
20200204,WA,1,,,,,,,,,,809dd1add519b3d81fcc94cf845f572096c7ed1c,2020-02-04T21:00:00Z,,,1,1,1,53,0,0,0,0,0
20200203,WA,1,,,,,,,,,,9500e206243c7dec91d1f89092aba0c92bf5aad2,2020-02-03T21:00:00Z,,,1,1,1,53,0,0,0,0,0
20200202,WA,1,,,,,,,,,,34b3c8d84417aff0ffa65274a6ccae208269b2c5,2020-02-02T21:00:00Z,,,1,1,1,53,0,0,0,0,0
20200201,WA,1,,,,,,,,,,7f6e2e3541cc39c8faf360eded70120ef1f01374,2020-02-01T21:00:00Z,,,1,1,1,53,0,0,0,0,0
20200131,WA,1,,,,,,,,,,e2c94eb4a9635a3bf35ae46ceb7f5496ae5596d4,2020-01-31T21:00:00Z,,,1,1,1,53,0,0,0,0,0
20200130,WA,1,,,,,,,,,,ba725dcd4055b95a974e7ad68b415e63cc026664,2020-01-30T21:00:00Z,,,1,1,1,53,0,0,0,0,0
20200129,WA,1,,,,,,,,,,ebd3db8123a213ec18160315a9cae98933f811a3,2020-01-29T21:00:00Z,,,1,1,1,53,0,0,0,0,0
20200128,WA,1,,,,,,,,,,40d46918d08a46309d5228751d4d315d972428a5,2020-01-28T21:00:00Z,,,1,1,1,53,0,0,0,0,0
20200127,WA,1,,,,,,,,,,15d0ad948df84d87c31ab25a4091a1980670fedd,2020-01-27T21:00:00Z,,,1,1,1,53,0,0,0,0,0
20200126,WA,1,,,,,,,,,,405aae8b4155c77878ab1e2a85f32d7bb7a45c9a,2020-01-26T21:00:00Z,,,1,1,1,53,0,0,0,0,0
20200125,WA,1,,,,,,,,,,f17fc4cde1b2e7b57e946752d620e48d7f02c7ce,2020-01-25T21:00:00Z,,,1,1,1,53,0,0,0,0,0
20200124,WA,1,,,,,,,,,,4763cdf13300976ba41317d7c7767e1c558a1134,2020-01-24T21:00:00Z,,,1,1,1,53,0,0,0,0,0
20200123,WA,1,,,,,,,,,,faa0d0b985f479eac50082e417dc84f9e645db8f,2020-01-23T21:00:00Z,,,1,1,1,53,0,0,0,0,0
20200122,WA,1,,,,,,,,,,299b5b62b4d05b5d61eba3e3730bb17d025ceb75,2020-01-22T21:00:00Z,,,1,1,1,53,,,,,