date,states,positive,negative,pending,hospitalizedCurrently,hospitalizedCumulative,inIcuCurrently,inIcuCumulative,onVentilatorCurrently,onVentilatorCumulative,recovered,dateChecked,death,hospitalized,lastModified,total,totalTestResults,posNeg,deathIncrease,hospitalizedIncrease,negativeIncrease,positiveIncrease,totalTestResultsIncrease,hash
20200728,56,4328695,48656882,3600,57091,299144,10463,13559,2752,1372,1355363,2020-07-28T00:00:00Z,141430,299144,2020-07-28T00:00:00Z,52989177,52985577,52985577,1121,4672,679736,53507,733243,10729af9f291bbb18e37d56f0bc31ff802f09672
20200727,56,4275188,47977146,3398,59023,294472,10328,13412,2720,1356,1325804,2020-07-27T00:00:00Z,140309,294472,2020-07-27T00:00:00Z,52255732,52252334,52252334,384,1690,705706,55134,760840,021bea33ea5ddba5408c2a928ad900ae036a25dc
20200726,56,4220054,47271440,3361,58614,292782,10353,13343,2723,1336,1297863,2020-07-26T00:00:00Z,139925,292782,2020-07-26T00:00:00Z,51494855,51491494,51491494,405,1435,794098,61713,855811,fd4b9434c593fc6b57c869a5ded22b5fbd75839e
20200725,56,4158341,46477342,3377,59227,291347,10380,13279,2729,1300,1279414,2020-07-25T00:00:00Z,139520,291347,2020-07-25T00:00:00Z,50639060,50635683,50635683,869,1992,732176,65413,797589,2e7b3c8ff7465048a829fdca0a0843d83cb8b436
20200724,56,4092928,45745166,3409,59670,289355,10405,13182,2712,1297,1261624,2020-07-24T00:00:00Z,138651,289355,2020-07-24T00:00:00Z,49841503,49838094,49838094,983,3026,854645,75193,929838,0b778476132decebcbcea21de68477d2e518697a
20200723,56,4017735,44890521,3179,59885,286329,10418,12933,2472,1280,1233269,2020-07-23T00:00:00Z,137668,286329,2020-07-23T00:00:00Z,48911435,48908256,48908256,871,2500,753372,71027,824399,22e9b4d04f039d1c9191f20c8045039e36bf828e
20200722,56,3946708,44137149,3051,59675,283829,10457,12790,2440,1258,1210849,2020-07-22T00:00:00Z,136797,283829,2020-07-22T00:00:00Z,48086908,48083857,48083857,946,2248,726352,69150,795502,19c8d6075b162873e4f6a953e38271caa7582da0
20200721,56,3877558,43410797,3197,59362,281581,6711,12629,2414,1242,1182931,2020-07-21T00:00:00Z,135851,281581,2020-07-21T00:00:00Z,47291552,47288355,47288355,944,2551,686606,63642,750248,6a8bafccb1ec523d77808e2dc5d0cf56a969cf21
20200720,56,3813916,42724191,3003,58371,279030,6558,12475,2403,1223,1160087,2020-07-20T00:00:00Z,134907,279030,2020-07-20T00:00:00Z,46541110,46538107,46538107,362,1647,654044,56971,711015,f9cbf575c313569fbbd94617c4bc755483c09591
20200719,56,3756945,42070147,3052,57885,277383,6384,12393,2362,1216,1131171,2020-07-19T00:00:00Z,134545,277383,2020-07-19T00:00:00Z,45830144,45827092,45827092,504,944,733624,64884,798508,40b81da4b58782c66d79615c8e8736ef65af6733
20200718,56,3692061,41336523,3032,57645,276439,6396,12342,2343,1211,1122720,2020-07-18T00:00:00Z,134041,276439,2020-07-18T00:00:00Z,45031616,45028584,45028584,819,2003,696452,65180,761632,46c5769878c644d17303b40b9c7096f1ae7e531f
20200717,56,3626881,40640071,3002,57761,274436,6453,12243,2353,1200,1106844,2020-07-17T00:00:00Z,133222,274436,2020-07-17T00:00:00Z,44269954,44266952,44266952,871,2678,760159,77233,837392,fcec47baddb89e50419ab9921ca45f2d8e620132
20200716,56,3549648,39879912,2929,57442,271758,6359,12091,2317,1175,1090645,2020-07-16T00:00:00Z,132351,271758,2020-07-16T00:00:00Z,43432489,43429560,43429560,951,2215,756611,70953,827564,db5f4121109e90a02a69076032efc6960f46245d
20200715,56,3478695,39123301,2947,56144,269543,6317,12002,2317,1166,1075882,2020-07-15T00:00:00Z,131400,269543,2020-07-15T00:00:00Z,42604943,42601996,42601996,879,2416,696615,65382,761997,455f5d7b48876a21233252c7f2926b2028f64d70
20200714,56,3413313,38426686,960,55565,267127,6235,11857,2263,1154,1049098,2020-07-14T00:00:00Z,130521,267127,2020-07-14T00:00:00Z,41840959,41839999,41839999,804,2262,707103,62879,769982,8baa6dddba619e59173dbc76077a514895a3e102
20200713,56,3350434,37719583,2610,53988,264865,6074,11749,2259,1142,1031939,2020-07-13T00:00:00Z,129717,264865,2020-07-13T00:00:00Z,41072627,41070017,41070017,420,1214,635111,58465,693576,9aaa5c8aacfe0b5557d0a42756d4b7d67afe2afc
20200712,56,3291969,37084472,2639,52727,263651,5930,11679,2182,1136,1006326,2020-07-12T00:00:00Z,129297,263651,2020-07-12T00:00:00Z,40379080,40376441,40376441,565,939,697346,60978,758324,6c1b93183e9b7f275639c97529a1727b3db8868d
20200711,56,3230991,36387126,2618,51859,262712,5939,11612,2169,1128,995576,2020-07-11T00:00:00Z,128732,262712,2020-07-11T00:00:00Z,39620735,39618117,39618117,795,5141,635437,63007,698444,677b39bec059f761adc73e5e5c7e1306461449e2
20200710,56,3167984,35751689,2493,51595,257571,5896,11523,2197,1118,983185,2020-07-10T00:00:00Z,127937,257571,2020-07-10T00:00:00Z,38922166,38919673,38919673,904,2318,744161,66645,810806,b504140b27ae94b41907a8866b603735902ba2af
20200709,56,3101339,35007528,2530,43934,255253,5845,11370,2127,1138,969111,2020-07-09T00:00:00Z,127033,255253,2020-07-09T00:00:00Z,38111397,38108867,38108867,894,1719,644214,58836,703050,89f5db40e588120e48ff591bd1ba7570889d7544
20200708,56,3042503,34363314,2360,43078,253534,5874,11303,2172,1103,953420,2020-07-08T00:00:00Z,126139,253534,2020-07-08T00:00:00Z,37408177,37405817,37405817,943,2035,566955,62147,629102,8625948c990acdcf47423b182e97ec48e97c42eb
20200707,56,2980356,33796359,2136,41760,251499,5832,11177,2098,1084,936476,2020-07-07T00:00:00Z,125196,251499,2020-07-07T00:00:00Z,36778851,36776715,36776715,994,1960,583025,51766,634791,dd23e9796adeb0904e00815a0f9efc976d234274
20200706,56,2928590,33213334,1907,39768,249539,5684,11058,2105,1070,924148,2020-07-06T00:00:00Z,124202,249539,2020-07-06T00:00:00Z,36143831,36141924,36141924,338,794,459601,41600,501201,0e531912c49010de5bea45c932a472b0c1ea8a1e
20200705,56,2886990,32753733,1885,38764,248745,5653,11010,2080,1064,902558,2020-07-05T00:00:00Z,123864,248745,2020-07-05T00:00:00Z,35642608,35640723,35640723,290,590,635661,45789,681450,a9cf7d0a39dc9d899833de1ac69fa26db3f4b9bb
20200704,56,2841201,32118072,2083,38146,248155,5633,10977,1982,1063,894325,2020-07-04T00:00:00Z,123574,248155,2020-07-04T00:00:00Z,34961356,34959273,34959273,400,871,587437,54734,642171,dc6fbd50a72d7b45a2e1a0268f22306c1d34d895
20200703,56,2786467,31530635,2237,37798,247284,5597,10936,2049,1059,883561,2020-07-03T00:00:00Z,123174,247284,2020-07-03T00:00:00Z,34319339,34317102,34317102,665,1435,656726,54223,710949,f7f300ea2522436cb0b108a8f13d6411f2a73e48
20200702,56,2732244,30873909,2208,37500,245849,5626,10843,2105,1041,875127,2020-07-02T00:00:00Z,122509,245849,2020-07-02T00:00:00Z,33608361,33606153,33606153,755,2003,608490,53826,662316,30ea8543425a0239e8c41aea012921c95b3850ca
20200701,56,2678418,30265419,2604,36405,243846,5512,10752,2098,1027,823151,2020-07-01T00:00:00Z,121754,243846,2020-07-01T00:00:00Z,32946441,32943837,32943837,733,1438,582612,50674,633286,0d3c72fb7ec3aa1ac646516e10f39ae0e189c9bb
20200630,56,2627744,29682807,2432,35248,242408,5424,10669,2044,1008,813788,2020-06-30T00:00:00Z,121021,242408,2020-06-30T00:00:00Z,32312983,32310551,32310551,657,1582,576601,47462,624063,e54e4bcb299d09f232cc9f8490b8f946ed83b4ab
20200629,56,2580282,29106206,2194,33586,240826,5380,10542,2011,990,798360,2020-06-29T00:00:00Z,120364,240826,2020-06-29T00:00:00Z,31688682,31686488,31686488,405,670,607649,39175,646824,f55f8e27dc3c62507db696874be439efec049eb1
20200628,56,2541107,28498557,2198,32476,240156,5248,10473,2077,983,778321,2020-06-28T00:00:00Z,119959,240156,2020-06-28T00:00:00Z,31041862,31039664,31039664,331,580,542041,41857,583898,e5a2002c521362ac517998b4f581bbc5b2d05bd6
20200627,56,2499250,27956516,2186,32483,239576,5315,10415,2159,977,772465,2020-06-27T00:00:00Z,119628,239576,2020-06-27T00:00:00Z,30457952,30455766,30455766,543,1057,555603,43783,599386,cde9090691a42fb67c496082a231f4cf36ca659c
20200626,56,2455467,27400913,2201,31738,238519,5283,10334,2075,966,763966,2020-06-26T00:00:00Z,119085,238519,2020-06-26T00:00:00Z,29858581,29856380,29856380,674,1526,562326,44421,606747,d4d543bc944b5755e5698ff3896027ed99efe6c8
20200625,56,2411046,26838587,2133,31844,236993,5319,10257,2214,951,756719,2020-06-25T00:00:00Z,118411,236993,2020-06-25T00:00:00Z,29251766,29249633,29249633,2512,1257,598076,39072,637148,1c7960a70fd9fff0b56fbfd15975ce1c7049ce76
20200624,56,2371974,26240511,2049,31102,235736,5293,10173,2248,934,747565,2020-06-24T00:00:00Z,115899,235736,2020-06-24T00:00:00Z,28614534,28612485,28612485,767,1310,480518,38684,519202,ffd4b28060b4bc96d99387d717ceb7e7d02c259f
20200623,56,2333290,25759993,1891,30235,234426,5402,10077,2293,918,738952,2020-06-23T00:00:00Z,115132,234426,2020-06-23T00:00:00Z,28095174,28093283,28093283,721,1257,458698,33021,491719,369729203413931b80db318beb0e9497de1ad6e0
20200622,56,2300269,25301295,2028,28799,233169,5323,10002,2299,909,731602,2020-06-22T00:00:00Z,114411,233169,2020-06-22T00:00:00Z,27603592,27601564,27601564,316,800,439588,27017,466605,1d51ca89fa530aeb70b01579b40686b9083de429
20200621,56,2273252,24861707,2084,28219,232369,5195,9944,2321,904,713537,2020-06-21T00:00:00Z,114095,232369,2020-06-21T00:00:00Z,27137043,27134959,27134959,315,514,483814,27284,511098,460af8f6bb4500a7f1e4834c312c9b500c26577a
20200620,56,2245968,24377893,2108,27967,231855,5229,9908,2380,888,708864,2020-06-20T00:00:00Z,113780,231855,2020-06-20T00:00:00Z,26625969,26623861,26623861,650,745,527221,31994,559215,680a7c861b8535193ce5e4d537dba1e16a2e6dcb
20200619,56,2213974,23850672,2032,28615,231110,5341,9876,2434,884,698119,2020-06-19T00:00:00Z,113130,231110,2020-06-19T00:00:00Z,26066678,26064646,26064646,666,1613,542946,31046,573992,f6a79a4d23c04533ca71c60933f36fba10e04c0c
20200618,56,2182928,23307726,1903,28414,229497,5465,9736,2520,869,690692,2020-06-18T00:00:00Z,112464,229497,2020-06-18T00:00:00Z,25492557,25490654,25490654,703,1040,488666,27527,516193,c3edecdd9292e7f6777fdcbdc31bbb48e2c54305
20200617,56,2155401,22819060,1745,28573,228457,5613,9665,2588,857,680916,2020-06-17T00:00:00Z,111761,228457,2020-06-17T00:00:00Z,24976206,24974461,24974461,771,1130,461417,23873,485290,ef2bef36f4c00296bae7c3a311e97c4213f8c17b
20200616,56,2131528,22357643,1604,28270,227327,5570,9590,2594,845,672228,2020-06-16T00:00:00Z,110990,227327,2020-06-16T00:00:00Z,24490775,24489171,24489171,728,1301,441094,23435,464529,3b15327a1061a80daf9fd76122c2df3999d6c4de
20200615,56,2108093,21916549,1619,27867,226026,5703,9516,2640,835,665059,2020-06-15T00:00:00Z,110262,226026,2020-06-15T00:00:00Z,24026261,24024642,24024642,402,543,414301,18510,432811,1a59a4ab6d286bb5578d47748cde691a09978aec
20200614,56,2089583,21502248,1672,27893,225483,5749,9466,2716,834,650541,2020-06-14T00:00:00Z,109860,225483,2020-06-14T00:00:00Z,23593503,23591831,23591831,382,640,463847,21373,485220,af49774c5d79949f7f4b133459bce2b4c16026f2
20200613,56,2068210,21038401,1698,28450,224843,5883,9430,2726,830,645331,2020-06-13T00:00:00Z,109478,224843,2020-06-13T00:00:00Z,23108309,23106611,23106611,713,1105,471087,25341,496428,a196e6208adfc507d81d8db1d71e8fd81ea2f568
20200612,56,2042869,20567314,1783,29154,223738,6017,9373,2734,814,636111,2020-06-12T00:00:00Z,108765,223738,2020-06-12T00:00:00Z,22611966,22610183,22610183,788,1245,599648,23477,623125,2bb7c3a5e83dde39a018937875154382a7363173
20200611,56,2019392,19967666,1816,29698,222493,6074,9295,2886,792,629017,2020-06-11T00:00:00Z,107977,222493,2020-06-11T00:00:00Z,21988874,21987058,21987058,891,1367,437423,22032,459455,bd6713508f6e5311e47a22185db12e886b40a378
20200610,56,1997360,19530243,1737,30864,221126,6249,9225,3020,780,618125,2020-06-10T00:00:00Z,107086,221126,2020-06-10T00:00:00Z,21529340,21527603,21527603,877,1484,408196,20803,428999,eb8aa45597618abef311082918903b835b3421ae
20200609,56,1976557,19122047,1661,31183,219642,6457,9141,3090,771,609476,2020-06-09T00:00:00Z,106209,219642,2020-06-09T00:00:00Z,21100265,21098604,21098604,909,1527,402549,17175,419724,f8394227dbb3b081d7491473222654724b5585cf
20200608,56,1959382,18719498,1606,31202,218115,6402,9013,3240,762,603143,2020-06-08T00:00:00Z,105300,218115,2020-06-08T00:00:00Z,20680486,20678880,20678880,691,714,378134,17012,395146,7e2f127a1598d945e40c41753c8f4d954bedc019
20200607,56,1942370,18341364,1733,31408,217401,6501,8957,3298,753,590988,2020-06-07T00:00:00Z,104609,217401,2020-06-07T00:00:00Z,20285467,20283734,20283734,455,685,427116,18823,445939,49218dfb4055dcd292030bb2fac75dd0c739d04f
20200606,56,1923547,17914248,1796,31938,216716,6762,8920,3476,750,585470,2020-06-06T00:00:00Z,104154,216716,2020-06-06T00:00:00Z,19839591,19837795,19837795,729,1017,497145,23106,520251,26a0abbbcd2d979c116e7f4c7e02bab14557fccf
20200605,56,1900441,17417103,1749,32451,215699,6920,8863,3523,740,576327,2020-06-05T00:00:00Z,103425,215699,2020-06-05T00:00:00Z,19319293,19317544,19317544,828,1440,482923,23352,506275,feb14baadc79e6869782e82b1129bd38e8a72a0e
20200604,56,1877089,16934180,3474,32835,214259,7057,8787,3665,723,569623,2020-06-04T00:00:00Z,102597,214259,2020-06-04T00:00:00Z,18814743,18811269,18811269,877,-2841,440145,20839,460984,ec8dce08b5d54521ce7b2bfa04b6ba24ed27d989
20200603,56,1856250,16494035,3556,33269,217100,7227,8688,3749,717,557366,2020-06-03T00:00:00Z,101720,217100,2020-06-03T00:00:00Z,18353841,18350285,18350285,987,2255,446402,20312,466714,45db04079ab0c73bf99c99c1321bbd1bc6072a52
20200602,56,1835938,16047633,4054,33933,214845,7407,8566,3852,710,541976,2020-06-02T00:00:00Z,100733,214845,2020-06-02T00:00:00Z,17887625,17883571,17883571,967,1585,398664,19982,418646,10e503f64fcd5e50f766c485b6f7d693cd2b386a
20200601,56,1815956,15648969,3455,34285,213260,7591,8485,3950,704,536339,2020-06-01T00:00:00Z,99766,213260,2020-06-01T00:00:00Z,17468380,17464925,17464925,680,2796,391912,20415,412327,4c14a6f6b1839d197b6ff4188cfd5a74749c808b
20200531,56,1795541,15257057,3270,34859,210464,7626,8445,3669,704,522866,2020-05-31T00:00:00Z,99086,210464,2020-05-31T00:00:00Z,17055868,17052598,17052598,617,976,374532,21639,396171,a10b97b22f7542144132f3c2d49ca92d2d10e8b7
20200530,56,1773902,14882525,1668,35732,209488,7956,8305,4004,698,494569,2020-05-30T00:00:00Z,98469,209488,2020-05-30T00:00:00Z,16658095,16656427,16656427,960,1424,401992,23762,425754,f05c2bc04d597bbc486cbb37da0ee9e775d72362
20200529,56,1750140,14480533,2978,36999,208064,8175,8235,4032,689,484554,2020-05-29T00:00:00Z,97509,208064,2020-05-29T00:00:00Z,16233651,16230673,16230673,1190,1715,463707,23522,487229,90cdff40081f975266e61fb573d6c6a948af8fed
20200528,56,1726618,14016826,1906,38069,206349,8389,8109,4080,676,478099,2020-05-28T00:00:00Z,96319,206349,2020-05-28T00:00:00Z,15745350,15743444,15743444,1219,1630,411869,22601,434470,ce39167c5a9ee22cb31f3e3c570064e23706d103
20200527,56,1704017,13604957,3132,38373,204719,8547,8015,4222,666,391508,2020-05-27T00:00:00Z,95100,204719,2020-05-27T00:00:00Z,15312106,15308974,15308974,1315,1713,289048,19385,308433,ed34c713af442fb1a4043394e17b676ac1319731
20200526,56,1684632,13315909,1549,37779,203006,8585,7899,4215,650,384902,2020-05-26T00:00:00Z,93785,203006,2020-05-26T00:00:00Z,15002090,15000541,15000541,654,17320,289303,16629,305932,787f36d7815923094516a274a3510bf807f8c29f
20200525,56,1668003,13026606,3368,37650,185686,8472,7847,4237,642,379157,2020-05-25T00:00:00Z,93131,185686,2020-05-25T00:00:00Z,14697977,14694609,14694609,565,1002,403790,18798,422588,19028189b8740f5eaa2dc88f9559cd29829bfe5c
20200524,56,1649205,12622816,3860,37695,184684,8487,7801,4383,639,366736,2020-05-24T00:00:00Z,92566,184684,2020-05-24T00:00:00Z,14275881,14272021,14272021,713,921,361400,20105,381505,191eb351ed987affbf47713513a7fd4e540d6192
20200523,56,1629100,12261416,4084,38614,183763,8733,7770,4620,638,361239,2020-05-23T00:00:00Z,91853,183763,2020-05-23T00:00:00Z,13894600,13890516,13890516,1049,1378,368410,21590,390000,73be86caf01a87abb08628646d3f80bd5a278618
20200522,56,1607510,11893006,3709,39989,182385,9048,7689,4716,633,350135,2020-05-22T00:00:00Z,90804,182385,2020-05-22T00:00:00Z,13504225,13500516,13500516,1324,4046,384533,24555,409088,f80f26861ba2ca76b60ea5bd6b7047cf29cd0dba
20200521,56,1582955,11508473,3641,41191,178339,9090,7412,4868,616,298418,2020-05-21T00:00:00Z,89480,178339,2020-05-21T00:00:00Z,13095069,13091428,13091428,1393,4630,435306,26513,461819,1f71a94ee3678e5a351c8653c12193bee2f315c3
20200520,56,1556442,11073167,2973,41762,173709,9522,7319,4911,613,294312,2020-05-20T00:00:00Z,88087,173709,2020-05-20T00:00:00Z,12632582,12629609,12629609,1364,1996,385840,21319,407159,da7daf83a9a063724ec80e0996bd501d3d271d57
20200519,56,1535123,10687327,2944,41872,171713,9597,7217,5032,606,289484,2020-05-19T00:00:00Z,86723,171713,2020-05-19T00:00:00Z,12225394,12222450,12222450,1333,1597,380486,20853,401339,9b84ddf6808ecf770683842ee5f908a45778c5b3
20200518,56,1514270,10306841,3596,41748,170116,9755,7064,5257,602,283178,2020-05-18T00:00:00Z,85390,170116,2020-05-18T00:00:00Z,11824707,11821111,11821111,855,1157,333721,20992,354713,da18377140b8778360bd9a73d06d3a9e1340f699
20200517,56,1493278,9973120,3449,41785,168959,9932,7003,5467,593,272265,2020-05-17T00:00:00Z,84535,168959,2020-05-17T00:00:00Z,11469847,11466398,11466398,842,1199,350983,20171,371154,b57f7af54afd774d92e7ede123cdec612464310a
20200516,56,1473107,9622137,3788,43396,167760,10277,6945,5529,592,268376,2020-05-16T00:00:00Z,83693,167760,2020-05-16T00:00:00Z,11099032,11095244,11095244,982,1856,337419,24701,362120,79844a2e1d8d62a78f0405096f2f5536aadca20a
20200515,56,1448406,9284718,2457,44491,165904,10472,6890,5746,589,250747,2020-05-15T00:00:00Z,82711,165904,2020-05-15T00:00:00Z,10735581,10733124,10733124,1490,1353,333613,24710,358323,12de6c5a381470a8849072ea70a1092dbd7f5371
20200514,56,1423696,8951105,2673,45790,164551,10656,6795,5940,582,246414,2020-05-14T00:00:00Z,81221,164551,2020-05-14T00:00:00Z,10377474,10374801,10374801,1844,3206,337369,26705,364074,934fba647aae4acb439437603182d4d1f76c28e0
20200513,56,1396991,8613736,1983,46926,161345,10978,6713,6156,572,243430,2020-05-13T00:00:00Z,79377,161345,2020-05-13T00:00:00Z,10012710,10010727,10010727,1714,1809,297848,21193,319041,cd48c4d6704caf3404892a832b287b8edcfb70a2
20200512,56,1375798,8315888,1803,47596,159536,11241,5595,6352,559,238857,2020-05-12T00:00:00Z,77663,159536,2020-05-12T00:00:00Z,9693489,9691686,9691686,1473,1579,285892,22663,308555,07fff8a85c251c23bf6a9d8e56fec5529bf91a56
20200511,56,1353135,8029996,1989,46552,157957,11147,6488,6350,551,232142,2020-05-11T00:00:00Z,76190,157957,2020-05-11T00:00:00Z,9385120,9383131,9383131,911,1238,363887,18236,382123,76a935834a9cc6618bb4a87d0fc0a219dec52aa5
20200510,56,1334899,7666109,3095,47163,156719,11393,6445,6395,547,215591,2020-05-10T00:00:00Z,75279,156719,2020-05-10T00:00:00Z,9004103,9001008,9001008,1013,1055,244826,21504,266330,b786c3467709872b657422a34ae90a7f2f22d040
20200509,56,1313395,7421283,3054,48768,155664,11496,6367,6551,543,211976,2020-05-09T00:00:00Z,74266,155664,2020-05-09T00:00:00Z,8737732,8734678,8734678,1415,1708,266799,24810,291609,94b2d9dc0b2bb9a3415aa72c4083135fcfb2067c
20200508,56,1288585,7154484,3307,49992,153956,11780,6294,6788,531,198459,2020-05-08T00:00:00Z,72851,153956,2020-05-08T00:00:00Z,8446376,8443069,8443069,1782,6892,270245,27605,297850,c138067d8d6691ce7b36e8d0aad01d50ecb7662e
20200507,56,1260980,6884239,3171,51683,147064,12137,5174,7070,529,194528,2020-05-07T00:00:00Z,71069,147064,2020-05-07T00:00:00Z,8148390,8145219,8145219,2752,3742,274154,27490,301644,57524220de655ac1a6d1a15337f87b87883d0515
20200506,56,1233490,6610085,2742,52773,143322,12478,4911,4753,449,189425,2020-05-06T00:00:00Z,68317,143322,2020-05-06T00:00:00Z,7846317,7843575,7843575,1923,2119,219777,25056,244833,2ba3e140014492908b9cbcd86c5a488c75c85878
20200505,56,1208434,6390308,2633,53455,141203,12629,4794,4818,439,189336,2020-05-05T00:00:00Z,66394,141203,2020-05-05T00:00:00Z,7601375,7598742,7598742,2453,1983,249022,22449,271471,a9dfeb5259e1a36c1e1906e8c783b6a010f6fd66
20200504,56,1185985,6141286,2791,52634,139220,12696,4579,4848,430,186752,2020-05-04T00:00:00Z,63941,139220,2020-05-04T00:00:00Z,7330062,7327271,7327271,1026,1651,208933,22523,231456,5b3dc03ed1035d1d679bb537c09dc643a00b2e79
20200503,56,1163462,5932353,2812,52857,137569,12722,4502,4761,425,179733,2020-05-03T00:00:00Z,62915,137569,2020-05-03T00:00:00Z,7098627,7095815,7095815,1223,1963,210747,25767,236514,19f1ff73030b4cc15774b81014aba2f75d469362
20200502,56,1137695,5721606,1578,54278,135606,12904,4386,4845,375,174987,2020-05-02T00:00:00Z,61692,135606,2020-05-02T00:00:00Z,6860879,6859301,6859301,1543,2031,217899,29185,247084,76d3f44a7835316e64e7df71b7b4e537e8b9ece3
20200501,56,1108510,5503707,1639,55122,133575,12845,4300,4707,376,163644,2020-05-01T00:00:00Z,60149,133575,2020-05-01T00:00:00Z,6613856,6612217,6612217,1763,9789,262170,33056,295226,9fe3b644f7cf469727434bfb0c640a08e06d8e8f
20200430,56,1075454,5241537,2775,55114,123786,13255,4192,4712,373,154648,2020-04-30T00:00:00Z,58386,123786,2020-04-30T00:00:00Z,6319766,6316991,6316991,2103,2290,203240,29568,232808,6078cccdf850a48aceac42aefbe5399fedf08481
20200429,56,1045886,5038297,4832,56206,121496,13535,4093,4796,365,147165,2020-04-29T00:00:00Z,56283,121496,2020-04-29T00:00:00Z,6089015,6084183,6084183,2675,3415,211964,26641,238605,663f05e2258bc9f54b25c4e3362959c1e2bfada7
20200428,56,1019245,4826333,4206,56255,118081,13562,3798,4760,195,139041,2020-04-28T00:00:00Z,53608,118081,2020-04-28T00:00:00Z,5849784,5845578,5845578,2051,2079,181395,25219,206614,54b0c887cec509e0a4d962060b8107b4177a30df
20200427,56,994026,4644938,4077,56191,116002,13812,3720,4867,195,121323,2020-04-27T00:00:00Z,51557,116002,2020-04-27T00:00:00Z,5643041,5638964,5638964,1249,3076,172795,22605,195400,60ed99d621ad36b45ff66eb9aaa2f0b84fd82472
20200426,56,971421,4472143,4445,56186,112926,14099,2571,5121,227,116529,2020-04-26T00:00:00Z,50308,112926,2020-04-26T00:00:00Z,5448009,5443564,5443564,1194,2192,178908,27380,206288,765640b6e83546da84373da07948deae4a802748
20200425,56,944041,4293235,5315,57377,110734,14414,2516,5266,227,112539,2020-04-25T00:00:00Z,49114,110734,2020-04-25T00:00:00Z,5242591,5237276,5237276,1721,2456,240249,35901,276150,93c23243a40e0178ffb69beb070617dd16fc9ce6
20200424,56,908140,4052986,4396,57300,108278,14602,2468,5187,227,101296,2020-04-24T00:00:00Z,47393,108278,2020-04-24T00:00:00Z,4965522,4961126,4961126,1866,2338,201683,34174,235857,d7597a5aa4a70881dbf864bb590f4d709fdbb3db
20200423,56,873966,3851303,4258,58989,105940,14744,2428,5464,227,96921,2020-04-23T00:00:00Z,45527,105940,2020-04-23T00:00:00Z,4729527,4725269,4725269,1785,2802,161026,31784,192810,caafa1ab3f7b6302b16b3e20328fe8d2940a02fb
20200422,56,842182,3690277,4191,59205,103138,15015,2370,5474,227,92978,2020-04-22T00:00:00Z,43742,103138,2020-04-22T00:00:00Z,4536650,4532459,4532459,2070,3087,294567,28916,323483,3fbd1c2c358c59ec1d5e8ef0eb31de4a7bfdf7a0
20200421,56,813266,3395710,3956,59780,100051,14941,2315,5514,214,72842,2020-04-21T00:00:00Z,41672,100051,2020-04-21T00:00:00Z,4212932,4208976,4208976,2448,2682,126501,26333,152834,2c7c5b4bb8666a1841a8eeec5249677ae565a5e3
20200420,56,786933,3269209,4037,56783,97369,14489,2193,5567,214,69493,2020-04-20T00:00:00Z,39224,97369,2020-04-20T00:00:00Z,4060179,4056142,4056142,1774,2211,119816,25872,145688,ae3bf61b06e851daaadd0e301aea4c181649b90c
20200419,56,761061,3149393,11324,56526,95158,14410,2145,5603,214,67205,2020-04-19T00:00:00Z,37450,95158,2020-04-19T00:00:00Z,3921778,3910454,3910454,1738,2239,126462,27468,153930,8728fb37454004990ee81170ffeccfba474c2d63
20200418,56,733593,3022931,9906,57761,92919,14768,2096,5729,205,62840,2020-04-18T00:00:00Z,35712,92919,2020-04-18T00:00:00Z,3766430,3756524,3756524,1841,3563,117871,27963,145834,71ef9a48248f0af611e3fdf3b329328c75cfe49a
20200417,56,705630,2905060,10889,58895,89356,14890,2052,6096,148,53533,2020-04-17T00:00:00Z,33871,89356,2020-04-17T00:00:00Z,3621579,3610690,3610690,2080,3405,126720,31964,158684,6d8ec73fe33435c1b063457e44e480d443ab982a
20200416,56,673666,2778340,16927,59499,85951,15130,1834,5940,137,48851,2020-04-16T00:00:00Z,31791,85951,2020-04-16T00:00:00Z,3468933,3452006,3452006,2144,3071,132875,30923,163798,53a80ffad39243c9a7e0989cbc2012ccc77390e2
20200415,56,642743,2645465,16901,59940,82880,14647,1783,6032,223,43435,2020-04-15T00:00:00Z,29647,82880,2020-04-15T00:00:00Z,3305109,3288208,3288208,2477,4434,106684,30298,136982,05dcdc625be9ca768647ae2d8ceaacd2bf3c0d58
20200414,56,612445,2538781,16615,59601,78446,14039,1715,5975,221,39268,2020-04-14T00:00:00Z,27170,78446,2020-04-14T00:00:00Z,3167841,3151226,3151226,2291,3282,126141,25631,151772,4cc4cb2158ca2c09d5cd0c499044fd2149461a35
20200413,56,586814,2412640,17159,56195,75164,13632,1628,6168,210,35372,2020-04-13T00:00:00Z,24879,75164,2020-04-13T00:00:00Z,3016613,2999454,2999454,1588,4285,109050,25133,134183,bdbdd67bdcd88387a117cb83c1141dc314483802
20200412,56,561681,2303590,16419,55426,70879,13623,1455,5986,160,34081,2020-04-12T00:00:00Z,23291,70879,2020-04-12T00:00:00Z,2881690,2865271,2865271,1648,3288,111073,27844,138917,c7251fb80b81a0b0e21d22d6c11774455d8bc6f1
20200411,56,533837,2192517,16593,55572,67591,13280,1405,5978,154,31567,2020-04-11T00:00:00Z,21643,67591,2020-04-11T00:00:00Z,2742947,2726354,2726354,1989,2825,106426,30561,136987,d21c0465043770b593690c8d501b7e2f90d25a14
20200410,56,503276,2086091,17435,52723,64766,12698,1185,5937,41,28997,2020-04-10T00:00:00Z,19654,64766,2020-04-10T00:00:00Z,2606802,2589367,2589367,2057,4934,124042,34351,158393,345cab2c70f3cf2abf727d3ecf304f6651acd098
20200409,56,468925,1962049,17622,50859,59832,12254,924,5794,39,24819,2020-04-09T00:00:00Z,17597,59832,2020-04-09T00:00:00Z,2448596,2430974,2430974,1985,3923,136639,34419,171058,e24006e8c034c011f488009a623da13a3eb52b18
20200408,56,434506,1825410,17219,45141,55909,10180,1013,4131,216,21102,2020-04-08T00:00:00Z,15612,55909,2020-04-08T00:00:00Z,2277135,2259916,2259916,1947,4311,116954,30534,147488,fba195775090cfec6807a62ed349df59d5e5c29e
20200407,56,403972,1708456,16548,43465,51598,9821,889,4076,151,18443,2020-04-07T00:00:00Z,13665,51598,2020-04-07T00:00:00Z,2128976,2112428,2112428,1960,2981,123505,30737,154242,fbba022b79371a42036169b69b9991270cc12174
20200406,56,373235,1584951,17283,35856,48617,6943,814,2961,147,16554,2020-04-06T00:00:00Z,11705,48617,2020-04-06T00:00:00Z,1975469,1958186,1958186,1267,2946,123071,28937,152008,39c3fc4dde8c601bd2992c9d2a1fe01e30e97b9b
20200405,56,344298,1461880,17303,31875,45671,5677,760,652,147,14513,2020-04-05T00:00:00Z,10438,45671,2020-04-05T00:00:00Z,1823481,1806178,1806178,1302,3903,94105,25550,119655,863c452a1baeed930fea7e28c4cc51a258e3b195
20200404,56,318748,1367775,15569,29987,41768,5383,554,656,147,12816,2020-04-04T00:00:00Z,9136,41768,2020-04-04T00:00:00Z,1702092,1686523,1686523,1446,5086,195941,33252,229193,5c171ce2a599ef106fefbb5058e67519fe37f0fd
20200403,56,285496,1171834,61976,25472,36682,4811,486,605,147,10861,2020-04-03T00:00:00Z,7690,36682,2020-04-03T00:00:00Z,1519306,1457330,1457330,1259,4554,100945,31945,132890,caa9635f0f9160047e8df00ac98eafd8de0133c5
20200402,56,253551,1070889,62097,22764,32128,4410,456,574,140,8586,2020-04-02T00:00:00Z,6431,32128,2020-04-02T00:00:00Z,1386537,1324440,1324440,1160,4175,90859,27992,118851,e5675f9ac7061fff25a746d71a1785477ad0ce9c
20200401,56,225559,980030,59665,20775,27953,3937,407,561,140,7084,2020-04-01T00:00:00Z,5271,27953,2020-04-01T00:00:00Z,1265254,1205589,1205589,993,4228,82748,25773,108521,2198ee2a2401acb01a0a7e24d7a1508259f14095
20200331,56,199786,897282,59518,18082,23725,3487,236,507,,5666,2020-03-31T00:00:00Z,4278,23725,2020-03-31T00:00:00Z,1156586,1097068,1097068,867,3906,87636,24694,112330,b34784a9afcf38218a90b985083fdddb744910da
20200330,56,175092,809646,65369,15772,19819,3087,187,451,,4560,2020-03-30T00:00:00Z,3411,19819,2020-03-30T00:00:00Z,1050107,984738,984738,595,2536,96564,21897,118461,ebaada7ebb4b3520319306cf573e593e1946701e
20200329,56,153195,713082,65545,14026,17283,2456,156,439,,4052,2020-03-29T00:00:00Z,2816,17283,2020-03-29T00:00:00Z,931822,866277,866277,521,2775,67957,19655,87612,da12bfac50fe9a7879f91642667608e4f0dc9345
20200328,56,133540,645125,65709,12350,14508,2174,140,390,,3143,2020-03-28T00:00:00Z,2295,14508,2020-03-28T00:00:00Z,844374,778665,778665,527,2425,87146,19724,106870,2cf4d88c37604b9852e65f3f832705e116114a62
20200327,56,113816,557979,60091,10932,12083,1792,124,324,,2418,2020-03-27T00:00:00Z,1768,12083,2020-03-27T00:00:00Z,731886,671795,671795,405,2563,83612,19044,102656,5804f7949e79d54ba6d21c655168552ed8996032
20200326,56,94772,474367,60251,7757,9520,1299,91,258,,97,2020-03-26T00:00:00Z,1363,9520,2020-03-26T00:00:00Z,629390,569139,569139,316,2499,84159,17656,101815,32c870f0b350b9f8ff0b1570c63ead551eccf8af
20200325,56,77116,390208,51235,5062,7021,,74,167,,146,2020-03-25T00:00:00Z,1047,7021,2020-03-25T00:00:00Z,518559,467324,467324,235,1904,71521,12873,84394,34ead03c0324ac8bf389a3ead599f0680f9b316c
20200324,56,64243,318687,14433,3902,5117,,,,,,2020-03-24T00:00:00Z,812,5117,2020-03-24T00:00:00Z,397363,382930,382930,236,1180,58505,10632,69137,48bacc2d692d36bd2d56be2b208752f2490fb9e1
20200323,56,53611,260182,14571,2770,3937,,,,,,2020-03-23T00:00:00Z,576,3937,2020-03-23T00:00:00Z,328364,313793,313793,96,914,46706,11442,58148,e671912b9e30a4df938418467f05c4598bd8f94b
20200322,56,42169,213476,2842,2155,3023,,,,,,2020-03-22T00:00:00Z,480,3023,2020-03-22T00:00:00Z,258487,255645,255645,144,1003,36214,9259,45473,56da0dc4424cfd63217fc457e219d5236f7b0024
20200321,56,32910,177262,3468,1436,2020,,,,,,2020-03-21T00:00:00Z,336,2020,2020-03-21T00:00:00Z,213640,210172,210172,63,1912,38448,6885,45333,1f6db20566c5183062eea0d723bc2853ebc64564
20200320,56,26025,138814,3330,1042,108,,,,,,2020-03-20T00:00:00Z,273,108,2020-03-20T00:00:00Z,168169,164839,164839,70,23,30407,6255,36662,7cebdcb06c03a6aef25e1a655434c7379172e527
20200319,56,19770,108407,3016,617,85,,,,,,2020-03-19T00:00:00Z,203,85,2020-03-19T00:00:00Z,131193,128177,128177,45,18,23410,4671,28081,85763a036c2baf6a1fb75d0221b9a983dbefdc23
20200318,56,15099,84997,2526,416,67,,,,,,2020-03-18T00:00:00Z,158,67,2020-03-18T00:00:00Z,102622,100096,100096,32,12,21893,3171,25064,a56d690fe7e96e3c9c45ee9c5e80921faa0858b1
20200317,56,11928,63104,1687,325,55,,,,,,2020-03-17T00:00:00Z,126,55,2020-03-17T00:00:00Z,76719,75032,75032,23,13,13707,3613,17320,9803b76628ea2a58c1390d4b00651eb13153962e
20200316,56,8315,49397,1691,,42,,,,,,2020-03-16T00:00:00Z,103,42,2020-03-16T00:00:00Z,59403,57712,57712,22,6,16355,1569,17924,f01f06a84430ab5d5f168b7839e7f724e4bec547
20200315,51,6746,33042,2242,,36,,,,,,2020-03-15T00:00:00Z,81,36,2020-03-15T00:00:00Z,42030,39788,39788,16,10,6353,1251,7604,2c1caff953fb764d69f521f27ae7536be483d151
20200314,51,5495,26689,1236,,26,,,,,,2020-03-14T00:00:00Z,65,26,2020-03-14T00:00:00Z,33420,32184,32184,9,4,3695,915,4610,d3c3ae4e8b429609716509603966e0f2e52b64a3
20200313,51,4580,22994,1130,,22,,,,,,2020-03-13T00:00:00Z,56,22,2020-03-13T00:00:00Z,28704,27574,27574,4,6,8146,1025,9171,4dbc5bad5e1810ccffe0beea740221a35c76948c
20200312,51,3555,14848,673,,16,,,,,,2020-03-12T00:00:00Z,52,16,2020-03-12T00:00:00Z,19076,18403,18403,8,5,4628,682,5310,b7be3d577ffc747ee0845590f4025cc7a109dcc3
20200311,50,2873,10220,563,,11,,,,,,2020-03-11T00:00:00Z,44,11,2020-03-11T00:00:00Z,13656,13093,13093,6,3,3291,527,3818,cc5c2d353c0c9151332347a2c76239db20178a35
20200310,50,2346,6929,469,,8,,,,,,2020-03-10T00:00:00Z,38,8,2020-03-10T00:00:00Z,9744,9275,9275,2,0,2049,441,2490,6f395c4118b9b304aaaa7c80c8da968b8bbae823
20200309,50,1905,4880,313,,8,,,,,,2020-03-09T00:00:00Z,36,8,2020-03-09T00:00:00Z,7098,6785,6785,4,2,1406,367,1773,42ff1fdd3d0a6dfdeb8cba3c5e08374bf0f9ca74
20200308,50,1538,3474,347,,6,,,,,,2020-03-08T00:00:00Z,32,6,2020-03-08T00:00:00Z,5359,5012,5012,4,0,607,267,874,8329e2e2c6bc8017ab42e6fd68e26bb602f40ec4
20200307,50,1271,2867,602,,6,,,,,,2020-03-07T00:00:00Z,28,6,2020-03-07T00:00:00Z,4740,4138,4138,2,0,578,220,798,3f4e2a7d67ca8d738dbd2eeb361a83e80fa592a3
20200306,36,1051,2289,458,,6,,,,,,2020-03-06T00:00:00Z,26,6,2020-03-06T00:00:00Z,3798,3340,3340,6,1,645,141,786,bff341983cc3d91067e76e695a7b20466039800f
20200305,24,910,1644,197,,5,,,,,,2020-03-05T00:00:00Z,20,5,2020-03-05T00:00:00Z,2751,2554,2554,4,1,464,153,617,bbeb057e0be9cfaa0574f478dd604069f36a2225
20200304,15,757,1180,103,,4,,,,,,2020-03-04T00:00:00Z,16,4,2020-03-04T00:00:00Z,2040,1937,1937,2,4,911,187,1098,3f96feb9ff9259be2ec3fbc99edc9eac7ff266e3
20200303,3,570,269,,,,,,,,,2020-03-03T00:00:00Z,14,,2020-03-03T00:00:00Z,839,839,839,3,0,143,100,243,f9727e4e13ad82cb735a5e52a102c5b76eeab777
20200302,3,470,126,,,,,,,,,2020-03-02T00:00:00Z,11,,2020-03-02T00:00:00Z,596,596,596,3,0,112,82,194,e34b83810217fb8afc398883fc82f67cd2a8978f
20200301,3,388,14,,,,,,,,,2020-03-01T00:00:00Z,8,,2020-03-01T00:00:00Z,402,402,402,3,0,-3,89,86,3d4d65c707c4ebccea4304d86716fb6e265762e1
20200229,1,299,17,,,,,,,,,2020-02-29T00:00:00Z,5,,2020-02-29T00:00:00Z,316,316,316,1,0,17,24,41,27c8dfcf504c66796dd4842c82d37d8a8b7d0c88
20200228,1,275,0,,,,,,,,,2020-02-28T00:00:00Z,4,,2020-02-28T00:00:00Z,275,275,275,2,0,0,40,40,0063e380f01c09a74ff18ab1940b36390ef365d9
20200227,1,235,0,,,,,,,,,2020-02-27T00:00:00Z,2,,2020-02-27T00:00:00Z,235,235,235,0,0,0,27,27,ffe41d6947d93d86a6f85189d9d0461c93f93d5e
20200226,1,208,0,,,,,,,,,2020-02-26T00:00:00Z,2,,2020-02-26T00:00:00Z,208,208,208,2,0,0,29,29,52535d8139a745270672daabd2f8824e38f7acee
20200225,1,179,0,,,,,,,,,2020-02-25T00:00:00Z,,,2020-02-25T00:00:00Z,179,179,179,0,0,0,31,31,fe9bd7ac1b1bb0403591268e0e18c10c7dd677f1
20200224,1,148,0,,,,,,,,,2020-02-24T00:00:00Z,,,2020-02-24T00:00:00Z,148,148,148,0,0,0,26,26,40f040514bdd96cea0529aa4fab368bf810ce3de
20200223,1,122,0,,,,,,,,,2020-02-23T00:00:00Z,,,2020-02-23T00:00:00Z,122,122,122,0,0,0,16,16,512963fd5bbfd45e6812ee673008fd7f1d9e9051
20200222,1,106,0,,,,,,,,,2020-02-22T00:00:00Z,,,2020-02-22T00:00:00Z,106,106,106,0,0,0,13,13,1e2edd13a951b782f2e36aa1335da750c5d605f6
20200221,1,93,0,,,,,,,,,2020-02-21T00:00:00Z,,,2020-02-21T00:00:00Z,93,93,93,0,0,0,11,11,775bae89a8c7819e65d3b0b1e05ad1a33b6bb9b7
20200220,1,82,0,,,,,,,,,2020-02-20T00:00:00Z,,,2020-02-20T00:00:00Z,82,82,82,0,0,0,13,13,d3832ff43d2ad63fbbac69ccc3a6f7a425671626
20200219,1,69,0,,,,,,,,,2020-02-19T00:00:00Z,,,2020-02-19T00:00:00Z,69,69,69,0,0,0,10,10,4eaba6a35cee6bf7863c306d80ebccead4f9e0b8
20200218,1,59,0,,,,,,,,,2020-02-18T00:00:00Z,,,2020-02-18T00:00:00Z,59,59,59,0,0,0,9,9,037f86e217230eeb1f82483e7bc38c3575d92f9b
20200217,1,50,0,,,,,,,,,2020-02-17T00:00:00Z,,,2020-02-17T00:00:00Z,50,50,50,0,0,0,15,15,654825b140100438046a5320976ca872c886835f
20200216,1,35,0,,,,,,,,,2020-02-16T00:00:00Z,,,2020-02-16T00:00:00Z,35,35,35,0,0,0,7,7,0d0ac95120a24edf715c33b7042a673a3ac72c22
20200215,1,28,0,,,,,,,,,2020-02-15T00:00:00Z,,,2020-02-15T00:00:00Z,28,28,28,0,0,0,7,7,aa97543642db531c4455dcfbff575626241a3bbb
20200214,1,21,0,,,,,,,,,2020-02-14T00:00:00Z,,,2020-02-14T00:00:00Z,21,21,21,0,0,0,3,3,98bad0bbf2467633c3ba4522edc9da4a5a896bd1
20200213,1,18,0,,,,,,,,,2020-02-13T00:00:00Z,,,2020-02-13T00:00:00Z,18,18,18,0,0,0,0,0,7033407474f6f0f59a7b74854fcc812d655434c2
20200212,1,18,0,,,,,,,,,2020-02-12T00:00:00Z,,,2020-02-12T00:00:00Z,18,18,18,0,0,0,1,1,3b69cfc2335143142dbfcde2ba5732d7b892d037
20200211,1,17,0,,,,,,,,,2020-02-11T00:00:00Z,,,2020-02-11T00:00:00Z,17,17,17,0,0,0,1,1,cfe56ace9b8e5eae7ccc0dcb3ce89369077642ab
20200210,1,16,0,,,,,,,,,2020-02-10T00:00:00Z,,,2020-02-10T00:00:00Z,16,16,16,0,0,0,3,3,a620e75c6dc4c685fc26d5cca336cfc6ff614506
20200209,1,13,0,,,,,,,,,2020-02-09T00:00:00Z,,,2020-02-09T00:00:00Z,13,13,13,0,0,0,0,0,b71f4996ae8c6f14b2d694af20ae26e0fdc68f14
20200208,1,13,0,,,,,,,,,2020-02-08T00:00:00Z,,,2020-02-08T00:00:00Z,13,13,13,0,0,0,1,1,27c3180319798290a1198cbbee0c1ed2379fdc2e
20200207,1,12,0,,,,,,,,,2020-02-07T00:00:00Z,,,2020-02-07T00:00:00Z,12,12,12,0,0,0,1,1,b396ed198a3b1a49e6d52705bd47baf45e9c5ae3
20200206,1,11,0,,,,,,,,,2020-02-06T00:00:00Z,,,2020-02-06T00:00:00Z,11,11,11,0,0,0,3,3,d7fb4549ba2c79b594b34fa9ed191b58d71e3696
20200205,1,8,0,,,,,,,,,2020-02-05T00:00:00Z,,,2020-02-05T00:00:00Z,8,8,8,0,0,0,0,0,4ca0fa2b0948956f33b5a5788abefaf56f1fce99
20200204,1,8,0,,,,,,,,,2020-02-04T00:00:00Z,,,2020-02-04T00:00:00Z,8,8,8,0,0,0,1,1,a2c106780077754f6fc62f322ee1bb13059abf01
20200203,1,7,0,,,,,,,,,2020-02-03T00:00:00Z,,,2020-02-03T00:00:00Z,7,7,7,0,0,0,1,1,f675e1b9bbb0cae5b545c12b528a2d123c419fb9
20200202,1,6,0,,,,,,,,,2020-02-02T00:00:00Z,,,2020-02-02T00:00:00Z,6,6,6,0,0,0,2,2,cabf736289065d789dd6100385a980d65a1fbeeb
20200201,1,4,0,,,,,,,,,2020-02-01T00:00:00Z,,,2020-02-01T00:00:00Z,4,4,4,0,0,0,1,1,5d928ca7c6802a3183d4d549f6f746cde73b00ae
20200131,1,3,0,,,,,,,,,2020-01-31T00:00:00Z,,,2020-01-31T00:00:00Z,3,3,3,0,0,0,0,0,c5e11f3f448ee066a5d4ba1b23fc91ec00c54e86
20200130,1,3,0,,,,,,,,,2020-01-30T00:00:00Z,,,2020-01-30T00:00:00Z,3,3,3,0,0,0,0,0,0a8e7117d2571e8984618900ff1d40d7f2c944fe
20200129,1,3,0,,,,,,,,,2020-01-29T00:00:00Z,,,2020-01-29T00:00:00Z,3,3,3,0,0,0,1,1,e960a515d1779fa15049c5935ab0574e595a87c8
20200128,1,2,0,,,,,,,,,2020-01-28T00:00:00Z,,,2020-01-28T00:00:00Z,2,2,2,0,0,0,0,0,0c443fe4c026a213030f976017c9fa95f115d5a7
20200127,1,2,0,,,,,,,,,2020-01-27T00:00:00Z,,,2020-01-27T00:00:00Z,2,2,2,0,0,0,0,0,3dde2425e73c17b4e6cbf0e4432340298c0a94f5
20200126,1,2,0,,,,,,,,,2020-01-26T00:00:00Z,,,2020-01-26T00:00:00Z,2,2,2,0,0,0,0,0,e1cf59ab48e1cf367c4a6798a508a23d9d36bd18
20200125,1,2,0,,,,,,,,,2020-01-25T00:00:00Z,,,2020-01-25T00:00:00Z,2,2,2,0,0,0,0,0,bef2a1d5f2a13491e0e0369bbd46c10cdd12973b
20200124,1,2,0,,,,,,,,,2020-01-24T00:00:00Z,,,2020-01-24T00:00:00Z,2,2,2,0,0,0,0,0,bfffe76fc0b7cf11efe8aecd3cc7b22598d77d61
20200123,1,2,0,,,,,,,,,2020-01-23T00:00:00Z,,,2020-01-23T00:00:00Z,2,2,2,0,0,0,0,0,cee36ebf3174bf1df0daa36e1e8088a157406fad
20200122,1,2,0,,,,,,,,,2020-01-22T00:00:00Z,,,2020-01-22T00:00:00Z,2,2,2,0,0,0,0,0,d538c99729d1fee626212d1878a100c1e1204a5f
