date,states,positive,negative,pending,hospitalizedCurrently,hospitalizedCumulative,inIcuCurrently,inIcuCumulative,onVentilatorCurrently,onVentilatorCumulative,recovered,dateChecked,death,hospitalized,lastModified,total,totalTestResults,posNeg,deathIncrease,hospitalizedIncrease,negativeIncrease,positiveIncrease,totalTestResultsIncrease,hash
20200914,56,6518306,81042455,10494,29795,387616,6208,18748,1507,2061,2474570,2020-09-14T00:00:00Z,186548,387616,2020-09-14T00:00:00Z,87571255,87560761,87560761,382,937,712651,29853,742504,9b71cf4ad9ece3106fa1393609cae209a29547af
20200913,56,6488453,80329804,10467,29816,386679,6234,18692,1562,2056,2450184,2020-09-13T00:00:00Z,186166,386679,2020-09-13T00:00:00Z,86828724,86818257,86818257,389,592,612437,34453,646890,f6de8b952e5917ae99fb7ce488910d2cb1f32964
20200912,56,6454000,79717367,10403,30662,386087,6454,18648,1619,2051,2438903,2020-09-12T00:00:00Z,185777,386087,2020-09-12T00:00:00Z,86181770,86171367,86171367,810,1076,806722,42087,848809,7637c7501e6ab32fcba3aec3c9e4905910f633d3
20200911,56,6411913,78910645,10813,31421,385011,6379,18549,1715,2031,2417878,2020-09-11T00:00:00Z,184967,385011,2020-09-11T00:00:00Z,85333371,85322558,85322558,1018,1553,721070,44927,765997,97633c7d65f2da5689dc71eecc4eda234aa70e51
20200910,56,6366986,78189575,10530,32419,383458,6524,18453,1925,2008,2403511,2020-09-10T00:00:00Z,183949,383458,2020-09-10T00:00:00Z,84567091,84556561,84556561,1170,1532,576461,37581,614042,9f5d388dd55ac90f6f8e7b31cbd43b419b7469b5
20200909,56,6329405,77613114,6551,32562,381926,6646,18322,1903,1994,2387479,2020-09-09T00:00:00Z,182779,381926,2020-09-09T00:00:00Z,83949070,83942519,83942519,1089,2060,553429,30983,584412,e5c534217742be6f09560d25616f96c0d1915b4c
20200908,56,6298422,77059685,8983,32263,379866,6542,18189,1879,1975,2359111,2020-09-08T00:00:00Z,181690,379866,2020-09-08T00:00:00Z,83367090,83358107,83358107,358,959,486487,22223,508710,c43bc49c6f42a78c85c704d97acdf1044d89bc3b
20200907,56,6276199,76573198,8986,31999,378907,6630,18156,1879,1967,2333583,2020-09-07T00:00:00Z,181332,378907,2020-09-07T00:00:00Z,82858383,82849397,82849397,225,492,559616,28682,588298,51f654802624bb55eeed0c26e2b4515660ddc977
20200906,56,6247517,76013582,8946,32361,378415,6699,18125,1912,1960,2316020,2020-09-06T00:00:00Z,181107,378415,2020-09-06T00:00:00Z,82270045,82261099,82261099,449,489,702709,33117,735826,2b37b7629bd6d06ff59b73ee91322a2bae6f40fa
20200905,56,6214400,75310873,9021,33502,377926,6766,18089,1956,1956,2302203,2020-09-05T00:00:00Z,180658,377926,2020-09-05T00:00:00Z,81534294,81525273,81525273,918,1287,761056,44905,805961,faf4acbb02e71c38879a6a3e691f870f277f81e1
20200904,56,6169495,74549817,10118,34099,376639,6924,18012,1995,1943,2283454,2020-09-04T00:00:00Z,179740,376639,2020-09-04T00:00:00Z,80729430,80719312,80719312,998,1239,850612,51591,902203,0b3c3e55b143f7e1e6c237a2b15b360c02d2bb8f
20200903,56,6117904,73699205,9987,34676,375400,6908,17894,2042,1928,2266957,2020-09-03T00:00:00Z,178742,375400,2020-09-03T00:00:00Z,79827096,79817109,79817109,1070,1536,679230,44714,723944,1fdf6d4ecb35ab7bde872a7b2c8d7884650f4f1e
20200902,56,6073190,73019975,9293,35569,373864,7087,17784,2024,1918,2231757,2020-09-02T00:00:00Z,177672,373864,2020-09-02T00:00:00Z,79102458,79093165,79093165,1032,1647,614433,30603,645036,fa40af3caf61343e440221b214033dd33e993825
20200901,56,6042587,72405542,6647,35271,372217,7090,17655,2042,1902,2202682,2020-09-01T00:00:00Z,176640,372217,2020-09-01T00:00:00Z,78454776,78448129,78448129,1027,1837,656103,42433,698536,d4057e2ae4796422582d593fa37e728c2d998101
20200831,56,6000154,71749439,11128,35349,370380,7051,17537,2077,1877,2184825,2020-08-31T00:00:00Z,175613,370380,2020-08-31T00:00:00Z,77760721,77749593,77749593,366,816,648999,31406,680405,fdd525d01dc887088afc9a7b78e6f8d70fb50ad1
20200830,56,5968748,71100440,11148,35726,369564,7268,17439,2055,1870,2153963,2020-08-30T00:00:00Z,175247,369564,2020-08-30T00:00:00Z,77080336,77069188,77069188,475,680,700008,39501,739509,31d8d94e5e89432259e7949d6bc1e87f233a30ae
20200829,56,5929247,70400432,11151,36469,368884,7426,17401,2062,1864,2140631,2020-08-29T00:00:00Z,174772,368884,2020-08-29T00:00:00Z,76340830,76329679,76329679,1015,1296,719736,44501,764237,2c4619d9dbb291d599c5bca0c0769a6b354be473
20200828,56,5884746,69680696,10428,37239,367588,7558,17304,2086,1856,2118367,2020-08-28T00:00:00Z,173757,367588,2020-08-28T00:00:00Z,75575870,75565442,75565442,1023,1595,725710,46548,772258,d8e18f564d03be1562449665fbab510a9e705f02
20200827,56,5838198,68954986,11168,37464,365993,7717,17181,2125,1831,2101326,2020-08-27T00:00:00Z,172734,365993,2020-08-27T00:00:00Z,74804352,74793184,74793184,1129,1668,698076,43984,742060,b4dac7b4880464e1e1c72ae676be8981b3562400
20200826,56,5794214,68256910,4081,38411,364325,7763,17046,2142,1809,2084465,2020-08-26T00:00:00Z,171605,364325,2020-08-26T00:00:00Z,74055205,74051124,74051124,1298,1873,631672,44053,675725,d65bf6ac8b7ccca45a9800a74a10bbca7824740b
20200825,56,5750161,67625238,4091,38762,362452,7851,16920,2163,1789,2053699,2020-08-25T00:00:00Z,170307,362452,2020-08-25T00:00:00Z,73379490,73375399,73375399,1147,1999,597782,36379,634161,48eb7e269f6a9e8ff120ccef5f4e1c8186421d9f
20200824,56,5713782,67027456,4143,38657,360453,7836,16787,2118,1764,2020774,2020-08-24T00:00:00Z,169160,360453,2020-08-24T00:00:00Z,72745381,72741238,72741238,343,1049,648010,34643,682653,467f6f3979f2b9533c7e2a21c236643ad13fc908
20200823,56,5679139,66379446,4149,39029,359404,7951,16697,2131,1737,1997782,2020-08-23T00:00:00Z,168817,359404,2020-08-23T00:00:00Z,72062734,72058585,72058585,572,774,577947,37566,615513,3cf8fd77008ec1465bd82708a95ee18f3115a3df
20200822,56,5641573,65801499,4154,39911,358630,8218,16657,2204,1736,1985493,2020-08-22T00:00:00Z,168245,358630,2020-08-22T00:00:00Z,71447226,71443072,71443072,1029,1537,710293,46236,756529,cc0412814836c8f1230ce67913b9d8282ad2b266
20200821,56,5595337,65091206,4199,40951,357093,8357,16563,2286,1730,1965056,2020-08-21T00:00:00Z,167216,357093,2020-08-21T00:00:00Z,70690742,70686543,70686543,1123,1817,697054,46561,743615,f3b52fc379a212a22f79b57b11b40ae42efa2fee
20200820,56,5548776,64394152,4170,41988,355276,8483,16487,2335,1716,1946866,2020-08-20T00:00:00Z,166093,355276,2020-08-20T00:00:00Z,69947098,69942928,69942928,1134,2010,634078,43758,677836,839613c0c3147e6d5a64150d0bae44a6e9ab97ff
20200819,56,5505018,63760074,4374,43330,353266,8744,16377,2371,1705,1924875,2020-08-19T00:00:00Z,164959,353266,2020-08-19T00:00:00Z,69269466,69265092,69265092,1420,2032,644823,44955,689778,e1d29bfd462d5ff5ab8f24fdaf2152e99b2759bc
20200818,56,5460063,63115251,4412,43747,351234,8866,16123,2468,1695,1889170,2020-08-18T00:00:00Z,163539,351234,2020-08-18T00:00:00Z,68579726,68575314,68575314,1196,2273,616859,40795,657654,99f2d6421127e8f2eda1312f0705d8c0ff84f5a0
20200817,56,5419268,62498392,4298,43485,348961,8871,15985,2447,1678,1865580,2020-08-17T00:00:00Z,162343,348961,2020-08-17T00:00:00Z,67921958,67917660,67917660,407,1267,625846,37880,663726,950e614bb35ddea7d5474ab0da73a31aeeb82ef4
20200816,56,5381388,61872546,4302,44028,347694,8947,15924,2481,1665,1833096,2020-08-16T00:00:00Z,161936,347694,2020-08-16T00:00:00Z,67258236,67253934,67253934,619,649,740599,42487,783086,9c8ee411f64413694af0500c86b52e443ef24026
20200815,56,5338901,61131947,4452,44794,347045,9101,15891,2526,1663,1818546,2020-08-15T00:00:00Z,161317,347045,2020-08-15T00:00:00Z,66475300,66470848,66470848,1219,2031,693310,56149,749459,438ba2e679bcde794cfcf81347f71e030aed315b
20200814,56,5282752,60438637,4415,45776,345014,9277,15764,2549,1665,1796326,2020-08-14T00:00:00Z,160098,345014,2020-08-14T00:00:00Z,65725804,65721389,65721389,1216,2212,798904,55636,854540,8997f19194ece1ae759c3cd71f5274ecc5b73b11
20200813,56,5227116,59639733,4239,47228,342802,9489,15629,2579,1649,1774648,2020-08-13T00:00:00Z,158882,342802,2020-08-13T00:00:00Z,64871088,64866849,64866849,1163,2685,843535,51759,895294,b01459384df52296b6fb8a5621283b6e8e84941a
20200812,56,5175357,58796198,4174,47968,340117,9553,15524,2604,1629,1755225,2020-08-12T00:00:00Z,157719,340117,2020-08-12T00:00:00Z,63975729,63971555,63971555,1517,3055,439024,56134,495158,7ccad886fe01cb06857b3f3a4194fb25bc45797f
20200811,56,5119223,58357174,4118,48498,337062,9136,15331,2415,1612,1714960,2020-08-11T00:00:00Z,156202,337062,2020-08-11T00:00:00Z,63480515,63476397,63476397,1326,2715,698757,55701,754458,b9e2da6bb6f529ef16f50f3554c9b0c74efd60ce
20200810,56,5063522,57658417,3966,48635,334347,9216,15158,2533,1592,1670755,2020-08-10T00:00:00Z,154876,334347,2020-08-10T00:00:00Z,62725905,62721939,62721939,426,1654,693402,42089,735491,e624112ff7b43604709ce006905c078a58ac906f
20200809,56,5021433,56965015,3871,48902,332693,9303,15081,2507,1578,1656888,2020-08-09T00:00:00Z,154450,332693,2020-08-09T00:00:00Z,61990319,61986448,61986448,616,855,666939,50627,717566,7843b033e8b4463fba63a02a3a93fde9a33a367c
20200808,56,4970806,56298076,3888,49884,331838,9654,15024,2566,1561,1643137,2020-08-08T00:00:00Z,153834,331838,2020-08-08T00:00:00Z,61272770,61268882,61268882,1089,1414,621980,53712,675692,b959a436cd1a53e2f830ee42037e0938baa79e61
20200807,56,4917094,55676096,3988,51153,330424,9671,14925,2617,1549,1623870,2020-08-07T00:00:00Z,152745,330424,2020-08-07T00:00:00Z,60597178,60593190,60593190,1333,8036,715719,61345,777064,ee0fac229516b5f92dc5d9b0abb2010bab9121f0
20200806,56,4855749,54960377,3903,53053,322388,9977,14810,2718,1534,1598624,2020-08-06T00:00:00Z,151412,322388,2020-08-06T00:00:00Z,59820029,59816126,59816126,1251,2682,691399,54187,745586,fa0642a1ae5919c8058fe4aaadd63d662c1f85c9
20200805,56,4801562,54268978,3842,53281,319706,9970,14687,2719,1524,1577851,2020-08-05T00:00:00Z,150161,319706,2020-08-05T00:00:00Z,59074382,59070540,59070540,1346,2269,643615,52324,695939,2a5867bc5582051381316dad92aa2c8f7d0a4085
20200804,56,4749238,53625363,3789,53293,317437,10208,14537,2701,1493,1528979,2020-08-04T00:00:00Z,148815,317437,2020-08-04T00:00:00Z,58378390,58374601,58374601,1255,4490,659553,51866,711419,2e81c48fc0caaa68f45646efdc3b7e62fca48aa7
20200803,56,4697372,52965810,3662,53326,312947,10216,14370,2659,1463,1513446,2020-08-03T00:00:00Z,147560,312947,2020-08-03T00:00:00Z,57666844,57663182,57663182,519,1724,692703,49713,742416,ca6a287ce9af100a3d8342d870cc359df35e840c
20200802,56,4647659,52273107,3888,53931,311223,10405,14288,2645,1448,1468689,2020-08-02T00:00:00Z,147041,311223,2020-08-02T00:00:00Z,56924654,56920766,56920766,498,817,643326,46812,690138,167e8af6a1eca9131a95c9e23708e3db25fe8427
20200801,56,4600847,51629781,3975,54412,310406,10428,14227,2698,1445,1461885,2020-08-01T00:00:00Z,146543,310406,2020-08-01T00:00:00Z,56234603,56230628,56230628,1190,2318,673904,61101,735005,fb38f437816134d9d039b662797af9de5bb9adaa
20200731,56,4539746,50955877,3956,55540,308088,10472,14044,2703,1437,1438160,2020-07-31T00:00:00Z,145353,308088,2020-07-31T00:00:00Z,55499579,55495623,55495623,1312,2627,657827,67623,725450,60cbf5fdacc788e3e211f97c2295dff178f077af
20200730,56,4472123,50298050,3947,56381,305461,10513,13875,2760,1415,1413957,2020-07-30T00:00:00Z,144041,305461,2020-07-30T00:00:00Z,54774120,54770173,54770173,1259,3383,737950,69418,807368,4e88430a05946ea05390cfad75a37be5f4ba9ae9
20200729,56,4402705,49560100,3840,57339,302078,10539,13744,2772,1400,1390568,2020-07-29T00:00:00Z,142782,302078,2020-07-29T00:00:00Z,53966645,53962805,53962805,1492,2934,789712,66963,856675,d3bce0be0d12c57de835c8a8900b5856c46686de
20200728,56,4335742,48770388,3600,57091,299144,10463,13559,2752,1372,1355363,2020-07-28T00:00:00Z,141290,299144,2020-07-28T00:00:00Z,53109730,53106130,53106130,1122,4672,681181,56448,737629,8cd51c0113cf6485ac21bc34eb8fe33bcdfbc1b6
20200727,56,4279294,48089207,3398,58897,294472,10328,13412,2720,1356,1325804,2020-07-27T00:00:00Z,140168,294472,2020-07-27T00:00:00Z,52371899,52368501,52368501,1060,1690,707142,55332,762474,fc7654a5ecdd98af9b3bf3cb13de84abc3bf0b5d
20200726,56,4223962,47382065,3361,58621,292782,10353,13343,2723,1336,1297863,2020-07-26T00:00:00Z,139108,292782,2020-07-26T00:00:00Z,51609388,51606027,51606027,559,1435,780054,61000,841054,3f58d718981bc9bdb830421924c4e87fe165f68b
20200725,56,4162962,46602011,3377,59301,291347,10380,13279,2729,1300,1279414,2020-07-25T00:00:00Z,138549,291347,2020-07-25T00:00:00Z,50768350,50764973,50764973,1023,1977,715969,64741,780710,471f3c74f1d0d36d7e3f81cee05f0f52d25dc272
20200724,56,4098221,45886042,3409,59682,289370,10395,13182,2711,1297,1261624,2020-07-24T00:00:00Z,137526,289370,2020-07-24T00:00:00Z,49987672,49984263,49984263,1176,3032,851205,75236,926441,a3528defd3b020d6b1975e035c10a4b8bd51f7c1
20200723,56,4022985,45034837,3179,59718,286338,10414,12933,2465,1280,1233269,2020-07-23T00:00:00Z,136350,286338,2020-07-23T00:00:00Z,49061001,49057822,49057822,1056,2509,769521,71552,841073,6291d08f190652048764cb08e5e1e00201da8bd2
20200722,56,3951433,44265316,3051,59596,283829,10457,12790,2440,1258,1210849,2020-07-22T00:00:00Z,135294,283829,2020-07-22T00:00:00Z,48219800,48216749,48216749,1171,2248,727105,69333,796438,cb44c4378ea2f1ee2d66b28148de9494b1b274fd
20200721,56,3882100,43538211,3197,59364,281581,6711,12629,2414,1242,1182931,2020-07-21T00:00:00Z,134123,281581,2020-07-21T00:00:00Z,47423508,47420311,47420311,1039,2551,686361,63930,750291,56d789c82880688fc2204edca7baa248bb842796
20200720,56,3818170,42851850,3003,58371,279030,6558,12475,2403,1223,1160087,2020-07-20T00:00:00Z,133084,279030,2020-07-20T00:00:00Z,46673023,46670020,46670020,363,1647,654148,57041,711189,235f7f364d6a888f4779701b65dbabc24c3f4a6d
20200719,56,3761129,42197702,3052,57885,277383,6384,12393,2362,1216,1131171,2020-07-19T00:00:00Z,132721,277383,2020-07-19T00:00:00Z,45961883,45958831,45958831,527,944,715331,64260,779591,00e7da687b55c137c7127b4e704a7bffe50a7761
20200718,56,3696869,41482371,3032,57645,276439,6396,12342,2343,1211,1122720,2020-07-18T00:00:00Z,132194,276439,2020-07-18T00:00:00Z,45182272,45179240,45179240,872,2003,691886,64951,756837,7bd3fe3321d2fe3e25f7a8e43de0c811e1be3820
20200717,56,3631918,40790485,3002,57761,274436,6453,12243,2353,1200,1106844,2020-07-17T00:00:00Z,131322,274436,2020-07-17T00:00:00Z,44425405,44422403,44422403,951,2678,757657,76842,834499,d9239394b561468c416478970e59025ad556c6fd
20200716,56,3555076,40032828,2929,57442,271758,6359,12091,2317,1175,1090645,2020-07-16T00:00:00Z,130371,271758,2020-07-16T00:00:00Z,43590833,43587904,43587904,947,2215,756287,71036,827323,96eea55aa55043be885c33b6bcde57964a6522c2
20200715,56,3484040,39276541,2947,56144,269543,6317,12002,2317,1166,1075882,2020-07-15T00:00:00Z,129424,269543,2020-07-15T00:00:00Z,42763528,42760581,42760581,858,2416,703090,65797,768887,fae055a9cec2ef52891ead29c292501257c6ef37
20200714,56,3418243,38573451,960,55565,267127,6235,11857,2263,1154,1049098,2020-07-14T00:00:00Z,128566,267127,2020-07-14T00:00:00Z,41992654,41991694,41991694,736,2262,702900,62729,765629,b596d083cac1396bea227b8bc19c607fd0769c4b
20200713,56,3355514,37870551,2610,53988,264865,6074,11749,2259,1142,1031939,2020-07-13T00:00:00Z,127830,264865,2020-07-13T00:00:00Z,41228675,41226065,41226065,327,1214,636500,58091,694591,cfe151573e17d41dfa91b8eb89bcc83577182cd8
20200712,56,3297423,37234051,2639,52727,263651,5930,11679,2182,1136,1006326,2020-07-12T00:00:00Z,127503,263651,2020-07-12T00:00:00Z,40534113,40531474,40531474,476,939,702394,61312,763706,692f1ea398e081c6513840caf942a7c67c144d9a
20200711,56,3236111,36531657,2618,51859,262712,5939,11612,2169,1128,995576,2020-07-11T00:00:00Z,127027,262712,2020-07-11T00:00:00Z,39770386,39767768,39767768,757,5141,637755,62895,700650,02af56fcabe461e2000b5fae05e4cd0f9a97f659
20200710,56,3173216,35893902,2493,51595,257571,5896,11523,2197,1118,983185,2020-07-10T00:00:00Z,126270,257571,2020-07-10T00:00:00Z,39069611,39067118,39067118,854,2318,742929,66846,809775,63379105c335642987d0671b129e8a91ea53547b
20200709,56,3106370,35150973,2530,43934,255253,5845,11370,2127,1138,969111,2020-07-09T00:00:00Z,125416,255253,2020-07-09T00:00:00Z,38259873,38257343,38257343,867,1719,646844,59157,706001,0aed7f7a40f0567e1a07adfbd4939c657850d7d7
20200708,56,3047213,34504129,2360,43078,253534,5874,11303,2172,1103,953420,2020-07-08T00:00:00Z,124549,253534,2020-07-08T00:00:00Z,37553702,37551342,37551342,807,2035,575559,62672,638231,afa4a06a54d362f6d5dbb1c792ea449ba98f1ade
20200707,56,2984541,33928570,2136,41760,251499,5832,11177,2098,1084,936476,2020-07-07T00:00:00Z,123742,251499,2020-07-07T00:00:00Z,36915247,36913111,36913111,923,1960,584171,51728,635899,c405972b5ce2a0fabb9e788e6eb6dadce216a3ac
20200706,56,2932813,33344399,1907,39768,249539,5684,11058,2105,1070,924148,2020-07-06T00:00:00Z,122819,249539,2020-07-06T00:00:00Z,36279119,36277212,36277212,243,794,471602,41918,513520,a84c6500073dff80cf87308f8a876764e229c5f2
20200705,56,2890895,32872797,1885,38764,248745,5653,11010,2080,1064,902558,2020-07-05T00:00:00Z,122576,248745,2020-07-05T00:00:00Z,35765577,35763692,35763692,209,590,633339,45612,678951,e8fb83f9b4439d4cfd9aa046eea8a022c750cb08
20200704,56,2845283,32239458,2083,38146,248155,5633,10977,1982,1063,894325,2020-07-04T00:00:00Z,122367,248155,2020-07-04T00:00:00Z,35086824,35084741,35084741,306,871,577481,54338,631819,394348b4da950483dd60d074a7316defeda96619
20200703,56,2790945,31661977,2237,37798,247284,5597,10936,2049,1059,883561,2020-07-03T00:00:00Z,122061,247284,2020-07-03T00:00:00Z,34455159,34452922,34452922,598,1435,654043,53948,707991,a6e3e2844e96f457b6597c664485dd2c8eeab52c
20200702,56,2736997,31007934,2208,37500,245849,5626,10843,2105,1041,875127,2020-07-02T00:00:00Z,121463,245849,2020-07-02T00:00:00Z,33747139,33744931,33744931,695,2003,608354,54085,662439,f20073449d2efb985db78921551cdd27ce4e7056
20200701,56,2682912,30399580,2604,36405,243846,5512,10752,2098,1027,823151,2020-07-01T00:00:00Z,120768,243846,2020-07-01T00:00:00Z,33085096,33082492,33082492,701,1438,589398,50981,640379,001c9553dae256b7418fd3341e0e60d61ca471f6
20200630,56,2631931,29810182,2432,35248,242408,5424,10669,2044,1008,813788,2020-06-30T00:00:00Z,120067,242408,2020-06-30T00:00:00Z,32444545,32442113,32442113,596,1582,580152,47864,628016,39ef11031d84d9dc13c4fb2f49860368948d56ff
20200629,56,2584067,29230030,2194,33586,240826,5380,10542,2011,990,798360,2020-06-29T00:00:00Z,119471,240826,2020-06-29T00:00:00Z,31816291,31814097,31814097,332,670,615988,39813,655801,229db5705c8e24941167efb70af8fe62a4473025
20200628,56,2544254,28614042,2198,32476,240156,5248,10473,2077,983,778321,2020-06-28T00:00:00Z,119139,240156,2020-06-28T00:00:00Z,31160494,31158296,31158296,271,580,535806,41570,577376,f592f01e127e7d19a6b271b10df19205dda4af3e
20200627,56,2502684,28078236,2186,32483,239576,5315,10415,2159,977,772465,2020-06-27T00:00:00Z,118868,239576,2020-06-27T00:00:00Z,30583106,30580920,30580920,511,1057,555647,43164,598811,40a9436bd875871310ac6103e0b3422dde35f7b4
20200626,56,2459520,27522589,2201,31738,238519,5283,10334,2075,966,763966,2020-06-26T00:00:00Z,118357,238519,2020-06-26T00:00:00Z,29984310,29982109,29982109,637,1526,565494,44543,610037,e4ef645073b1e2eda5e58d8739be8e1eb560f88b
20200625,56,2414977,26957095,2133,31844,236993,5319,10257,2214,951,756719,2020-06-25T00:00:00Z,117720,236993,2020-06-25T00:00:00Z,29374205,29372072,29372072,647,1257,602693,39640,642333,4f487931f52d256b722358cc38d44fb779f10d8c
20200624,56,2375337,26354402,2049,31102,235736,5293,10173,2248,934,747565,2020-06-24T00:00:00Z,117073,235736,2020-06-24T00:00:00Z,28731788,28729739,28729739,724,1310,485049,39072,524121,d527d3179f7f38102c82bbc1170998ea66d2739a
20200623,56,2336265,25869353,1891,30235,234426,5402,10077,2293,918,738952,2020-06-23T00:00:00Z,116349,234426,2020-06-23T00:00:00Z,28207509,28205618,28205618,710,1257,469104,33447,502551,bcef4e5fef2b1e3ede021c22d5fef32192846ffe
20200622,56,2302818,25400249,2028,28799,233169,5323,10002,2299,909,731602,2020-06-22T00:00:00Z,115639,233169,2020-06-22T00:00:00Z,27705095,27703067,27703067,286,800,444089,27281,471370,5d996c6c5815278458eb7b1f6cf5e9c265cccb61
20200621,56,2275537,24956160,2084,28219,232369,5195,9944,2321,904,713537,2020-06-21T00:00:00Z,115353,232369,2020-06-21T00:00:00Z,27233781,27231697,27231697,294,514,496049,27928,523977,0774dbfeab04428f6942f2e5a5970bd5fd0622d5
20200620,56,2247609,24460111,2108,27967,231855,5229,9908,2380,888,708864,2020-06-20T00:00:00Z,115059,231855,2020-06-20T00:00:00Z,26709828,26707720,26707720,629,745,533304,32294,565598,f6e64e807baf819d309f0af844e690972af10af2
20200619,56,2215315,23926807,2032,28615,231110,5341,9876,2434,884,698119,2020-06-19T00:00:00Z,114430,231110,2020-06-19T00:00:00Z,26144154,26142122,26142122,655,1613,548107,31471,579578,4333a11e0aa616f1e04ba47351f86948a5280eec
20200618,56,2183844,23378700,1903,28414,229497,5465,9736,2520,869,690692,2020-06-18T00:00:00Z,113775,229497,2020-06-18T00:00:00Z,25564447,25562544,25562544,705,1040,491625,27746,519371,b6fd8f095bbaae261a43520b9a57491ec9cc1404
20200617,56,2156098,22887075,1745,28573,228457,5613,9665,2588,857,680916,2020-06-17T00:00:00Z,113070,228457,2020-06-17T00:00:00Z,25044918,25043173,25043173,767,1130,463168,24001,487169,5fab9e069369bdbf0dc57053e0bf5c37db54270c
20200616,56,2132097,22423907,1604,28270,227327,5570,9590,2594,845,672228,2020-06-16T00:00:00Z,112303,227327,2020-06-16T00:00:00Z,24557608,24556004,24556004,730,1301,442650,23497,466147,154b286a852b8e9b7146f5d6c887e53b92ba4e1c
20200615,56,2108600,21981257,1619,27867,226026,5703,9516,2640,835,665059,2020-06-15T00:00:00Z,111573,226026,2020-06-15T00:00:00Z,24091476,24089857,24089857,381,543,415390,18630,434020,fe04f3d3d23df52a10e5cf6057965ee832e6f0a1
20200614,56,2089970,21565867,1672,27893,225483,5749,9466,2716,834,650541,2020-06-14T00:00:00Z,111192,225483,2020-06-14T00:00:00Z,23657509,23655837,23655837,356,640,464154,21399,485553,9aa1069db6f64e3a5c853f9fb28c7fea8e3e5a8c
20200613,56,2068571,21101713,1698,28450,224843,5883,9430,2726,830,645331,2020-06-13T00:00:00Z,110836,224843,2020-06-13T00:00:00Z,23171982,23170284,23170284,694,1105,471388,25376,496764,437fe2c1e873809583d780a044b2d04b6b3e1cec
20200612,56,2043195,20630325,1783,29154,223738,6017,9373,2734,814,636111,2020-06-12T00:00:00Z,110142,223738,2020-06-12T00:00:00Z,22675303,22673520,22673520,775,1245,599972,23597,623569,99e19227e5882afbc98dcfcb48c23e36fe10f2a7
20200611,56,2019598,20030353,1816,29698,222493,6074,9295,2886,792,629017,2020-06-11T00:00:00Z,109367,222493,2020-06-11T00:00:00Z,22051767,22049951,22049951,899,1367,438062,22153,460215,754a63818ddc87e6bd0a27b05c89700b6c85309c
20200610,56,1997445,19592291,1737,30864,221126,6249,9225,3020,780,618125,2020-06-10T00:00:00Z,108468,221126,2020-06-10T00:00:00Z,21591473,21589736,21589736,887,1484,408971,20894,429865,c564cb23af3ce73a06d6546fe491c482dad79e07
20200609,56,1976551,19183320,1661,31183,219642,6457,9141,3090,771,609476,2020-06-09T00:00:00Z,107581,219642,2020-06-09T00:00:00Z,21161532,21159871,21159871,902,1527,404379,17312,421691,908767d8e532413b4f981ab39e80c4d6aff58194
20200608,56,1959239,18778941,1606,31202,218115,6402,9013,3240,762,603143,2020-06-08T00:00:00Z,106679,218115,2020-06-08T00:00:00Z,20739786,20738180,20738180,661,714,380221,17209,397430,ad38e92be0cd96a77028117e3da85b4c472fa2bf
20200607,56,1942030,18398720,1733,31408,217401,6501,8957,3298,753,590988,2020-06-07T00:00:00Z,106018,217401,2020-06-07T00:00:00Z,20342483,20340750,20340750,447,685,404383,18740,423123,66674756e831ab42b325c450259d16de3c3340d2
20200606,56,1923290,17994337,1796,31938,216716,6762,8920,3476,750,585470,2020-06-06T00:00:00Z,105571,216716,2020-06-06T00:00:00Z,19919423,19917627,19917627,728,1017,521778,23064,544842,f6ae8bdf041ad9de7fb841e82829953b86e6754a
20200605,56,1900226,17472559,1749,32451,215699,6920,8863,3523,740,576327,2020-06-05T00:00:00Z,104843,215699,2020-06-05T00:00:00Z,19374534,19372785,19372785,826,1440,484686,23400,508086,14299b92db8f5710c3c3c55c411c3ea1f2455db7
20200604,56,1876826,16987873,3474,32835,214259,7057,8787,3665,723,569623,2020-06-04T00:00:00Z,104017,214259,2020-06-04T00:00:00Z,18868173,18864699,18864699,893,-2841,441895,20880,462775,ba6d82bc93b7e2cbd5a6314cebfb73ba25a74e51
20200603,56,1855946,16545978,3556,33269,217100,7227,8688,3749,717,557366,2020-06-03T00:00:00Z,103124,217100,2020-06-03T00:00:00Z,18405480,18401924,18401924,993,2255,448319,20392,468711,03720da6571ccca363d4389b9e3dd5aeb3bddedf
20200602,56,1835554,16097659,4054,33933,214845,7407,8566,3852,710,541976,2020-06-02T00:00:00Z,102131,214845,2020-06-02T00:00:00Z,17937267,17933213,17933213,962,1585,400600,20110,420710,6d5a9ac952b41d4638d75101731fd017c4b84666
20200601,56,1815444,15697059,3455,34285,213260,7591,8485,3950,704,536339,2020-06-01T00:00:00Z,101169,213260,2020-06-01T00:00:00Z,17515958,17512503,17512503,668,2796,393669,20482,414151,cf21a7f0d585d1b1bbfd099eab6525e847b67e80
20200531,56,1794962,15303390,3270,34859,210464,7626,8445,3669,704,522866,2020-05-31T00:00:00Z,100501,210464,2020-05-31T00:00:00Z,17101622,17098352,17098352,652,976,375191,21558,396749,d5ed8539f54f547ce95a1a1440f5a22db3e4fda6
20200530,56,1773404,14928199,1668,35732,209488,7956,8305,4004,698,494569,2020-05-30T00:00:00Z,99849,209488,2020-05-30T00:00:00Z,16703271,16701603,16701603,932,1424,402861,23682,426543,8f0ee27b9f7a34ccf03137d4506c29081bf10c58
20200529,56,1749722,14525338,2978,36999,208064,8175,8235,4032,689,484554,2020-05-29T00:00:00Z,98917,208064,2020-05-29T00:00:00Z,16278038,16275060,16275060,1184,1715,465104,23574,488678,e101f1620f2c15fd5008e055da84d11494bb10eb
20200528,56,1726148,14060234,1906,38069,206349,8389,8109,4080,676,478099,2020-05-28T00:00:00Z,97733,206349,2020-05-28T00:00:00Z,15788288,15786382,15786382,1231,1630,413429,22630,436059,9c9f22e38259e659168b76c97598d519e56d728e
20200527,56,1703518,13646805,3132,38373,204719,8547,8015,4222,666,391508,2020-05-27T00:00:00Z,96502,204719,2020-05-27T00:00:00Z,15353455,15350323,15350323,1321,1713,290562,19437,309999,988508e3b7fb39c4f48cd35b5e8ea394007d9f51
20200526,56,1684081,13356243,1549,37779,203006,8585,7899,4215,650,384902,2020-05-26T00:00:00Z,95181,203006,2020-05-26T00:00:00Z,15041873,15040324,15040324,645,17320,291055,16830,307885,af99beca94a0acc8f298a8a85cd0e63894ff5651
20200525,56,1667251,13065188,3368,37650,185686,8472,7847,4237,642,379157,2020-05-25T00:00:00Z,94536,185686,2020-05-25T00:00:00Z,14735807,14732439,14732439,559,1002,404718,18691,423409,0b8726fdb21e89158ce5e3391768d2bed35e33e9
20200524,56,1648560,12660470,3860,37695,184684,8487,7801,4383,639,366736,2020-05-24T00:00:00Z,93977,184684,2020-05-24T00:00:00Z,14312890,14309030,14309030,680,921,361940,20047,381987,e982c0093d61707decb10c4d01bc538c39349a14
20200523,56,1628513,12298530,4084,38614,183763,8733,7770,4620,638,361239,2020-05-23T00:00:00Z,93297,183763,2020-05-23T00:00:00Z,13931127,13927043,13927043,1063,1378,369149,21531,390680,6ef5dc76d08c8256e96dbca9a21dc1fa1d81a800
20200522,56,1606982,11929381,3709,39989,182385,9048,7689,4716,633,350135,2020-05-22T00:00:00Z,92234,182385,2020-05-22T00:00:00Z,13540072,13536363,13536363,1341,4046,385791,24555,410346,aed67643d0e6b52fe091acee673ff2259edae3e3
20200521,56,1582427,11543590,3641,41191,178339,9090,7412,4868,616,298418,2020-05-21T00:00:00Z,90893,178339,2020-05-21T00:00:00Z,13129658,13126017,13126017,1394,4630,436275,26566,462841,7d17e70c69979377c8521fc2aa1dbe894180979a
20200520,56,1555861,11107315,2973,41762,173709,9522,7319,4911,613,294312,2020-05-20T00:00:00Z,89499,173709,2020-05-20T00:00:00Z,12666149,12663176,12663176,1399,1996,387243,21318,408561,c6d4aaf926f859614e3df22df5643a6763e51a2f
20200519,56,1534543,10720072,2944,41872,171713,9597,7217,5032,606,289484,2020-05-19T00:00:00Z,88100,171713,2020-05-19T00:00:00Z,12257559,12254615,12254615,1326,1597,381974,20899,402873,37fac10a239ca5f6f58deab82f06f637ab003941
20200518,56,1513644,10338098,3596,41748,170116,9755,7064,5257,602,283178,2020-05-18T00:00:00Z,86774,170116,2020-05-18T00:00:00Z,11855338,11851742,11851742,848,1157,335177,21016,356193,7994a88b8ee4c60ab87913d863a8de95cbab8c34
20200517,56,1492628,10002921,3449,41785,168959,9932,7003,5467,593,272265,2020-05-17T00:00:00Z,85926,168959,2020-05-17T00:00:00Z,11498998,11495549,11495549,849,1199,351570,20034,371604,852e2e1d1052046105477774fe23baf2531aca04
20200516,56,1472594,9651351,3788,43396,167760,10277,6945,5529,592,268376,2020-05-16T00:00:00Z,85077,167760,2020-05-16T00:00:00Z,11127733,11123945,11123945,988,1856,338158,24678,362836,5a9d569e07206f3a24602c0885b7ed172ef491b5
20200515,56,1447916,9313193,2457,44491,165904,10472,6890,5746,589,250747,2020-05-15T00:00:00Z,84089,165904,2020-05-15T00:00:00Z,10763566,10761109,10761109,1507,1353,334713,24684,359397,255ef35b55e7e9faa051741f3c0e8c2def0b1302
20200514,56,1423232,8978480,2673,45790,164551,10656,6795,5940,582,246414,2020-05-14T00:00:00Z,82582,164551,2020-05-14T00:00:00Z,10404385,10401712,10401712,1880,3206,338711,26798,365509,92c5f560a0da3c8328a1d83d012e094abd4d56e7
20200513,56,1396434,8639769,1983,46926,161345,10978,6713,6156,572,243430,2020-05-13T00:00:00Z,80702,161345,2020-05-13T00:00:00Z,10038186,10036203,10036203,1704,1809,299164,21272,320436,4345580f1097c2c7a62d6af6ebe89b133490cd1b
20200512,56,1375162,8340605,1803,47596,159536,11241,5595,6352,559,238857,2020-05-12T00:00:00Z,78998,159536,2020-05-12T00:00:00Z,9717570,9715767,9715767,1486,1579,286983,22701,309684,eb440d54ed95410a8176871e5e5cb3ae62af2b13
20200511,56,1352461,8053622,1989,46552,157957,11147,6488,6350,551,232142,2020-05-11T00:00:00Z,77512,157957,2020-05-11T00:00:00Z,9408072,9406083,9406083,892,1238,365238,18239,383477,6e9d764e8df0742670a8fbe9ef89c714a4041b2f
20200510,56,1334222,7688384,3095,47163,156719,11393,6445,6395,547,215591,2020-05-10T00:00:00Z,76620,156719,2020-05-10T00:00:00Z,9025701,9022606,9022606,1036,1055,245353,21391,266744,cb40fed825feb5ee2d8284ce57b06a7276fc39c0
20200509,56,1312831,7443031,3054,48768,155664,11496,6367,6551,543,211976,2020-05-09T00:00:00Z,75584,155664,2020-05-09T00:00:00Z,8758916,8755862,8755862,1445,1708,267236,24788,292024,4ad319d11c377e29c3381a20611d997343d9d986
20200508,56,1288043,7175795,3307,49992,153956,11780,6294,6788,531,198459,2020-05-08T00:00:00Z,74139,153956,2020-05-08T00:00:00Z,8467145,8463838,8463838,1798,6892,271123,27647,298770,a073807bf9a42e358f24513e2218241168ac3b02
20200507,56,1260396,6904672,3171,51683,147064,12137,5174,7070,529,194528,2020-05-07T00:00:00Z,72341,147064,2020-05-07T00:00:00Z,8168239,8165068,8165068,2752,3742,275015,27560,302575,eb954d1dfafa0645219dcc9aae8498c493d2a51d
20200506,56,1232836,6629657,2742,52773,143322,12478,4911,4753,449,189425,2020-05-06T00:00:00Z,69589,143322,2020-05-06T00:00:00Z,7865235,7862493,7862493,1950,2119,220849,25096,245945,411d9477c56c683eea5a9dbb874dfe0cd8c487af
20200505,56,1207740,6408808,2633,53455,141203,12629,4794,4818,439,189336,2020-05-05T00:00:00Z,67639,141203,2020-05-05T00:00:00Z,7619181,7616548,7616548,2452,1983,250081,22446,272527,ca8bb8c741913a551dd8fb9b2e3d95c19535f551
20200504,56,1185294,6158727,2791,52634,139220,12696,4579,4848,430,186752,2020-05-04T00:00:00Z,65187,139220,2020-05-04T00:00:00Z,7346812,7344021,7344021,1035,1651,209668,22646,232314,db325338dd0497af0f5429cf1d4f3b84ffe0cd41
20200503,56,1162648,5949059,2812,52857,137569,12722,4502,4761,425,179733,2020-05-03T00:00:00Z,64152,137569,2020-05-03T00:00:00Z,7114519,7111707,7111707,1231,1963,211117,25707,236824,3fb1a3eb73037dc7fe0e9ee09b4170d6028a6631
20200502,56,1136941,5737942,1578,54278,135606,12904,4386,4845,375,174987,2020-05-02T00:00:00Z,62921,135606,2020-05-02T00:00:00Z,6876461,6874883,6874883,1564,2031,218321,29148,247469,cc8787423429be56479fe577d0c815bcc45cc9eb
20200501,56,1107793,5519621,1639,55122,133575,12845,4300,4707,376,163644,2020-05-01T00:00:00Z,61357,133575,2020-05-01T00:00:00Z,6629053,6627414,6627414,1777,9789,263100,33029,296129,d6ea4f79d8f2e14a4e32a72131f2f1054e103290
20200430,56,1074764,5256521,2775,55114,123786,13255,4192,4712,373,154648,2020-04-30T00:00:00Z,59580,123786,2020-04-30T00:00:00Z,6334060,6331285,6331285,2140,2290,203903,29549,233452,cb9b828cd51b47e55526381d245e85ea951366fc
20200429,56,1045215,5052618,4832,56206,121496,13535,4093,4796,365,147165,2020-04-29T00:00:00Z,57440,121496,2020-04-29T00:00:00Z,6102665,6097833,6097833,2713,3415,212653,26725,239378,b3e7200c1b637b1eb8584588e1662051d9c102bb
20200428,56,1018490,4839965,4206,56255,118081,13562,3798,4760,195,139041,2020-04-28T00:00:00Z,54727,118081,2020-04-28T00:00:00Z,5862661,5858455,5858455,2072,2079,181953,25282,207235,999763bd5962dcb828676dfe2ffdcf0b1df3726e
20200427,56,993208,4658012,4077,56191,116002,13812,3720,4867,195,121323,2020-04-27T00:00:00Z,52655,116002,2020-04-27T00:00:00Z,5655297,5651220,5651220,1270,3076,173380,22700,196080,263ea3f40df9526aa88d38a84306f0e51d4dcc7f
20200426,56,970508,4484632,4445,56186,112926,14099,2571,5121,227,116529,2020-04-26T00:00:00Z,51385,112926,2020-04-26T00:00:00Z,5459585,5455140,5455140,1214,2192,179284,27311,206595,ea1542909e027c1618cbc8fa53799754b83a5e03
20200425,56,943197,4305348,5315,57377,110734,14414,2516,5266,227,112539,2020-04-25T00:00:00Z,50171,110734,2020-04-25T00:00:00Z,5253860,5248545,5248545,1748,2456,240717,35871,276588,23016e19d95cf1dfe596ce8b3a50894832978c2a
20200424,56,907326,4064631,4396,57300,108278,14602,2468,5187,227,101296,2020-04-24T00:00:00Z,48423,108278,2020-04-24T00:00:00Z,4976353,4971957,4971957,1895,2338,202285,34238,236523,933bff0142504b2b0806a2c2b91e31c35fa13078
20200423,56,873088,3862346,4258,58989,105940,14744,2428,5464,227,96921,2020-04-23T00:00:00Z,46528,105940,2020-04-23T00:00:00Z,4739692,4735434,4735434,1791,2802,161630,31807,193437,3ca8c66e2e8f5ef38f4209a314b5bdb121dd6461
20200422,56,841281,3700716,4191,59205,103138,15015,2370,5474,227,92978,2020-04-22T00:00:00Z,44737,103138,2020-04-22T00:00:00Z,4546188,4541997,4541997,2098,3087,295229,28955,324184,fdd80678ab1fc25c3df80b867539174ae2bcd9b0
20200421,56,812326,3405487,3956,59780,100051,14941,2315,5514,214,72842,2020-04-21T00:00:00Z,42639,100051,2020-04-21T00:00:00Z,4221769,4217813,4217813,2467,2682,127063,26361,153424,a7dc2be0aee5dd7ac8678771d80e11799cb4ade5
20200420,56,785965,3278424,4037,56783,97369,14489,2193,5567,214,69493,2020-04-20T00:00:00Z,40172,97369,2020-04-20T00:00:00Z,4068426,4064389,4064389,1798,2211,120369,25899,146268,560980a9ea0de6e9724e6f57a03f1c70766152b0
20200419,56,760066,3158055,11324,56526,95158,14410,2145,5603,214,67205,2020-04-19T00:00:00Z,38374,95158,2020-04-19T00:00:00Z,3929445,3918121,3918121,1772,2239,126832,27387,154219,1fc9c2a98484f476799c9043ddba872440644a0c
20200418,56,732679,3031223,9906,57761,92919,14768,2096,5729,205,62840,2020-04-18T00:00:00Z,36602,92919,2020-04-18T00:00:00Z,3773808,3763902,3763902,1893,3563,118251,27906,146157,22b41490f06a563f42ea095067a82d423a4f6af1
20200417,56,704773,2912972,10889,58895,89356,14890,2052,6096,148,53533,2020-04-17T00:00:00Z,34709,89356,2020-04-17T00:00:00Z,3628634,3617745,3617745,2120,3405,127342,32013,159355,8ced12801ff695209c3781d131eb23f32fcc5ccf
20200416,56,672760,2785630,16927,59499,85951,15130,1834,5940,137,48851,2020-04-16T00:00:00Z,32589,85951,2020-04-16T00:00:00Z,3475317,3458390,3458390,2200,3071,133173,30979,164152,c25f5dca2d9b3a77292fa794414e1283851cc123
20200415,56,641781,2652457,16901,59940,82880,14647,1783,6032,223,43435,2020-04-15T00:00:00Z,30389,82880,2020-04-15T00:00:00Z,3311139,3294238,3294238,2544,4434,107024,30309,137333,3aca08895d41f43014587cfc7739f8582d3925dc
20200414,56,611472,2545433,16615,59601,78446,14039,1715,5975,221,39268,2020-04-14T00:00:00Z,27845,78446,2020-04-14T00:00:00Z,3173520,3156905,3156905,2336,3282,126412,25709,152121,faa2ecec8c5796745c8c28bdcb910c61fab17475
20200413,56,585763,2419021,17159,56195,75164,13632,1628,6168,210,35372,2020-04-13T00:00:00Z,25509,75164,2020-04-13T00:00:00Z,3021943,3004784,3004784,1644,4285,109349,25200,134549,5e98bb24cdfff2a85ae08bcd0b9a224d1b1d0699
20200412,56,560563,2309672,16419,55426,70879,13623,1455,5986,160,34081,2020-04-12T00:00:00Z,23865,70879,2020-04-12T00:00:00Z,2886654,2870235,2870235,1703,3288,111204,27763,138967,4d457b77f365f58f96af55b66cbd159d1d3acc2d
20200411,56,532800,2198468,16593,55572,67591,13280,1405,5978,154,31567,2020-04-11T00:00:00Z,22162,67591,2020-04-11T00:00:00Z,2747861,2731268,2731268,2055,2825,106592,30506,137098,199ab4b6100e2749d7a47d9f9043988f100dced5
20200410,56,502294,2091876,17435,52723,64766,12698,1185,5937,41,28997,2020-04-10T00:00:00Z,20107,64766,2020-04-10T00:00:00Z,2611605,2594170,2594170,2108,4934,124192,34383,158575,d0822d8a82e25361a8742bd8da94e9e11ae73d9b
20200409,56,467911,1967684,17622,50859,59832,12254,924,5794,39,24819,2020-04-09T00:00:00Z,17999,59832,2020-04-09T00:00:00Z,2453217,2435595,2435595,2043,3923,136748,34495,171243,4f4811f71616a45f0c0e16e2ad41cd61f49f841a
20200408,56,433416,1830936,17219,45141,55909,10180,1013,4131,216,21102,2020-04-08T00:00:00Z,15956,55909,2020-04-08T00:00:00Z,2281571,2264352,2264352,2010,4311,117154,30595,147749,d49636cba5a009e2af8ac1ff165c39927cf0d8ef
20200407,56,402821,1713782,16548,43465,51598,9821,889,4076,151,18443,2020-04-07T00:00:00Z,13946,51598,2020-04-07T00:00:00Z,2133151,2116603,2116603,2024,2981,123604,30885,154489,ccaae9900fa293c7103c1a462709d579afdeee2d
20200406,56,371936,1590178,17283,35856,48617,6943,814,2961,147,16554,2020-04-06T00:00:00Z,11922,48617,2020-04-06T00:00:00Z,1979397,1962114,1962114,1318,2946,123253,29002,152255,7bdb492c4a9f53578172bc31bd36dbaddf8b8c93
20200405,56,342934,1466925,17303,31875,45671,5677,760,652,147,14513,2020-04-05T00:00:00Z,10604,45671,2020-04-05T00:00:00Z,1827162,1809859,1809859,1340,3903,94299,25500,119799,bab3b241ba234c98db9c86117a90162721f402d0
20200404,56,317434,1372626,15569,29987,41768,5383,554,656,147,12816,2020-04-04T00:00:00Z,9264,41768,2020-04-04T00:00:00Z,1705629,1690060,1690060,1482,5086,196066,33212,229278,f782ccc7f29b57173f5bfd5499a0ad1495775e6a
20200403,56,284222,1176560,61976,25472,36682,4811,486,605,147,10861,2020-04-03T00:00:00Z,7782,36682,2020-04-03T00:00:00Z,1522758,1460782,1460782,1286,4554,101013,32076,133089,e22d16fde28e0223655503542173bce0a8f19bac
20200402,56,252146,1075547,62097,22764,32128,4410,456,574,140,8586,2020-04-02T00:00:00Z,6496,32128,2020-04-02T00:00:00Z,1389790,1327693,1327693,1172,4175,91058,28060,119118,aaff599a781f9607c2ba9f0c7f77ccfa6006a2d5
20200401,56,224086,984489,59665,20775,27953,3937,407,561,140,7084,2020-04-01T00:00:00Z,5324,27953,2020-04-01T00:00:00Z,1268240,1208575,1208575,1010,4228,82981,25791,108772,b3829badb8e9f8652d970e37b5ce9e93d24d8558
20200331,56,198295,901508,59518,18082,23725,3487,236,507,,5666,2020-03-31T00:00:00Z,4314,23725,2020-03-31T00:00:00Z,1159321,1099803,1099803,890,3906,87657,24853,112510,c2ae63d52663b5dcc9409a81fa41cb39f36333f3
20200330,56,173442,813851,65369,15772,19819,3087,187,451,,4560,2020-03-30T00:00:00Z,3424,19819,2020-03-30T00:00:00Z,1052662,987293,987293,589,2536,96706,22042,118748,82550db2c4984a2faaa0fcaf589d763d033addcb
20200329,56,151400,717145,65545,14026,17283,2456,156,439,,4052,2020-03-29T00:00:00Z,2835,17283,2020-03-29T00:00:00Z,934090,868545,868545,521,2775,68187,19581,87768,d3635e8042c627e28043d159464b2bb933e9f3b7
20200328,56,131819,648958,65709,12350,14508,2174,140,390,,3143,2020-03-28T00:00:00Z,2314,14508,2020-03-28T00:00:00Z,846486,780777,780777,538,2425,87375,19692,107067,47291433bc63b24ff8932247abdf3da2e9cc13f4
20200327,56,112127,561583,60091,10932,12083,1792,124,324,,2418,2020-03-27T00:00:00Z,1776,12083,2020-03-27T00:00:00Z,733801,673710,673710,406,2563,83781,19128,102909,20e6d58a17e608a03e46b24b4a01311b3ee6ce1e
20200326,56,92999,477802,60251,7757,9520,1299,91,258,,97,2020-03-26T00:00:00Z,1370,9520,2020-03-26T00:00:00Z,631052,570801,570801,320,2499,84311,17720,102031,7ffadc86d5ba9a725acbe621555f32b1f86308a2
20200325,56,75279,393491,51235,5062,7021,,74,167,,146,2020-03-25T00:00:00Z,1050,7021,2020-03-25T00:00:00Z,520005,468770,468770,235,1904,71728,12908,84636,2e7da6b2900e763fbd6883d8b6df72f2a97af178
20200324,56,62371,321763,14433,3902,5117,,,,,,2020-03-24T00:00:00Z,815,5117,2020-03-24T00:00:00Z,398567,384134,384134,234,1180,58695,10769,69464,a5d4220360d1c015325abb76b9761b5c1a2d69ec
20200323,56,51602,263068,14571,2770,3937,,,,,,2020-03-23T00:00:00Z,581,3937,2020-03-23T00:00:00Z,329241,314670,314670,101,914,46894,11439,58333,f61f0d58535ac0c8011abaa6e11e53e9ad8b003f
20200322,56,40163,216174,2842,2155,3023,,,,,,2020-03-22T00:00:00Z,480,3023,2020-03-22T00:00:00Z,259179,256337,256337,146,1003,36456,9125,45581,167069e48fe00c384394679ad0fa225f42e80a69
20200321,56,31038,179718,3468,1436,2020,,,,,,2020-03-21T00:00:00Z,334,2020,2020-03-21T00:00:00Z,214224,210756,210756,62,1912,38628,6793,45421,4b8e97a8a431ecdfda932289989c19d9640d5ba6
20200320,56,24245,141090,3330,1042,108,,,,,,2020-03-20T00:00:00Z,272,108,2020-03-20T00:00:00Z,168665,165335,165335,69,23,30568,6147,36715,516a6ee00503b11ada5bf43e828220515c67eb96
20200319,56,18098,110522,3016,617,85,,,,,,2020-03-19T00:00:00Z,203,85,2020-03-19T00:00:00Z,131636,128620,128620,48,18,23323,4651,27974,ab3e4b905e8d4913a278a24a0c68bedba0b58a49
20200318,56,13447,87199,2526,416,67,,,,,,2020-03-18T00:00:00Z,155,67,2020-03-18T00:00:00Z,103172,100646,100646,32,12,22068,3089,25157,d3ba75c770f84224ac8f3187195d0938f93e96c8
20200317,56,10358,65131,1687,325,55,,,,,,2020-03-17T00:00:00Z,123,55,2020-03-17T00:00:00Z,77176,75489,75489,23,13,13945,3550,17495,e7313273e9498fb541694dc6ca72ba355f03ddf1
20200316,56,6808,51186,1691,,42,,,,,,2020-03-16T00:00:00Z,100,42,2020-03-16T00:00:00Z,59685,57994,57994,21,6,16525,1494,18019,8a9aa23e5f73a92b944cde9bea327eb1efd9ce8b
20200315,51,5314,34661,2242,,36,,,,,,2020-03-15T00:00:00Z,79,36,2020-03-15T00:00:00Z,42217,39975,39975,15,10,6553,1115,7668,f5c9c0639a58f38c63fed9383fd101f13e8b935c
20200314,51,4199,28108,1236,,26,,,,,,2020-03-14T00:00:00Z,64,26,2020-03-14T00:00:00Z,33543,32307,32307,9,4,3852,808,4660,3b5b13e640c498a61e14793a338264f7247f2879
20200313,51,3391,24256,1130,,22,,,,,,2020-03-13T00:00:00Z,55,22,2020-03-13T00:00:00Z,28777,27647,27647,4,6,8318,951,9269,6783a23fc71cf29a0229db20fca5163232da35a0
20200312,51,2440,15938,673,,16,,,,,,2020-03-12T00:00:00Z,51,16,2020-03-12T00:00:00Z,19051,18378,18378,8,5,4750,606,5356,1451f36feac5f9184c2b7ad6e7dbbdda2f242741
20200311,51,1834,11188,563,,11,,,,,,2020-03-11T00:00:00Z,43,11,2020-03-11T00:00:00Z,13585,13022,13022,6,3,3421,449,3870,89251cf6a16d5c512022f9b43b83813d267e23a6
20200310,51,1385,7767,469,,8,,,,,,2020-03-10T00:00:00Z,37,8,2020-03-10T00:00:00Z,9621,9152,9152,2,0,2184,335,2519,006f4796fe79b2fe4a0f6544ccd38203dec516f0
20200309,51,1050,5583,313,,8,,,,,,2020-03-09T00:00:00Z,35,8,2020-03-09T00:00:00Z,6946,6633,6633,4,2,1534,257,1791,be650c97bfdeff9c8defd5a42c0423bf4fa24d0a
20200308,51,793,4049,347,,6,,,,,,2020-03-08T00:00:00Z,31,6,2020-03-08T00:00:00Z,5189,4842,4842,4,0,716,175,891,513f84e311b252394c2a6f1335362b15edf917ba
20200307,51,618,3333,602,,6,,,,,,2020-03-07T00:00:00Z,27,6,2020-03-07T00:00:00Z,4553,3951,3951,1,0,661,160,821,cd118b406b27fa2c14fedf51a8bc4606667ce2d1
20200306,37,458,2672,458,,6,,,,,,2020-03-06T00:00:00Z,26,6,2020-03-06T00:00:00Z,3588,3130,3130,6,1,723,100,823,815f9b6a0bbc0ec9e3fdcba00c7437a3429eb028
20200305,25,358,1949,197,,5,,,,,,2020-03-05T00:00:00Z,20,5,2020-03-05T00:00:00Z,2504,2307,2307,4,1,532,99,631,97c301d16d60e86e9c23437b2094fb5a33ff6424
20200304,18,259,1417,103,,4,,,,,,2020-03-04T00:00:00Z,16,4,2020-03-04T00:00:00Z,1779,1676,1676,2,4,971,133,1104,a0c1db244272352b4267a9666ee35a1831672731
20200303,6,126,446,,,,,,,,,2020-03-03T00:00:00Z,14,,2020-03-03T00:00:00Z,572,572,572,3,0,203,41,244,843f99203fe8e103e33be57dcdf8ce42cf9bc97c
20200302,6,85,243,,,,,,,,,2020-03-02T00:00:00Z,11,,2020-03-02T00:00:00Z,328,328,328,3,0,158,40,198,0dbf0f7f44027f3502bac3535542a5e437a9081a
20200301,6,45,85,,,,,,,,,2020-03-01T00:00:00Z,8,,2020-03-01T00:00:00Z,130,130,130,3,0,61,27,88,018bc6d00fd64a77414f423a82714017e60f967d
20200229,4,18,24,,,,,,,,,2020-02-29T00:00:00Z,5,,2020-02-29T00:00:00Z,42,42,42,1,0,24,18,42,e8bfe9db6d823a5eb909810abef9887d2fbb9898
20200228,4,0,0,,,,,,,,,2020-02-28T00:00:00Z,4,,2020-02-28T00:00:00Z,0,0,0,2,0,0,0,0,e32d96910062fcdd632e72d59dd6218420709f43
20200227,4,0,0,,,,,,,,,2020-02-27T00:00:00Z,2,,2020-02-27T00:00:00Z,0,0,0,0,0,0,0,0,7a6b9c55e5b2e48605fbbb652ed9d8f6ce0c516f
20200226,3,0,0,,,,,,,,,2020-02-26T00:00:00Z,2,,2020-02-26T00:00:00Z,0,0,0,2,0,0,0,0,7fd18cfd695b3876452a4759c07cd74b431c70c1
20200225,3,0,0,,,,,,,,,2020-02-25T00:00:00Z,0,,2020-02-25T00:00:00Z,0,0,0,0,0,0,0,0,546df3c71998c4cf4188373d077f4cedc6933d9a
20200224,3,0,0,,,,,,,,,2020-02-24T00:00:00Z,0,,2020-02-24T00:00:00Z,0,0,0,0,0,0,0,0,892a45536b84803c54018d56c49b4613372218e7
20200223,3,0,0,,,,,,,,,2020-02-23T00:00:00Z,0,,2020-02-23T00:00:00Z,0,0,0,0,0,0,0,0,f1629457f5b903efc056266d3a003a077fe44425
20200222,3,0,0,,,,,,,,,2020-02-22T00:00:00Z,0,,2020-02-22T00:00:00Z,0,0,0,0,0,0,0,0,4df67d2b63bed863d76d69d00698ebdcdc31b3f3
20200221,3,0,0,,,,,,,,,2020-02-21T00:00:00Z,0,,2020-02-21T00:00:00Z,0,0,0,0,0,0,0,0,7f0ac856ef16728ed819d4e3b659102c49f6e43a
20200220,3,0,0,,,,,,,,,2020-02-20T00:00:00Z,0,,2020-02-20T00:00:00Z,0,0,0,0,0,0,0,0,1a9852cb7d8d92b28347aab35eb5606e372cadd5
20200219,3,0,0,,,,,,,,,2020-02-19T00:00:00Z,0,,2020-02-19T00:00:00Z,0,0,0,0,0,0,0,0,2c972a64785dd342fbad97e1f5cd9a407c7ac107
20200218,3,0,0,,,,,,,,,2020-02-18T00:00:00Z,0,,2020-02-18T00:00:00Z,0,0,0,0,0,0,0,0,b9771c64ca39cb7675bfcdd2c13a4f720f069aba
20200217,3,0,0,,,,,,,,,2020-02-17T00:00:00Z,0,,2020-02-17T00:00:00Z,0,0,0,0,0,0,0,0,821066754b993d15d0e3bd05685c12a7cfe5cb90
20200216,3,0,0,,,,,,,,,2020-02-16T00:00:00Z,0,,2020-02-16T00:00:00Z,0,0,0,0,0,0,0,0,d1632c4c6ea11aa1d09af42a855d36db099d88c4
20200215,3,0,0,,,,,,,,,2020-02-15T00:00:00Z,0,,2020-02-15T00:00:00Z,0,0,0,0,0,0,0,0,2dc9b940ebd2554cd84851a061392a921bbeb8fe
20200214,3,0,0,,,,,,,,,2020-02-14T00:00:00Z,0,,2020-02-14T00:00:00Z,0,0,0,0,0,0,0,0,214f6ca03432d7f44929bddd86d47bd61a2e1d7e
20200213,3,0,0,,,,,,,,,2020-02-13T00:00:00Z,0,,2020-02-13T00:00:00Z,0,0,0,0,0,0,0,0,399329390bce10053bffcf0d122965a19a3a93a9
20200212,3,0,0,,,,,,,,,2020-02-12T00:00:00Z,0,,2020-02-12T00:00:00Z,0,0,0,0,0,0,0,0,68df6880bf30101ac41e4b6a21dbd8787c7d4a71
20200211,3,0,0,,,,,,,,,2020-02-11T00:00:00Z,0,,2020-02-11T00:00:00Z,0,0,0,0,0,0,0,0,dd890414f05d64e4fbc01124e0964c9b5b8a1af3
20200210,3,0,0,,,,,,,,,2020-02-10T00:00:00Z,0,,2020-02-10T00:00:00Z,0,0,0,0,0,0,0,0,5c4dde7942c1a28345dc78492e2a9c5afd52cc62
20200209,2,0,0,,,,,,,,,2020-02-09T00:00:00Z,,,2020-02-09T00:00:00Z,0,0,0,0,0,0,0,0,69ce4ee6b68fbf3c0eea00424415f9af7f342956
20200208,2,0,0,,,,,,,,,2020-02-08T00:00:00Z,,,2020-02-08T00:00:00Z,0,0,0,0,0,0,0,0,435f978d8dea79d19330ac9edb3f96fde50953df
20200207,2,0,0,,,,,,,,,2020-02-07T00:00:00Z,,,2020-02-07T00:00:00Z,0,0,0,0,0,0,0,0,98d1490aa9817eb65d40f5ae6b09b3f58ff7d9ce
20200206,2,0,0,,,,,,,,,2020-02-06T00:00:00Z,,,2020-02-06T00:00:00Z,0,0,0,0,0,0,0,0,6424ce9e48ad97b680db81aa6c0d06c09a473f69
20200205,2,0,0,,,,,,,,,2020-02-05T00:00:00Z,,,2020-02-05T00:00:00Z,0,0,0,0,0,0,0,0,9a8c8b7eac1d419c7aa04a84bc9bc7ec0bb92da7
20200204,2,0,0,,,,,,,,,2020-02-04T00:00:00Z,,,2020-02-04T00:00:00Z,0,0,0,0,0,0,0,0,16c916bcaa18b0aa6f02f6c97718e50c5443cd9c
20200203,2,0,0,,,,,,,,,2020-02-03T00:00:00Z,,,2020-02-03T00:00:00Z,0,0,0,0,0,0,0,0,c542f7ad74541b08270d6925274eece2c4f79334
20200202,2,0,0,,,,,,,,,2020-02-02T00:00:00Z,,,2020-02-02T00:00:00Z,0,0,0,0,0,0,0,0,a1dd021af3e12d2a218df294663d03bdd573a330
20200201,2,0,0,,,,,,,,,2020-02-01T00:00:00Z,,,2020-02-01T00:00:00Z,0,0,0,0,0,0,0,0,10c29665184670bf22ba060ebb5650e298a6d1b8
20200131,2,0,0,,,,,,,,,2020-01-31T00:00:00Z,,,2020-01-31T00:00:00Z,0,0,0,0,0,0,0,0,529c83fead59f5b26a9898ce39996851806f9a2f
20200130,2,0,0,,,,,,,,,2020-01-30T00:00:00Z,,,2020-01-30T00:00:00Z,0,0,0,0,0,0,0,0,82859b598bd6e9643d8dc3b69b99d74c4f061282
20200129,2,0,0,,,,,,,,,2020-01-29T00:00:00Z,,,2020-01-29T00:00:00Z,0,0,0,0,0,0,0,0,5829b18554ba8cfdd449dcdf8a767aaf8af806b2
20200128,2,0,0,,,,,,,,,2020-01-28T00:00:00Z,,,2020-01-28T00:00:00Z,0,0,0,0,0,0,0,0,1e004b11f0e9c340d0e206a5e168b5ac2c154421
20200127,2,0,0,,,,,,,,,2020-01-27T00:00:00Z,,,2020-01-27T00:00:00Z,0,0,0,0,0,0,0,0,0dbe12f64745ae2d9e59003e934d50c66164fff3
20200126,2,0,0,,,,,,,,,2020-01-26T00:00:00Z,,,2020-01-26T00:00:00Z,0,0,0,0,0,0,0,0,acd8dfc63d3542d3d579778290d4601b2433e48c
20200125,2,0,0,,,,,,,,,2020-01-25T00:00:00Z,,,2020-01-25T00:00:00Z,0,0,0,0,0,0,0,0,e90258fa02cb55fd9357b389669ed1940e381bbd
20200124,2,0,0,,,,,,,,,2020-01-24T00:00:00Z,,,2020-01-24T00:00:00Z,0,0,0,0,0,0,0,0,babd004bb329a35eea647d8b431604c1a9ea2f97
20200123,2,0,0,,,,,,,,,2020-01-23T00:00:00Z,,,2020-01-23T00:00:00Z,0,0,0,0,0,0,0,0,d9b1df660fd87df4ddc10fd71d5d024e1080fe06
20200122,2,0,0,,,,,,,,,2020-01-22T00:00:00Z,,,2020-01-22T00:00:00Z,0,0,0,0,0,0,0,0,6955b9b8d895cdd26f91da2aedc369265b908816
