date,states,positive,negative,pending,hospitalizedCurrently,hospitalizedCumulative,inIcuCurrently,inIcuCumulative,onVentilatorCurrently,onVentilatorCumulative,recovered,dateChecked,death,hospitalized,lastModified,total,totalTestResults,posNeg,deathIncrease,hospitalizedIncrease,negativeIncrease,positiveIncrease,totalTestResultsIncrease,hash
20200831,56,5999459,71749439,11128,35349,370380,7051,17537,2077,1877,2184825,2020-08-31T00:00:00Z,175602,370380,2020-08-31T00:00:00Z,77760026,77748898,77748898,358,816,648999,31406,680405,ec992cccb88e56f0cd3b9b2dd3cd13edbff5c60e
20200830,56,5968053,71100440,11148,35726,369564,7268,17439,2055,1870,2153963,2020-08-30T00:00:00Z,175244,369564,2020-08-30T00:00:00Z,77079641,77068493,77068493,475,680,700008,39498,739506,c69f0e4ffe5bf519dac4d2c73c5e84737d8d38da
20200829,56,5928555,70400432,11151,36469,368884,7426,17401,2062,1864,2140631,2020-08-29T00:00:00Z,174769,368884,2020-08-29T00:00:00Z,76340138,76328987,76328987,1015,1296,719736,44502,764238,4c6bc7ad23b7c081aeff789e441e5bc4c6eb520c
20200828,56,5884053,69680696,10428,37239,367588,7558,17304,2086,1856,2118367,2020-08-28T00:00:00Z,173754,367588,2020-08-28T00:00:00Z,75575177,75564749,75564749,1023,1595,725710,46546,772256,3813626949a226a418b90db88ac160321c81aa5b
20200827,56,5837507,68954986,11168,37464,365993,7717,17181,2125,1831,2101326,2020-08-27T00:00:00Z,172731,365993,2020-08-27T00:00:00Z,74803661,74792493,74792493,1129,1668,698076,43984,742060,da4b2487096e8fc8476aa6346cfa0dc8796d86ba
20200826,56,5793523,68256910,4081,38411,364325,7763,17046,2142,1809,2084465,2020-08-26T00:00:00Z,171602,364325,2020-08-26T00:00:00Z,74054514,74050433,74050433,1298,1873,631672,43356,675028,fb7647b9fce989365ac29d1e344d8239128c7ac7
20200825,56,5750167,67625238,4091,38762,362452,7851,16920,2163,1789,2053699,2020-08-25T00:00:00Z,170304,362452,2020-08-25T00:00:00Z,73379496,73375405,73375405,1147,1999,597782,36374,634156,c31219b712a71669cbb4c3f73ef53df0733416d5
20200824,56,5713793,67027456,4143,38657,360453,7836,16787,2118,1764,2020774,2020-08-24T00:00:00Z,169157,360453,2020-08-24T00:00:00Z,72745392,72741249,72741249,343,1049,648010,34641,682651,9a60b92c7fd3585f607b638b4a2637edc9e929ae
20200823,56,5679152,66379446,4149,39029,359404,7951,16697,2131,1737,1997782,2020-08-23T00:00:00Z,168814,359404,2020-08-23T00:00:00Z,72062747,72058598,72058598,572,774,577947,37567,615514,200f4920adaedd00e71f32876046399052592592
20200822,56,5641585,65801499,4154,39911,358630,8218,16657,2204,1736,1985493,2020-08-22T00:00:00Z,168242,358630,2020-08-22T00:00:00Z,71447238,71443084,71443084,1029,1537,710293,46242,756535,c85e3badb65b3b4f42ebafa87290a9c4eb5abca8
20200821,56,5595343,65091206,4199,40951,357093,8357,16563,2286,1730,1965056,2020-08-21T00:00:00Z,167213,357093,2020-08-21T00:00:00Z,70690748,70686549,70686549,1123,1817,697054,46562,743616,9aedbc82fbd43f83645c1bfa78edece4f35de411
20200820,56,5548781,64394152,4170,41988,355276,8483,16487,2335,1716,1946866,2020-08-20T00:00:00Z,166090,355276,2020-08-20T00:00:00Z,69947103,69942933,69942933,1134,2010,634078,43758,677836,92b032f50a082ba1b7ce59cd8498fddab7611a13
20200819,56,5505023,63760074,4374,43330,353266,8744,16377,2371,1705,1924875,2020-08-19T00:00:00Z,164956,353266,2020-08-19T00:00:00Z,69269471,69265097,69265097,1420,2032,644823,44953,689776,548da75e8121dddc37fcb49f42931f0642b734d7
20200818,56,5460070,63115251,4412,43747,351234,8866,16123,2468,1695,1889170,2020-08-18T00:00:00Z,163536,351234,2020-08-18T00:00:00Z,68579733,68575321,68575321,1196,2273,616859,40796,657655,fc26a483407f1a3542cee7f0a193058455b69279
20200817,56,5419274,62498392,4298,43485,348961,8871,15985,2447,1678,1865580,2020-08-17T00:00:00Z,162340,348961,2020-08-17T00:00:00Z,67921964,67917666,67917666,407,1267,625846,37881,663727,5a64ba32a8c428f643ae781ba452ae18f0dd22e2
20200816,56,5381393,61872546,4302,44028,347694,8947,15924,2481,1665,1833096,2020-08-16T00:00:00Z,161933,347694,2020-08-16T00:00:00Z,67258241,67253939,67253939,619,649,740599,42487,783086,047006f000e82462b05487adba2f66fa39dbcc01
20200815,56,5338906,61131947,4452,44794,347045,9101,15891,2526,1663,1818546,2020-08-15T00:00:00Z,161314,347045,2020-08-15T00:00:00Z,66475305,66470853,66470853,1219,2031,693310,56148,749458,c6a8328c5cd9848ca3f4fb3e83cf865063aec765
20200814,56,5282758,60438637,4415,45776,345014,9277,15764,2549,1665,1796326,2020-08-14T00:00:00Z,160095,345014,2020-08-14T00:00:00Z,65725810,65721395,65721395,1216,2212,798904,55635,854539,70c36c433d26c5a26642f2b0c24b8d88afceadfe
20200813,56,5227123,59639733,4239,47228,342802,9489,15629,2579,1649,1774648,2020-08-13T00:00:00Z,158879,342802,2020-08-13T00:00:00Z,64871095,64866856,64866856,1163,2685,843535,51760,895295,e25f32b691007a8251fa644618093c75089fea93
20200812,56,5175363,58796198,4174,47968,340117,9553,15524,2604,1629,1755225,2020-08-12T00:00:00Z,157716,340117,2020-08-12T00:00:00Z,63975735,63971561,63971561,1517,3055,439024,56132,495156,ed7be90b42068cbf6fe6ceb74f62039fe3b7fe63
20200811,56,5119231,58357174,4118,48498,337062,9136,15331,2415,1612,1714960,2020-08-11T00:00:00Z,156199,337062,2020-08-11T00:00:00Z,63480523,63476405,63476405,1326,2715,698757,55702,754459,caabcf55d7f4d744ee11fcb19dd198bfb0f3b9af
20200810,56,5063529,57658417,3966,48635,334347,9216,15158,2533,1592,1670755,2020-08-10T00:00:00Z,154873,334347,2020-08-10T00:00:00Z,62725912,62721946,62721946,426,1654,693402,42089,735491,3661972470ac56e004e7da74e7dd3633f708dd15
20200809,56,5021440,56965015,3871,48902,332693,9303,15081,2507,1578,1656888,2020-08-09T00:00:00Z,154447,332693,2020-08-09T00:00:00Z,61990326,61986455,61986455,616,855,666939,50624,717563,d42fdc8d95641c3bef14097860f87c0b5b5cc61d
20200808,56,4970816,56298076,3888,49884,331838,9653,15024,2566,1561,1643137,2020-08-08T00:00:00Z,153831,331838,2020-08-08T00:00:00Z,61272780,61268892,61268892,1089,1414,621980,53713,675693,03e87962804f861333980acce86d98fda91d0146
20200807,56,4917103,55676096,3988,51153,330424,9670,14925,2617,1549,1623870,2020-08-07T00:00:00Z,152742,330424,2020-08-07T00:00:00Z,60597187,60593199,60593199,1333,8036,715719,61346,777065,6d3725f016d129328be4fda89c6eba7722ce5e26
20200806,56,4855757,54960377,3903,53053,322388,9976,14810,2718,1534,1598624,2020-08-06T00:00:00Z,151409,322388,2020-08-06T00:00:00Z,59820037,59816134,59816134,1251,2682,691399,54185,745584,6460d0020d7f8ba422f6b4d109b08dc72392579b
20200805,56,4801572,54268978,3842,53281,319706,9970,14687,2719,1524,1577851,2020-08-05T00:00:00Z,150158,319706,2020-08-05T00:00:00Z,59074392,59070550,59070550,1346,2269,643615,52326,695941,123f8b38793a24814a3d392a733ffb9569034734
20200804,56,4749246,53625363,3789,53293,317437,10208,14537,2701,1493,1528979,2020-08-04T00:00:00Z,148812,317437,2020-08-04T00:00:00Z,58378398,58374609,58374609,1255,4490,659553,51865,711418,d54ead508b71b3584599ccd2a5257cd90bf8cc8e
20200803,56,4697381,52965810,3662,53326,312947,10216,14370,2659,1463,1513446,2020-08-03T00:00:00Z,147557,312947,2020-08-03T00:00:00Z,57666853,57663191,57663191,519,1724,692703,49769,742472,e3094b37f02560f3b5959e675582b799774b6e1a
20200802,56,4647612,52273107,3888,53931,311223,10405,14288,2645,1448,1468689,2020-08-02T00:00:00Z,147038,311223,2020-08-02T00:00:00Z,56924607,56920719,56920719,498,817,643326,46756,690082,eec3c5da0b30177b285e0a5379d478921791c6a6
20200801,56,4600856,51629781,3975,54412,310406,10428,14227,2698,1445,1461885,2020-08-01T00:00:00Z,146540,310406,2020-08-01T00:00:00Z,56234612,56230637,56230637,1190,2318,673904,61102,735006,269481808bee7ac3dcba504d07532cad01f71310
20200731,56,4539754,50955877,3956,55540,308088,10472,14044,2703,1437,1438160,2020-07-31T00:00:00Z,145350,308088,2020-07-31T00:00:00Z,55499587,55495631,55495631,1312,2627,657827,67624,725451,551f28203cf224d13f5bd38f06ace3f892fae579
20200730,56,4472130,50298050,3947,56381,305461,10513,13875,2760,1415,1413957,2020-07-30T00:00:00Z,144038,305461,2020-07-30T00:00:00Z,54774127,54770180,54770180,1259,3383,737950,69419,807369,3c9e15dbce27af60587a531b2bdf6a8b11a6e357
20200729,56,4402711,49560100,3840,57339,302078,10539,13744,2772,1400,1390568,2020-07-29T00:00:00Z,142779,302078,2020-07-29T00:00:00Z,53966651,53962811,53962811,1492,2934,789712,66960,856672,f6492a77784fa908fdb73932b6364ef507bfe8e6
20200728,56,4335751,48770388,3600,57091,299144,10463,13559,2752,1372,1355363,2020-07-28T00:00:00Z,141287,299144,2020-07-28T00:00:00Z,53109739,53106139,53106139,1122,4672,681181,56452,737633,b03a47202f28cc3a25225b89cf74ce7e53a75515
20200727,56,4279299,48089207,3398,58897,294472,10328,13412,2720,1356,1325804,2020-07-27T00:00:00Z,140165,294472,2020-07-27T00:00:00Z,52371904,52368506,52368506,1059,1690,707142,55321,762463,b1d03db4f5ad7063331bbb62c0815e875f998125
20200726,56,4223978,47382065,3361,58621,292782,10353,13343,2723,1336,1297863,2020-07-26T00:00:00Z,139106,292782,2020-07-26T00:00:00Z,51609404,51606043,51606043,559,1435,780054,61009,841063,74a090b4bd5ad50a198875444454e49d693e1c03
20200725,56,4162969,46602011,3377,59301,291347,10380,13279,2729,1300,1279414,2020-07-25T00:00:00Z,138547,291347,2020-07-25T00:00:00Z,50768357,50764980,50764980,1023,1977,715969,64742,780711,87ade0fd11915f81dcfbcbbbc450adcbb90d245f
20200724,56,4098227,45886042,3409,59682,289370,10395,13182,2711,1297,1261624,2020-07-24T00:00:00Z,137524,289370,2020-07-24T00:00:00Z,49987678,49984269,49984269,1176,3032,851205,75235,926440,6be0b3948433c3dabffc4e972034731b7801c5f2
20200723,56,4022992,45034837,3179,59718,286338,10414,12933,2465,1280,1233269,2020-07-23T00:00:00Z,136348,286338,2020-07-23T00:00:00Z,49061008,49057829,49057829,1055,2509,769521,71553,841074,f6aa1b5d9321dab5973dc87246db0838a4e2f5d1
20200722,56,3951439,44265316,3051,59596,283829,10457,12790,2440,1258,1210849,2020-07-22T00:00:00Z,135293,283829,2020-07-22T00:00:00Z,48219806,48216755,48216755,1171,2248,727105,69334,796439,269117bce9c936f8c9b575b894821aa47c2e9869
20200721,56,3882105,43538211,3197,59364,281581,6711,12629,2414,1242,1182931,2020-07-21T00:00:00Z,134122,281581,2020-07-21T00:00:00Z,47423513,47420316,47420316,1038,2551,686361,63929,750290,e5e3ed344827e93acc7cc90a8fa7ce895a57bd09
20200720,56,3818176,42851850,3003,58371,279030,6558,12475,2403,1223,1160087,2020-07-20T00:00:00Z,133084,279030,2020-07-20T00:00:00Z,46673029,46670026,46670026,363,1647,654148,57041,711189,e341933bce7d2f247a492036396b1397f4b82048
20200719,56,3761135,42197702,3052,57885,277383,6384,12393,2362,1216,1131171,2020-07-19T00:00:00Z,132721,277383,2020-07-19T00:00:00Z,45961889,45958837,45958837,527,944,715331,64259,779590,48d9a4eb0772902cf7d8845e29730b426dcad71e
20200718,56,3696876,41482371,3032,57645,276439,6396,12342,2343,1211,1122720,2020-07-18T00:00:00Z,132194,276439,2020-07-18T00:00:00Z,45182279,45179247,45179247,872,2003,691886,64950,756836,657c853ab3b2dde65b7f82cbca0487b4df6fc873
20200717,56,3631926,40790485,3002,57761,274436,6453,12243,2353,1200,1106844,2020-07-17T00:00:00Z,131322,274436,2020-07-17T00:00:00Z,44425413,44422411,44422411,951,2678,757657,76844,834501,50f27d14811823acaf3759f9884af98211d590f6
20200716,56,3555082,40032828,2929,57442,271758,6359,12091,2317,1175,1090645,2020-07-16T00:00:00Z,130371,271758,2020-07-16T00:00:00Z,43590839,43587910,43587910,947,2215,756287,71036,827323,fbde75373039924899c0c10f9b9ec1155f85a849
20200715,56,3484046,39276541,2947,56144,269543,6317,12002,2317,1166,1075882,2020-07-15T00:00:00Z,129424,269543,2020-07-15T00:00:00Z,42763534,42760587,42760587,858,2416,703090,65797,768887,c36f9fb0175ccae0b3c28e613f0fccd8849becb1
20200714,56,3418249,38573451,960,55565,267127,6235,11857,2263,1154,1049098,2020-07-14T00:00:00Z,128566,267127,2020-07-14T00:00:00Z,41992660,41991700,41991700,736,2262,702900,62726,765626,c7029b5170080e40d9c08a20683eca16ab513188
20200713,56,3355523,37870551,2610,53988,264865,6074,11749,2259,1142,1031939,2020-07-13T00:00:00Z,127830,264865,2020-07-13T00:00:00Z,41228684,41226074,41226074,327,1214,636500,58097,694597,bc34c13dbb6cfdc431f4f0dd5a67dfe653ec3e4a
20200712,56,3297426,37234051,2639,52727,263651,5930,11679,2182,1136,1006326,2020-07-12T00:00:00Z,127503,263651,2020-07-12T00:00:00Z,40534116,40531477,40531477,476,939,702394,61312,763706,4ac8187defc744236e07fa5caa103bf70d00af43
20200711,56,3236114,36531657,2618,51859,262712,5939,11612,2169,1128,995576,2020-07-11T00:00:00Z,127027,262712,2020-07-11T00:00:00Z,39770389,39767771,39767771,757,5141,637755,62896,700651,31b9a9e49afad31e20fe72c769c85a27c940f1e3
20200710,56,3173218,35893902,2493,51595,257571,5896,11523,2197,1118,983185,2020-07-10T00:00:00Z,126270,257571,2020-07-10T00:00:00Z,39069613,39067120,39067120,854,2318,742929,66846,809775,8965f9579ed12cd34d8dd6f04988807cfdee2844
20200709,56,3106372,35150973,2530,43934,255253,5845,11370,2127,1138,969111,2020-07-09T00:00:00Z,125416,255253,2020-07-09T00:00:00Z,38259875,38257345,38257345,867,1719,646844,59157,706001,eda11a79e2cddcc480b83ea1b46babfa6d502193
20200708,56,3047215,34504129,2360,43078,253534,5874,11303,2172,1103,953420,2020-07-08T00:00:00Z,124549,253534,2020-07-08T00:00:00Z,37553704,37551344,37551344,807,2035,575559,62672,638231,01f813de89bbd9f483293ab8c3324f500621c190
20200707,56,2984543,33928570,2136,41760,251499,5832,11177,2098,1084,936476,2020-07-07T00:00:00Z,123742,251499,2020-07-07T00:00:00Z,36915249,36913113,36913113,923,1960,584171,51726,635897,dbdca279a000821f906b264e4c4396e67ccda2f1
20200706,56,2932817,33344399,1907,39768,249539,5684,11058,2105,1070,924148,2020-07-06T00:00:00Z,122819,249539,2020-07-06T00:00:00Z,36279123,36277216,36277216,243,794,471602,41918,513520,5b27be022f6a7d2f37c1a89a6f1a0353a740e044
20200705,56,2890899,32872797,1885,38764,248745,5653,11010,2080,1064,902558,2020-07-05T00:00:00Z,122576,248745,2020-07-05T00:00:00Z,35765581,35763696,35763696,209,590,633339,45613,678952,c4a033777c80ab027c6a7376cd462428db55a8b8
20200704,56,2845286,32239458,2083,38146,248155,5633,10977,1982,1063,894325,2020-07-04T00:00:00Z,122367,248155,2020-07-04T00:00:00Z,35086827,35084744,35084744,306,871,577481,54338,631819,9f733a63d03c9c70d8ce3e892b62f697adf581d1
20200703,56,2790948,31661977,2237,37798,247284,5597,10936,2049,1059,883561,2020-07-03T00:00:00Z,122061,247284,2020-07-03T00:00:00Z,34455162,34452925,34452925,598,1435,654043,53950,707993,77792042bdd3758f8195f5a9079d523fd4b51ca3
20200702,56,2736998,31007934,2208,37500,245849,5626,10843,2105,1041,875127,2020-07-02T00:00:00Z,121463,245849,2020-07-02T00:00:00Z,33747140,33744932,33744932,695,2003,608354,54084,662438,71ad42a273fdcc66b399fe067b9a094274c2325a
20200701,56,2682914,30399580,2604,36405,243846,5512,10752,2098,1027,823151,2020-07-01T00:00:00Z,120768,243846,2020-07-01T00:00:00Z,33085098,33082494,33082494,701,1438,589398,50981,640379,5bc460d0226f4daa00d491912d22306d364ecabb
20200630,56,2631933,29810182,2432,35248,242408,5424,10669,2044,1008,813788,2020-06-30T00:00:00Z,120067,242408,2020-06-30T00:00:00Z,32444547,32442115,32442115,596,1582,580152,47863,628015,45ed25b901382b2d01d017c6b34c80958a583c55
20200629,56,2584070,29230030,2194,33586,240826,5380,10542,2011,990,798360,2020-06-29T00:00:00Z,119471,240826,2020-06-29T00:00:00Z,31816294,31814100,31814100,332,670,615988,39811,655799,e3ef858d8d96c8795898485e504f55c04ae7e476
20200628,56,2544259,28614042,2198,32476,240156,5248,10473,2077,983,778321,2020-06-28T00:00:00Z,119139,240156,2020-06-28T00:00:00Z,31160499,31158301,31158301,271,580,535806,41572,577378,d25dae86a8389e9865646b386acea82d407f78e6
20200627,56,2502687,28078236,2186,32483,239576,5315,10415,2159,977,772465,2020-06-27T00:00:00Z,118868,239576,2020-06-27T00:00:00Z,30583109,30580923,30580923,511,1057,555647,43784,599431,fbb068b451f1361078c2070df7b0b901fd91076d
20200626,56,2458903,27522589,2201,31738,238519,5283,10334,2075,966,763966,2020-06-26T00:00:00Z,118357,238519,2020-06-26T00:00:00Z,29983693,29981492,29981492,637,1526,565494,44543,610037,845e95ac6454ab9d62cae2c27d604020e6b2c2bd
20200625,56,2414360,26957095,2133,31844,236993,5319,10257,2214,951,756719,2020-06-25T00:00:00Z,117720,236993,2020-06-25T00:00:00Z,29373588,29371455,29371455,647,1257,602693,39249,641942,78eac1df41f0692df760f49c0b9dcf9d4b2e0420
20200624,56,2375111,26354402,2049,31102,235736,5293,10173,2248,934,747565,2020-06-24T00:00:00Z,117073,235736,2020-06-24T00:00:00Z,28731562,28729513,28729513,724,1310,485049,38843,523892,9bfd1ba91ac0069ebc85cc5adf805b778d696f1d
20200623,56,2336268,25869353,1891,30235,234426,5402,10077,2293,918,738952,2020-06-23T00:00:00Z,116349,234426,2020-06-23T00:00:00Z,28207512,28205621,28205621,710,1257,469104,33447,502551,fba6b5c82bab4c5275360b501ba43d5cc8501776
20200622,56,2302821,25400249,2028,28799,233169,5323,10002,2299,909,731602,2020-06-22T00:00:00Z,115639,233169,2020-06-22T00:00:00Z,27705098,27703070,27703070,286,800,444089,27281,471370,a3d63f0060d8de196bdc5f2d7619dc49d478f9e2
20200621,56,2275540,24956160,2084,28219,232369,5195,9944,2321,904,713537,2020-06-21T00:00:00Z,115353,232369,2020-06-21T00:00:00Z,27233784,27231700,27231700,294,514,496049,27928,523977,af81be6d6e82fc0cdb98efb20f7858b1969597c1
20200620,56,2247612,24460111,2108,27967,231855,5229,9908,2380,888,708864,2020-06-20T00:00:00Z,115059,231855,2020-06-20T00:00:00Z,26709831,26707723,26707723,629,745,533304,32294,565598,db8faf813200c4e0a89cd6003b6fedd16266ecf9
20200619,56,2215318,23926807,2032,28615,231110,5341,9876,2434,884,698119,2020-06-19T00:00:00Z,114430,231110,2020-06-19T00:00:00Z,26144157,26142125,26142125,655,1613,548107,31472,579579,dd0c93fbb4c7fda58568cc745906d609fbfe4c58
20200618,56,2183846,23378700,1903,28414,229497,5465,9736,2520,869,690692,2020-06-18T00:00:00Z,113775,229497,2020-06-18T00:00:00Z,25564449,25562546,25562546,705,1040,491625,27744,519369,39b53725ffe51d9b03b1a7d96630603f18e6c6c4
20200617,56,2156102,22887075,1745,28573,228457,5613,9665,2588,857,680916,2020-06-17T00:00:00Z,113070,228457,2020-06-17T00:00:00Z,25044922,25043177,25043177,767,1130,463168,24004,487172,b3ed924b75974b77bbb86d7b09cdf64b6deb0650
20200616,56,2132098,22423907,1604,28270,227327,5570,9590,2594,845,672228,2020-06-16T00:00:00Z,112303,227327,2020-06-16T00:00:00Z,24557609,24556005,24556005,730,1301,442650,23497,466147,d91a5303c271c85eec5475c94bff0484098ea2ce
20200615,56,2108601,21981257,1619,27867,226026,5703,9516,2640,835,665059,2020-06-15T00:00:00Z,111573,226026,2020-06-15T00:00:00Z,24091477,24089858,24089858,381,543,415390,18629,434019,ed801eaa86b5ef6997c2df93315bbb7c3d5a0a03
20200614,56,2089972,21565867,1672,27893,225483,5749,9466,2716,834,650541,2020-06-14T00:00:00Z,111192,225483,2020-06-14T00:00:00Z,23657511,23655839,23655839,356,640,464154,21399,485553,860d3d32fa20033f541402598e4581cd1ab4d139
20200613,56,2068573,21101713,1698,28450,224843,5883,9430,2726,830,645331,2020-06-13T00:00:00Z,110836,224843,2020-06-13T00:00:00Z,23171984,23170286,23170286,694,1105,471388,25374,496762,63983dacbd1b936f7df5efe648d7a1110c6dc950
20200612,56,2043199,20630325,1783,29154,223738,6017,9373,2734,814,636111,2020-06-12T00:00:00Z,110142,223738,2020-06-12T00:00:00Z,22675307,22673524,22673524,775,1245,599972,23599,623571,8331bea08d6f96a9939df5d5d0dc60072efb881f
20200611,56,2019600,20030353,1816,29698,222493,6074,9295,2886,792,629017,2020-06-11T00:00:00Z,109367,222493,2020-06-11T00:00:00Z,22051769,22049953,22049953,899,1367,438062,22154,460216,2d414a302eb4271c9ffc2d415808c57cbb06593a
20200610,56,1997446,19592291,1737,30864,221126,6249,9225,3020,780,618125,2020-06-10T00:00:00Z,108468,221126,2020-06-10T00:00:00Z,21591474,21589737,21589737,887,1484,408971,20894,429865,f4715e488a08beb47e9db6ac88b604f462a2e551
20200609,56,1976552,19183320,1661,31183,219642,6457,9141,3090,771,609476,2020-06-09T00:00:00Z,107581,219642,2020-06-09T00:00:00Z,21161533,21159872,21159872,902,1527,404379,17311,421690,2e052aaf0d07084b46ea372de2e3dc2f8397be9d
20200608,56,1959241,18778941,1606,31202,218115,6402,9013,3240,762,603143,2020-06-08T00:00:00Z,106679,218115,2020-06-08T00:00:00Z,20739788,20738182,20738182,661,714,380221,17209,397430,ff1c345e409269195a6e0e0760dadae177e9042e
20200607,56,1942032,18398720,1733,31408,217401,6501,8957,3298,753,590988,2020-06-07T00:00:00Z,106018,217401,2020-06-07T00:00:00Z,20342485,20340752,20340752,447,685,404383,18741,423124,bd90c0e3a14bf5626024ab881e73219460fa09de
20200606,56,1923291,17994337,1796,31938,216716,6762,8920,3476,750,585470,2020-06-06T00:00:00Z,105571,216716,2020-06-06T00:00:00Z,19919424,19917628,19917628,728,1017,521778,23064,544842,dc428096aa7b7d6c408205a4582359b368170bd9
20200605,56,1900227,17472559,1749,32451,215699,6920,8863,3523,740,576327,2020-06-05T00:00:00Z,104843,215699,2020-06-05T00:00:00Z,19374535,19372786,19372786,826,1440,484686,23399,508085,144030e280a9f9050f2de008996662e167a59bd6
20200604,56,1876828,16987873,3474,32835,214259,7057,8787,3665,723,569623,2020-06-04T00:00:00Z,104017,214259,2020-06-04T00:00:00Z,18868175,18864701,18864701,893,-2841,441895,20877,462772,37d2eededa985f6fd47cadca0f1ffcb6000ada17
20200603,56,1855951,16545978,3556,33269,217100,7227,8688,3749,717,557366,2020-06-03T00:00:00Z,103124,217100,2020-06-03T00:00:00Z,18405485,18401929,18401929,993,2255,448319,20396,468715,995c9bdb405cf8a6bf0eb66302b9d7dbf16c31eb
20200602,56,1835555,16097659,4054,33933,214845,7407,8566,3852,710,541976,2020-06-02T00:00:00Z,102131,214845,2020-06-02T00:00:00Z,17937268,17933214,17933214,962,1585,400600,20109,420709,b9735196c7df88e72159af0cd364d7db9496dd08
20200601,56,1815446,15697059,3455,34285,213260,7591,8485,3950,704,536339,2020-06-01T00:00:00Z,101169,213260,2020-06-01T00:00:00Z,17515960,17512505,17512505,668,2796,393669,20483,414152,2c41c26f30fb1073e0c06b2cd0f13083332e9fdc
20200531,56,1794963,15303390,3270,34859,210464,7626,8445,3669,704,522866,2020-05-31T00:00:00Z,100501,210464,2020-05-31T00:00:00Z,17101623,17098353,17098353,652,976,375191,21558,396749,0755e51520bfc878468c5ca311904f9a85085438
20200530,56,1773405,14928199,1668,35732,209488,7956,8305,4004,698,494569,2020-05-30T00:00:00Z,99849,209488,2020-05-30T00:00:00Z,16703272,16701604,16701604,932,1424,402861,23682,426543,1b10e64053e7b6c3c7ae22b76cac4ea82fb7a937
20200529,56,1749723,14525338,2978,36999,208064,8175,8235,4032,689,484554,2020-05-29T00:00:00Z,98917,208064,2020-05-29T00:00:00Z,16278039,16275061,16275061,1184,1715,465104,23573,488677,fb9a30d2193353e69682ddc402397b3e482661e1
20200528,56,1726150,14060234,1906,38069,206349,8389,8109,4080,676,478099,2020-05-28T00:00:00Z,97733,206349,2020-05-28T00:00:00Z,15788290,15786384,15786384,1231,1630,413429,22631,436060,10af9dae8ecb6254a3be3892b3dbdc273d7224cd
20200527,56,1703519,13646805,3132,38373,204719,8547,8015,4222,666,391508,2020-05-27T00:00:00Z,96502,204719,2020-05-27T00:00:00Z,15353456,15350324,15350324,1321,1713,290562,19437,309999,342c94c28ad45cda8b389094c96acca471b83c45
20200526,56,1684082,13356243,1549,37779,203006,8585,7899,4215,650,384902,2020-05-26T00:00:00Z,95181,203006,2020-05-26T00:00:00Z,15041874,15040325,15040325,645,17320,291055,16752,307807,e996083bb1641e7d8751f62dd0d5e08e7e41d057
20200525,56,1667330,13065188,3368,37650,185686,8472,7847,4237,642,379157,2020-05-25T00:00:00Z,94536,185686,2020-05-25T00:00:00Z,14735886,14732518,14732518,559,1002,404718,18690,423408,d1414b5a8593e134bee6010dc8695d126a3b5c30
20200524,56,1648640,12660470,3860,37695,184684,8487,7801,4383,639,366736,2020-05-24T00:00:00Z,93977,184684,2020-05-24T00:00:00Z,14312970,14309110,14309110,680,921,361940,20046,381986,01ec483c5f83cb0890824f48a25765b790c322f8
20200523,56,1628594,12298530,4084,38614,183763,8733,7770,4620,638,361239,2020-05-23T00:00:00Z,93297,183763,2020-05-23T00:00:00Z,13931208,13927124,13927124,1063,1378,369149,21530,390679,2de47b16a97b9da08bc4a81fd0588e463bfb0e89
20200522,56,1607064,11929381,3709,39989,182385,9048,7689,4716,633,350135,2020-05-22T00:00:00Z,92234,182385,2020-05-22T00:00:00Z,13540154,13536445,13536445,1341,4046,385791,24573,410364,6e230396c0410ae1ce15687d7dbc1f841866d609
20200521,56,1582491,11543590,3641,41191,178339,9090,7412,4868,616,298418,2020-05-21T00:00:00Z,90893,178339,2020-05-21T00:00:00Z,13129722,13126081,13126081,1394,4630,436275,26605,462880,7ae7f5ba30701e74269a02672763307de6976808
20200520,56,1555886,11107315,2973,41762,173709,9522,7319,4911,613,294312,2020-05-20T00:00:00Z,89499,173709,2020-05-20T00:00:00Z,12666174,12663201,12663201,1399,1996,387243,21338,408581,c4a3a6114a336f2f16dc2c0a2264f1464c8057b7
20200519,56,1534548,10720072,2944,41872,171713,9597,7217,5032,606,289484,2020-05-19T00:00:00Z,88100,171713,2020-05-19T00:00:00Z,12257564,12254620,12254620,1326,1597,381974,20902,402876,cbd693a4123284fbbf89c8f6ae2f80e791f9a499
20200518,56,1513646,10338098,3596,41748,170116,9755,7064,5257,602,283178,2020-05-18T00:00:00Z,86774,170116,2020-05-18T00:00:00Z,11855340,11851744,11851744,848,1157,335177,21016,356193,b2bf0db92c2c2b15dc0a3a7f39f5a00d40bb7d12
20200517,56,1492630,10002921,3449,41785,168959,9932,7003,5467,593,272265,2020-05-17T00:00:00Z,85926,168959,2020-05-17T00:00:00Z,11499000,11495551,11495551,849,1199,351570,20082,371652,28158425b9567c7605c166f56e0b5faa85fd1d8e
20200516,56,1472548,9651351,3788,43396,167760,10277,6945,5529,592,268376,2020-05-16T00:00:00Z,85077,167760,2020-05-16T00:00:00Z,11127687,11123899,11123899,988,1856,338158,24631,362789,934d9aa8bf98f25bd6d9f6fd7d98d3eecdc73266
20200515,56,1447917,9313193,2457,44491,165904,10472,6890,5746,589,250747,2020-05-15T00:00:00Z,84089,165904,2020-05-15T00:00:00Z,10763567,10761110,10761110,1507,1353,334713,24747,359460,6b1693180eca18cada72ca16f8a56dce280b657e
20200514,56,1423170,8978480,2673,45790,164551,10656,6795,5940,582,246414,2020-05-14T00:00:00Z,82582,164551,2020-05-14T00:00:00Z,10404323,10401650,10401650,1880,3206,338711,26731,365442,46e184c8c60dd9eecc1d88f0562d548837217162
20200513,56,1396439,8639769,1983,46926,161345,10978,6713,6156,572,243430,2020-05-13T00:00:00Z,80702,161345,2020-05-13T00:00:00Z,10038191,10036208,10036208,1704,1809,299164,21274,320438,829635eaf6429e47800496b26decaa91ca5d58fb
20200512,56,1375165,8340605,1803,47596,159536,11241,5595,6352,559,238857,2020-05-12T00:00:00Z,78998,159536,2020-05-12T00:00:00Z,9717573,9715770,9715770,1486,1579,286983,22702,309685,17d9b170a7b75e897a23e839e5250e91b74fb952
20200511,56,1352463,8053622,1989,46552,157957,11147,6488,6350,551,232142,2020-05-11T00:00:00Z,77512,157957,2020-05-11T00:00:00Z,9408074,9406085,9406085,892,1238,365238,18240,383478,82c22c59f715df20152a811dbbfd8fa14b8b63b8
20200510,56,1334223,7688384,3095,47163,156719,11393,6445,6395,547,215591,2020-05-10T00:00:00Z,76620,156719,2020-05-10T00:00:00Z,9025702,9022607,9022607,1036,1055,245353,21392,266745,b088f2c4606604b14c0de99e5bb1b02647577ee8
20200509,56,1312831,7443031,3054,48768,155664,11496,6367,6551,543,211976,2020-05-09T00:00:00Z,75584,155664,2020-05-09T00:00:00Z,8758916,8755862,8755862,1445,1708,267236,24787,292023,4ad319d11c377e29c3381a20611d997343d9d986
20200508,56,1288044,7175795,3307,49992,153956,11780,6294,6788,531,198459,2020-05-08T00:00:00Z,74139,153956,2020-05-08T00:00:00Z,8467146,8463839,8463839,1798,6892,271123,27648,298771,f072bd9777b19b66ce316fda9a69bbe9af21d29e
20200507,56,1260396,6904672,3171,51683,147064,12137,5174,7070,529,194528,2020-05-07T00:00:00Z,72341,147064,2020-05-07T00:00:00Z,8168239,8165068,8165068,2752,3742,275015,27559,302574,eb954d1dfafa0645219dcc9aae8498c493d2a51d
20200506,56,1232837,6629657,2742,52773,143322,12478,4911,4753,449,189425,2020-05-06T00:00:00Z,69589,143322,2020-05-06T00:00:00Z,7865236,7862494,7862494,1950,2119,220849,25097,245946,7848727c93156973c5b850b1fbd28d793ebf6ea4
20200505,56,1207740,6408808,2633,53455,141203,12629,4794,4818,439,189336,2020-05-05T00:00:00Z,67639,141203,2020-05-05T00:00:00Z,7619181,7616548,7616548,2452,1983,250081,22446,272527,ca8bb8c741913a551dd8fb9b2e3d95c19535f551
20200504,56,1185294,6158727,2791,52634,139220,12696,4579,4848,430,186752,2020-05-04T00:00:00Z,65187,139220,2020-05-04T00:00:00Z,7346812,7344021,7344021,1035,1651,209668,22643,232311,db325338dd0497af0f5429cf1d4f3b84ffe0cd41
20200503,56,1162651,5949059,2812,52857,137569,12722,4502,4761,425,179733,2020-05-03T00:00:00Z,64152,137569,2020-05-03T00:00:00Z,7114522,7111710,7111710,1231,1963,211117,25710,236827,26b42da8f5a7d3ef5a1dc2c39fd4d94273cd76f7
20200502,56,1136941,5737942,1578,54278,135606,12904,4386,4845,375,174987,2020-05-02T00:00:00Z,62921,135606,2020-05-02T00:00:00Z,6876461,6874883,6874883,1564,2031,218321,29148,247469,cc8787423429be56479fe577d0c815bcc45cc9eb
20200501,56,1107793,5519621,1639,55122,133575,12845,4300,4707,376,163644,2020-05-01T00:00:00Z,61357,133575,2020-05-01T00:00:00Z,6629053,6627414,6627414,1777,9789,263100,33029,296129,d6ea4f79d8f2e14a4e32a72131f2f1054e103290
20200430,56,1074764,5256521,2775,55114,123786,13255,4192,4712,373,154648,2020-04-30T00:00:00Z,59580,123786,2020-04-30T00:00:00Z,6334060,6331285,6331285,2140,2290,203903,29549,233452,cb9b828cd51b47e55526381d245e85ea951366fc
20200429,56,1045215,5052618,4832,56206,121496,13535,4093,4796,365,147165,2020-04-29T00:00:00Z,57440,121496,2020-04-29T00:00:00Z,6102665,6097833,6097833,2713,3415,212653,26725,239378,b3e7200c1b637b1eb8584588e1662051d9c102bb
20200428,56,1018490,4839965,4206,56255,118081,13562,3798,4760,195,139041,2020-04-28T00:00:00Z,54727,118081,2020-04-28T00:00:00Z,5862661,5858455,5858455,2072,2079,181953,25282,207235,999763bd5962dcb828676dfe2ffdcf0b1df3726e
20200427,56,993208,4658012,4077,56191,116002,13812,3720,4867,195,121323,2020-04-27T00:00:00Z,52655,116002,2020-04-27T00:00:00Z,5655297,5651220,5651220,1270,3076,173380,22700,196080,263ea3f40df9526aa88d38a84306f0e51d4dcc7f
20200426,56,970508,4484632,4445,56186,112926,14099,2571,5121,227,116529,2020-04-26T00:00:00Z,51385,112926,2020-04-26T00:00:00Z,5459585,5455140,5455140,1214,2192,179284,27311,206595,ea1542909e027c1618cbc8fa53799754b83a5e03
20200425,56,943197,4305348,5315,57377,110734,14414,2516,5266,227,112539,2020-04-25T00:00:00Z,50171,110734,2020-04-25T00:00:00Z,5253860,5248545,5248545,1748,2456,240717,35870,276587,23016e19d95cf1dfe596ce8b3a50894832978c2a
20200424,56,907327,4064631,4396,57300,108278,14602,2468,5187,227,101296,2020-04-24T00:00:00Z,48423,108278,2020-04-24T00:00:00Z,4976354,4971958,4971958,1895,2338,202285,34239,236524,878de9f83aa5717c54cd280a755c4f6144749a8c
20200423,56,873088,3862346,4258,58989,105940,14744,2428,5464,227,96921,2020-04-23T00:00:00Z,46528,105940,2020-04-23T00:00:00Z,4739692,4735434,4735434,1791,2802,161630,31805,193435,3ca8c66e2e8f5ef38f4209a314b5bdb121dd6461
20200422,56,841283,3700716,4191,59205,103138,15015,2370,5474,227,92978,2020-04-22T00:00:00Z,44737,103138,2020-04-22T00:00:00Z,4546190,4541999,4541999,2098,3087,295229,28957,324186,d1e516b19c4bf6e20f1a1016f44ab2cee1064d46
20200421,56,812326,3405487,3956,59780,100051,14941,2315,5514,214,72842,2020-04-21T00:00:00Z,42639,100051,2020-04-21T00:00:00Z,4221769,4217813,4217813,2467,2682,127063,26360,153423,a7dc2be0aee5dd7ac8678771d80e11799cb4ade5
20200420,56,785966,3278424,4037,56783,97369,14489,2193,5567,214,69493,2020-04-20T00:00:00Z,40172,97369,2020-04-20T00:00:00Z,4068427,4064390,4064390,1798,2211,120369,25899,146268,4e581078ad787c7487533f5415e9122a9dceb574
20200419,56,760067,3158055,11324,56526,95158,14410,2145,5603,214,67205,2020-04-19T00:00:00Z,38374,95158,2020-04-19T00:00:00Z,3929446,3918122,3918122,1772,2239,126832,27388,154220,47574903797ff0e508b690f703233890c50bc95e
20200418,56,732679,3031223,9906,57761,92919,14768,2096,5729,205,62840,2020-04-18T00:00:00Z,36602,92919,2020-04-18T00:00:00Z,3773808,3763902,3763902,1893,3563,118251,27905,146156,22b41490f06a563f42ea095067a82d423a4f6af1
20200417,56,704774,2912972,10889,58895,89356,14890,2052,6096,148,53533,2020-04-17T00:00:00Z,34709,89356,2020-04-17T00:00:00Z,3628635,3617746,3617746,2120,3405,127342,32013,159355,157c08f92e1cbda59c4fd314482c02fb498962ec
20200416,56,672761,2785630,16927,59499,85951,15130,1834,5940,137,48851,2020-04-16T00:00:00Z,32589,85951,2020-04-16T00:00:00Z,3475318,3458391,3458391,2200,3071,133173,30979,164152,c83103b56a47ccbf3262853a71991e7b1adc7db6
20200415,56,641782,2652457,16901,59940,82880,14647,1783,6032,223,43435,2020-04-15T00:00:00Z,30389,82880,2020-04-15T00:00:00Z,3311140,3294239,3294239,2544,4434,107024,30310,137334,c046306b8cf91aa36dabc744206c6eb9fca022e8
20200414,56,611472,2545433,16615,59601,78446,14039,1715,5975,221,39268,2020-04-14T00:00:00Z,27845,78446,2020-04-14T00:00:00Z,3173520,3156905,3156905,2336,3282,126412,25709,152121,faa2ecec8c5796745c8c28bdcb910c61fab17475
20200413,56,585763,2419021,17159,56195,75164,13632,1628,6168,210,35372,2020-04-13T00:00:00Z,25509,75164,2020-04-13T00:00:00Z,3021943,3004784,3004784,1644,4285,109349,25200,134549,5e98bb24cdfff2a85ae08bcd0b9a224d1b1d0699
20200412,56,560563,2309672,16419,55426,70879,13623,1455,5986,160,34081,2020-04-12T00:00:00Z,23865,70879,2020-04-12T00:00:00Z,2886654,2870235,2870235,1703,3288,111204,27763,138967,4d457b77f365f58f96af55b66cbd159d1d3acc2d
20200411,56,532800,2198468,16593,55572,67591,13280,1405,5978,154,31567,2020-04-11T00:00:00Z,22162,67591,2020-04-11T00:00:00Z,2747861,2731268,2731268,2055,2825,106592,30506,137098,199ab4b6100e2749d7a47d9f9043988f100dced5
20200410,56,502294,2091876,17435,52723,64766,12698,1185,5937,41,28997,2020-04-10T00:00:00Z,20107,64766,2020-04-10T00:00:00Z,2611605,2594170,2594170,2108,4934,124192,34383,158575,d0822d8a82e25361a8742bd8da94e9e11ae73d9b
20200409,56,467911,1967684,17622,50859,59832,12254,924,5794,39,24819,2020-04-09T00:00:00Z,17999,59832,2020-04-09T00:00:00Z,2453217,2435595,2435595,2043,3923,136748,34495,171243,4f4811f71616a45f0c0e16e2ad41cd61f49f841a
20200408,56,433416,1830936,17219,45141,55909,10180,1013,4131,216,21102,2020-04-08T00:00:00Z,15956,55909,2020-04-08T00:00:00Z,2281571,2264352,2264352,2010,4311,117154,30595,147749,d49636cba5a009e2af8ac1ff165c39927cf0d8ef
20200407,56,402821,1713782,16548,43465,51598,9821,889,4076,151,18443,2020-04-07T00:00:00Z,13946,51598,2020-04-07T00:00:00Z,2133151,2116603,2116603,2024,2981,123604,30885,154489,ccaae9900fa293c7103c1a462709d579afdeee2d
20200406,56,371936,1590178,17283,35856,48617,6943,814,2961,147,16554,2020-04-06T00:00:00Z,11922,48617,2020-04-06T00:00:00Z,1979397,1962114,1962114,1318,2946,123253,29002,152255,7bdb492c4a9f53578172bc31bd36dbaddf8b8c93
20200405,56,342934,1466925,17303,31875,45671,5677,760,652,147,14513,2020-04-05T00:00:00Z,10604,45671,2020-04-05T00:00:00Z,1827162,1809859,1809859,1340,3903,94299,25500,119799,bab3b241ba234c98db9c86117a90162721f402d0
20200404,56,317434,1372626,15569,29987,41768,5383,554,656,147,12816,2020-04-04T00:00:00Z,9264,41768,2020-04-04T00:00:00Z,1705629,1690060,1690060,1482,5086,196066,33212,229278,f782ccc7f29b57173f5bfd5499a0ad1495775e6a
20200403,56,284222,1176560,61976,25472,36682,4811,486,605,147,10861,2020-04-03T00:00:00Z,7782,36682,2020-04-03T00:00:00Z,1522758,1460782,1460782,1286,4554,101013,32076,133089,e22d16fde28e0223655503542173bce0a8f19bac
20200402,56,252146,1075547,62097,22764,32128,4410,456,574,140,8586,2020-04-02T00:00:00Z,6496,32128,2020-04-02T00:00:00Z,1389790,1327693,1327693,1172,4175,91058,28057,119115,aaff599a781f9607c2ba9f0c7f77ccfa6006a2d5
20200401,56,224089,984489,59665,20775,27953,3937,407,561,140,7084,2020-04-01T00:00:00Z,5324,27953,2020-04-01T00:00:00Z,1268243,1208578,1208578,1010,4228,82981,25785,108766,9fabd19f9aef37fb5a665ac9d4a1875e6c0445be
20200331,56,198304,901508,59518,18082,23725,3487,236,507,,5666,2020-03-31T00:00:00Z,4314,23725,2020-03-31T00:00:00Z,1159330,1099812,1099812,890,3906,87657,24848,112505,1b233a3147528396eb83532c59757880f63200a4
20200330,56,173456,813851,65369,15772,19819,3087,187,451,,4560,2020-03-30T00:00:00Z,3424,19819,2020-03-30T00:00:00Z,1052676,987307,987307,589,2536,96706,22055,118761,6f217965b77d50118da4490c355ab2c0f5f5c8b9
20200329,56,151401,717145,65545,14026,17283,2456,156,439,,4052,2020-03-29T00:00:00Z,2835,17283,2020-03-29T00:00:00Z,934091,868546,868546,521,2775,68187,19579,87766,de7b400973a6b37cc386e1e1d58f08b1105c8fb9
20200328,56,131822,648958,65709,12350,14508,2174,140,390,,3143,2020-03-28T00:00:00Z,2314,14508,2020-03-28T00:00:00Z,846489,780780,780780,538,2425,87375,19691,107066,ae062586b01b7291b5422d59c89f7636aa581cc6
20200327,56,112131,561583,60091,10932,12083,1792,124,324,,2418,2020-03-27T00:00:00Z,1776,12083,2020-03-27T00:00:00Z,733805,673714,673714,406,2563,83781,19132,102913,cb6ace5b40d0982b2322400d0334cdd918fd8641
20200326,56,92999,477802,60251,7757,9520,1299,91,258,,97,2020-03-26T00:00:00Z,1370,9520,2020-03-26T00:00:00Z,631052,570801,570801,320,2499,84311,17720,102031,7ffadc86d5ba9a725acbe621555f32b1f86308a2
20200325,56,75279,393491,51235,5062,7021,,74,167,,146,2020-03-25T00:00:00Z,1050,7021,2020-03-25T00:00:00Z,520005,468770,468770,235,1904,71728,12907,84635,2e7da6b2900e763fbd6883d8b6df72f2a97af178
20200324,56,62372,321763,14433,3902,5117,,,,,,2020-03-24T00:00:00Z,815,5117,2020-03-24T00:00:00Z,398568,384135,384135,234,1180,58695,10715,69410,3deabecb0f0669ccbcfe7c85a8f7d944332aacc8
20200323,56,51657,263068,14571,2770,3937,,,,,,2020-03-23T00:00:00Z,581,3937,2020-03-23T00:00:00Z,329296,314725,314725,101,914,46894,11458,58352,5b6e3cba054a79fc4063965d15dbdb1b7441438e
20200322,56,40199,216174,2842,2155,3023,,,,,,2020-03-22T00:00:00Z,480,3023,2020-03-22T00:00:00Z,259215,256373,256373,146,1003,36456,9161,45617,7412494cd635d521c67f46a6de323a49de98c4c0
20200321,56,31038,179718,3468,1436,2020,,,,,,2020-03-21T00:00:00Z,334,2020,2020-03-21T00:00:00Z,214224,210756,210756,62,1912,38628,6793,45421,4b8e97a8a431ecdfda932289989c19d9640d5ba6
20200320,56,24245,141090,3330,1042,108,,,,,,2020-03-20T00:00:00Z,272,108,2020-03-20T00:00:00Z,168665,165335,165335,69,23,30568,6153,36721,516a6ee00503b11ada5bf43e828220515c67eb96
20200319,56,18092,110522,3016,617,85,,,,,,2020-03-19T00:00:00Z,203,85,2020-03-19T00:00:00Z,131630,128614,128614,48,18,23323,4668,27991,9c4f7a482630174f88e6e6960e9b2a844a66325e
20200318,56,13424,87199,2526,416,67,,,,,,2020-03-18T00:00:00Z,155,67,2020-03-18T00:00:00Z,103149,100623,100623,32,12,22068,3082,25150,8e489a6f0ea0b274614f368abf95c2f50f938c6b
20200317,56,10342,65131,1687,325,55,,,,,,2020-03-17T00:00:00Z,123,55,2020-03-17T00:00:00Z,77160,75473,75473,23,13,13945,3552,17497,3b5742f5fd39897a407debbaa00ce8495f87b719
20200316,56,6790,51186,1691,,42,,,,,,2020-03-16T00:00:00Z,100,42,2020-03-16T00:00:00Z,59667,57976,57976,21,6,16525,1500,18025,c527952c805fa68b875f1bb51443394c5e270f14
20200315,51,5290,34661,2242,,36,,,,,,2020-03-15T00:00:00Z,79,36,2020-03-15T00:00:00Z,42193,39951,39951,15,10,6553,1105,7658,8e24978be2f3b91f0bd6547e44c1f8e5485731a9
20200314,51,4185,28108,1236,,26,,,,,,2020-03-14T00:00:00Z,64,26,2020-03-14T00:00:00Z,33529,32293,32293,9,4,3852,805,4657,0ecbb1b210d6ea168418107cf21e3b7805816204
20200313,51,3380,24256,1130,,22,,,,,,2020-03-13T00:00:00Z,55,22,2020-03-13T00:00:00Z,28766,27636,27636,4,6,8318,945,9263,2d1f0462bd1ba6cbbc2eddcf4b7fd867e116af52
20200312,51,2435,15938,673,,16,,,,,,2020-03-12T00:00:00Z,51,16,2020-03-12T00:00:00Z,19046,18373,18373,8,5,4750,605,5355,e6e4cf8931136594b719687cd43891e23ccab389
20200311,51,1830,11188,563,,11,,,,,,2020-03-11T00:00:00Z,43,11,2020-03-11T00:00:00Z,13581,13018,13018,6,3,3421,449,3870,472368b5d1cc7fa9faee6b4fe481b7258230d6a3
20200310,51,1381,7767,469,,8,,,,,,2020-03-10T00:00:00Z,37,8,2020-03-10T00:00:00Z,9617,9148,9148,2,0,2184,335,2519,87c96b16327539e1ef678e987cc88943c82b9154
20200309,51,1046,5583,313,,8,,,,,,2020-03-09T00:00:00Z,35,8,2020-03-09T00:00:00Z,6942,6629,6629,4,2,1534,256,1790,ba95ab8bd3c9ea70dbc2d13e7ef71f649462a566
20200308,51,790,4049,347,,6,,,,,,2020-03-08T00:00:00Z,31,6,2020-03-08T00:00:00Z,5186,4839,4839,4,0,716,175,891,6c4cf875eb0c839ab83b5b3c9bdb0a9848a38ace
20200307,51,615,3333,602,,6,,,,,,2020-03-07T00:00:00Z,27,6,2020-03-07T00:00:00Z,4550,3948,3948,1,0,661,159,820,c46ad096daea95f6c0047d56076a9902d35eb86b
20200306,37,456,2672,458,,6,,,,,,2020-03-06T00:00:00Z,26,6,2020-03-06T00:00:00Z,3586,3128,3128,6,1,723,98,821,83c916e80b3991768afba460a99948cc5069f368
20200305,25,358,1949,197,,5,,,,,,2020-03-05T00:00:00Z,20,5,2020-03-05T00:00:00Z,2504,2307,2307,4,1,532,99,631,97c301d16d60e86e9c23437b2094fb5a33ff6424
20200304,18,259,1417,103,,4,,,,,,2020-03-04T00:00:00Z,16,4,2020-03-04T00:00:00Z,1779,1676,1676,2,4,971,133,1104,a0c1db244272352b4267a9666ee35a1831672731
20200303,6,126,446,,,,,,,,,2020-03-03T00:00:00Z,14,,2020-03-03T00:00:00Z,572,572,572,3,0,203,41,244,843f99203fe8e103e33be57dcdf8ce42cf9bc97c
20200302,6,85,243,,,,,,,,,2020-03-02T00:00:00Z,11,,2020-03-02T00:00:00Z,328,328,328,3,0,158,40,198,0dbf0f7f44027f3502bac3535542a5e437a9081a
20200301,6,45,85,,,,,,,,,2020-03-01T00:00:00Z,8,,2020-03-01T00:00:00Z,130,130,130,3,0,61,27,88,018bc6d00fd64a77414f423a82714017e60f967d
20200229,4,18,24,,,,,,,,,2020-02-29T00:00:00Z,5,,2020-02-29T00:00:00Z,42,42,42,1,0,24,18,42,e8bfe9db6d823a5eb909810abef9887d2fbb9898
20200228,4,0,0,,,,,,,,,2020-02-28T00:00:00Z,4,,2020-02-28T00:00:00Z,0,0,0,2,0,0,0,0,e32d96910062fcdd632e72d59dd6218420709f43
20200227,4,0,0,,,,,,,,,2020-02-27T00:00:00Z,2,,2020-02-27T00:00:00Z,0,0,0,0,0,0,0,0,7a6b9c55e5b2e48605fbbb652ed9d8f6ce0c516f
20200226,3,0,0,,,,,,,,,2020-02-26T00:00:00Z,2,,2020-02-26T00:00:00Z,0,0,0,2,0,0,0,0,7fd18cfd695b3876452a4759c07cd74b431c70c1
20200225,3,0,0,,,,,,,,,2020-02-25T00:00:00Z,0,,2020-02-25T00:00:00Z,0,0,0,0,0,0,0,0,546df3c71998c4cf4188373d077f4cedc6933d9a
20200224,3,0,0,,,,,,,,,2020-02-24T00:00:00Z,0,,2020-02-24T00:00:00Z,0,0,0,0,0,0,0,0,892a45536b84803c54018d56c49b4613372218e7
20200223,3,0,0,,,,,,,,,2020-02-23T00:00:00Z,0,,2020-02-23T00:00:00Z,0,0,0,0,0,0,0,0,f1629457f5b903efc056266d3a003a077fe44425
20200222,3,0,0,,,,,,,,,2020-02-22T00:00:00Z,0,,2020-02-22T00:00:00Z,0,0,0,0,0,0,0,0,4df67d2b63bed863d76d69d00698ebdcdc31b3f3
20200221,3,0,0,,,,,,,,,2020-02-21T00:00:00Z,0,,2020-02-21T00:00:00Z,0,0,0,0,0,0,0,0,7f0ac856ef16728ed819d4e3b659102c49f6e43a
20200220,3,0,0,,,,,,,,,2020-02-20T00:00:00Z,0,,2020-02-20T00:00:00Z,0,0,0,0,0,0,0,0,1a9852cb7d8d92b28347aab35eb5606e372cadd5
20200219,3,0,0,,,,,,,,,2020-02-19T00:00:00Z,0,,2020-02-19T00:00:00Z,0,0,0,0,0,0,0,0,2c972a64785dd342fbad97e1f5cd9a407c7ac107
20200218,3,0,0,,,,,,,,,2020-02-18T00:00:00Z,0,,2020-02-18T00:00:00Z,0,0,0,0,0,0,0,0,b9771c64ca39cb7675bfcdd2c13a4f720f069aba
20200217,3,0,0,,,,,,,,,2020-02-17T00:00:00Z,0,,2020-02-17T00:00:00Z,0,0,0,0,0,0,0,0,821066754b993d15d0e3bd05685c12a7cfe5cb90
20200216,3,0,0,,,,,,,,,2020-02-16T00:00:00Z,0,,2020-02-16T00:00:00Z,0,0,0,0,0,0,0,0,d1632c4c6ea11aa1d09af42a855d36db099d88c4
20200215,3,0,0,,,,,,,,,2020-02-15T00:00:00Z,0,,2020-02-15T00:00:00Z,0,0,0,0,0,0,0,0,2dc9b940ebd2554cd84851a061392a921bbeb8fe
20200214,3,0,0,,,,,,,,,2020-02-14T00:00:00Z,0,,2020-02-14T00:00:00Z,0,0,0,0,0,0,0,0,214f6ca03432d7f44929bddd86d47bd61a2e1d7e
20200213,3,0,0,,,,,,,,,2020-02-13T00:00:00Z,0,,2020-02-13T00:00:00Z,0,0,0,0,0,0,0,0,399329390bce10053bffcf0d122965a19a3a93a9
20200212,3,0,0,,,,,,,,,2020-02-12T00:00:00Z,0,,2020-02-12T00:00:00Z,0,0,0,0,0,0,0,0,68df6880bf30101ac41e4b6a21dbd8787c7d4a71
20200211,3,0,0,,,,,,,,,2020-02-11T00:00:00Z,0,,2020-02-11T00:00:00Z,0,0,0,0,0,0,0,0,dd890414f05d64e4fbc01124e0964c9b5b8a1af3
20200210,3,0,0,,,,,,,,,2020-02-10T00:00:00Z,0,,2020-02-10T00:00:00Z,0,0,0,0,0,0,0,0,5c4dde7942c1a28345dc78492e2a9c5afd52cc62
20200209,2,0,0,,,,,,,,,2020-02-09T00:00:00Z,,,2020-02-09T00:00:00Z,0,0,0,0,0,0,0,0,69ce4ee6b68fbf3c0eea00424415f9af7f342956
20200208,2,0,0,,,,,,,,,2020-02-08T00:00:00Z,,,2020-02-08T00:00:00Z,0,0,0,0,0,0,0,0,435f978d8dea79d19330ac9edb3f96fde50953df
20200207,2,0,0,,,,,,,,,2020-02-07T00:00:00Z,,,2020-02-07T00:00:00Z,0,0,0,0,0,0,0,0,98d1490aa9817eb65d40f5ae6b09b3f58ff7d9ce
20200206,2,0,0,,,,,,,,,2020-02-06T00:00:00Z,,,2020-02-06T00:00:00Z,0,0,0,0,0,0,0,0,6424ce9e48ad97b680db81aa6c0d06c09a473f69
20200205,2,0,0,,,,,,,,,2020-02-05T00:00:00Z,,,2020-02-05T00:00:00Z,0,0,0,0,0,0,0,0,9a8c8b7eac1d419c7aa04a84bc9bc7ec0bb92da7
20200204,2,0,0,,,,,,,,,2020-02-04T00:00:00Z,,,2020-02-04T00:00:00Z,0,0,0,0,0,0,0,0,16c916bcaa18b0aa6f02f6c97718e50c5443cd9c
20200203,2,0,0,,,,,,,,,2020-02-03T00:00:00Z,,,2020-02-03T00:00:00Z,0,0,0,0,0,0,0,0,c542f7ad74541b08270d6925274eece2c4f79334
20200202,2,0,0,,,,,,,,,2020-02-02T00:00:00Z,,,2020-02-02T00:00:00Z,0,0,0,0,0,0,0,0,a1dd021af3e12d2a218df294663d03bdd573a330
20200201,2,0,0,,,,,,,,,2020-02-01T00:00:00Z,,,2020-02-01T00:00:00Z,0,0,0,0,0,0,0,0,10c29665184670bf22ba060ebb5650e298a6d1b8
20200131,2,0,0,,,,,,,,,2020-01-31T00:00:00Z,,,2020-01-31T00:00:00Z,0,0,0,0,0,0,0,0,529c83fead59f5b26a9898ce39996851806f9a2f
20200130,2,0,0,,,,,,,,,2020-01-30T00:00:00Z,,,2020-01-30T00:00:00Z,0,0,0,0,0,0,0,0,82859b598bd6e9643d8dc3b69b99d74c4f061282
20200129,2,0,0,,,,,,,,,2020-01-29T00:00:00Z,,,2020-01-29T00:00:00Z,0,0,0,0,0,0,0,0,5829b18554ba8cfdd449dcdf8a767aaf8af806b2
20200128,2,0,0,,,,,,,,,2020-01-28T00:00:00Z,,,2020-01-28T00:00:00Z,0,0,0,0,0,0,0,0,1e004b11f0e9c340d0e206a5e168b5ac2c154421
20200127,2,0,0,,,,,,,,,2020-01-27T00:00:00Z,,,2020-01-27T00:00:00Z,0,0,0,0,0,0,0,0,0dbe12f64745ae2d9e59003e934d50c66164fff3
20200126,2,0,0,,,,,,,,,2020-01-26T00:00:00Z,,,2020-01-26T00:00:00Z,0,0,0,0,0,0,0,0,acd8dfc63d3542d3d579778290d4601b2433e48c
20200125,2,0,0,,,,,,,,,2020-01-25T00:00:00Z,,,2020-01-25T00:00:00Z,0,0,0,0,0,0,0,0,e90258fa02cb55fd9357b389669ed1940e381bbd
20200124,2,0,0,,,,,,,,,2020-01-24T00:00:00Z,,,2020-01-24T00:00:00Z,0,0,0,0,0,0,0,0,babd004bb329a35eea647d8b431604c1a9ea2f97
20200123,2,0,0,,,,,,,,,2020-01-23T00:00:00Z,,,2020-01-23T00:00:00Z,0,0,0,0,0,0,0,0,d9b1df660fd87df4ddc10fd71d5d024e1080fe06
20200122,2,0,0,,,,,,,,,2020-01-22T00:00:00Z,,,2020-01-22T00:00:00Z,0,0,0,0,0,0,0,0,6955b9b8d895cdd26f91da2aedc369265b908816
