date,states,positive,negative,pending,hospitalizedCurrently,hospitalizedCumulative,inIcuCurrently,inIcuCumulative,onVentilatorCurrently,onVentilatorCumulative,recovered,dateChecked,death,hospitalized,lastModified,total,totalTestResults,posNeg,deathIncrease,hospitalizedIncrease,negativeIncrease,positiveIncrease,totalTestResultsIncrease,hash
20200702,56,2727628,30734553,2208,37114,245722,5609,10816,2105,1041,781970,2020-07-02T00:00:00Z,121497,245722,2020-07-02T00:00:00Z,33464389,33462181,33462181,644,1876,582007,52815,634822,14bcec9ebfcc8cf4f83f1bf9d72152e764332bea
20200701,56,2674813,30152546,2604,35937,243846,5494,10752,2098,1027,729994,2020-07-01T00:00:00Z,120853,243846,2020-07-01T00:00:00Z,32829963,32827359,32827359,701,1438,568132,52982,621114,f2966df0f86a9c1441db7ec10133690a51db09b6
20200630,56,2621831,29584414,2432,34830,242408,5406,10669,2044,1008,720631,2020-06-30T00:00:00Z,120152,242408,2020-06-30T00:00:00Z,32208677,32206245,32206245,596,1582,604480,44358,648838,480e9c7356c3b9278e1276e93eba16989d51c51f
20200629,56,2577473,28979934,2194,33198,240826,5363,10542,2011,990,705203,2020-06-29T00:00:00Z,119556,240826,2020-06-29T00:00:00Z,31559601,31557407,31557407,330,670,532904,36490,569394,1e5c023acc5e3dc40dfb5c8dcb85625f801ccba3
20200628,56,2540983,28447030,2198,32117,240156,5230,10473,2077,983,685164,2020-06-28T00:00:00Z,119226,240156,2020-06-28T00:00:00Z,30990211,30988013,30988013,271,580,544208,42161,586369,5a80c658c8584c128e199ee1f6a823f452739257
20200627,56,2498822,27902822,2186,32220,239576,5296,10415,2159,977,679308,2020-06-27T00:00:00Z,118955,239576,2020-06-27T00:00:00Z,30403830,30401644,30401644,509,1057,547406,43471,590877,3558ecd03d1837271b410b73ea30e75e56c71abe
20200626,56,2455351,27355416,2201,31423,238519,5263,10334,2075,966,670809,2020-06-26T00:00:00Z,118446,238519,2020-06-26T00:00:00Z,29812968,29810767,29810767,636,1526,558574,44373,602947,91c0cf312971935a3905787e570ad005b952b339
20200625,56,2410978,26796842,2133,31532,236993,5305,10257,2214,951,663562,2020-06-25T00:00:00Z,117810,236993,2020-06-25T00:00:00Z,29209953,29207820,29207820,2501,1257,598526,39061,637587,44b0688c96cce35f6bec5d7dffb4b1603c31567b
20200624,56,2371917,26198316,2049,30826,235736,5279,10173,2248,934,656161,2020-06-24T00:00:00Z,115309,235736,2020-06-24T00:00:00Z,28572282,28570233,28570233,724,1310,473722,38706,512428,12f85be17df5cf84068cbdd13a4771ee44b818c7
20200623,56,2333211,25724594,1891,29920,234426,5416,10077,2293,918,647548,2020-06-23T00:00:00Z,114585,234426,2020-06-23T00:00:00Z,28059696,28057805,28057805,708,1257,468396,33018,501414,9364b9dc40656b06337d93ca8254545f0fccfcf6
20200622,56,2300193,25256198,2028,28490,233169,5311,10002,2299,909,640198,2020-06-22T00:00:00Z,113877,233169,2020-06-22T00:00:00Z,27558419,27556391,27556391,283,800,437722,27080,464802,525651a247e47a31e276346d2868dfaadaa35d2f
20200621,56,2273113,24818476,2084,27718,232369,5155,9944,2321,904,622133,2020-06-21T00:00:00Z,113594,232369,2020-06-21T00:00:00Z,27093673,27091589,27091589,292,514,484921,27257,512178,ecb248d167fc3f71e7ca8060af6bb864f9f7d60b
20200620,56,2245856,24333555,2108,27757,231855,5220,9908,2380,888,617460,2020-06-20T00:00:00Z,113302,231855,2020-06-20T00:00:00Z,26581519,26579411,26579411,628,745,534518,31958,566476,563f7afaf63bd0d9114bd3cdabf2d8270dcbc854
20200619,56,2213898,23799037,2032,28392,231110,5332,9876,2434,884,606715,2020-06-19T00:00:00Z,112674,231110,2020-06-19T00:00:00Z,26014967,26012935,26012935,655,1613,540191,31055,571246,5eafc4efb2cbbf03e2515732ed3c056ebeb5523e
20200618,56,2182843,23258846,1903,28185,229497,5458,9736,2520,869,599288,2020-06-18T00:00:00Z,112019,229497,2020-06-18T00:00:00Z,25443592,25441689,25441689,704,1040,490227,27512,517739,7975b64e2112b17cf7f2ca8df26386364df78872
20200617,56,2155331,22768619,1745,28311,228457,5605,9665,2588,857,592191,2020-06-17T00:00:00Z,111315,228457,2020-06-17T00:00:00Z,24925695,24923950,24923950,767,1130,464880,23871,488751,173788c3ba06899c80b3a4b7accd84ee9e46fd86
20200616,56,2131460,22303739,1604,28028,227327,5564,9590,2594,845,583503,2020-06-16T00:00:00Z,110548,227327,2020-06-16T00:00:00Z,24436803,24435199,24435199,733,1325,443388,23638,467026,47b61f4e4e65fc39543697d609407a215632f0bd
20200615,56,2107822,21860351,1619,27115,226002,5695,9516,2636,835,576334,2020-06-15T00:00:00Z,109815,226002,2020-06-15T00:00:00Z,23969792,23968173,23968173,379,519,429084,18655,447739,df2732c0bd4c121d541cae870c373922c8f5ada3
20200614,56,2089167,21431267,1672,27247,225483,5743,9466,2716,834,561816,2020-06-14T00:00:00Z,109436,225483,2020-06-14T00:00:00Z,23522106,23520434,23520434,353,640,457329,21240,478569,304b2194c51c3cda6445e5bcca9c74448d58f62b
20200613,56,2067927,20973938,1698,27902,224843,5878,9430,2726,830,556606,2020-06-13T00:00:00Z,109083,224843,2020-06-13T00:00:00Z,23043563,23041865,23041865,690,1105,474694,25134,499828,6dbcb7da48ee6cff56ee12c7214b690d6e45d8a1
20200612,56,2042793,20499244,1783,28524,223738,6012,9373,2734,814,547386,2020-06-12T00:00:00Z,108393,223738,2020-06-12T00:00:00Z,22543820,22542037,22542037,772,1245,570835,23481,594316,78a6eed760037fffc07f4eedf575eae9d570299c
20200611,56,2019312,19928409,1816,29064,222493,6067,9295,2886,792,540292,2020-06-11T00:00:00Z,107621,222493,2020-06-11T00:00:00Z,21949537,21947721,21947721,898,1367,437028,22051,459079,3d360ea943cc372b85b3d6c72a275f980b892d07
20200610,56,1997261,19491381,1737,30203,221126,6242,9225,3020,780,533504,2020-06-10T00:00:00Z,106723,221126,2020-06-10T00:00:00Z,21490379,21488642,21488642,885,1484,408782,20764,429546,8e01c1aeea95fe5f64e89a1ca4e4dbea1f69a500
20200609,56,1976497,19082599,1661,30547,219642,6450,9141,3090,771,524855,2020-06-09T00:00:00Z,105838,219642,2020-06-09T00:00:00Z,21060757,21059096,21059096,898,1527,403307,17156,420463,2afa47810cacc5e8d554e75363c47dcc1ebd58f2
20200608,56,1959341,18679292,1606,29969,218115,6394,9013,3240,762,518522,2020-06-08T00:00:00Z,104940,218115,2020-06-08T00:00:00Z,20640239,20638633,20638633,660,714,386524,17168,403692,5e19c99da6f916c5f19b435254847e63926b50d3
20200607,56,1942173,18292768,1733,30299,217401,6493,8957,3298,753,506367,2020-06-07T00:00:00Z,104280,217401,2020-06-07T00:00:00Z,20236674,20234941,20234941,446,685,427569,18774,446343,c3bcf452e657b73f24e9da6ac61c7e82b81ba845
20200606,56,1923399,17865199,1796,30909,216716,6754,8920,3476,750,500849,2020-06-06T00:00:00Z,103834,216716,2020-06-06T00:00:00Z,19790394,19788598,19788598,727,1017,459876,23038,482914,740542e82e2fc34899415b3d6cbeba03857ca844
20200605,56,1900361,17405323,1749,31335,215699,6912,8863,3523,740,491706,2020-06-05T00:00:00Z,103107,215699,2020-06-05T00:00:00Z,19307433,19305684,19305684,823,1440,486103,23363,509466,810f5391cf9697e0a65343e2c5cca023bd30256c
20200604,56,1876998,16919220,3474,31659,214259,7054,8787,3665,723,485002,2020-06-04T00:00:00Z,102284,214259,2020-06-04T00:00:00Z,18799692,18796218,18796218,888,-2841,441422,20828,462250,fbbc9e2dbf12151a57179ffdd4a404d598bd5a04
20200603,56,1856170,16477798,3556,32081,217100,7224,8688,3749,717,479258,2020-06-03T00:00:00Z,101396,217100,2020-06-03T00:00:00Z,18337524,18333968,18333968,991,2255,447651,20314,467965,fd8fbc94725cdd217953271ea10cb519df3c93a6
20200602,56,1835856,16030147,4054,32728,214845,7403,8566,3852,710,463868,2020-06-02T00:00:00Z,100405,214845,2020-06-02T00:00:00Z,17870057,17866003,17866003,959,1585,399868,19996,419864,6e17dcd26270df0183e040b2fb223032fd65a4a5
20200601,56,1815860,15630279,3455,33160,213260,7588,8485,3950,704,458231,2020-06-01T00:00:00Z,99446,213260,2020-06-01T00:00:00Z,17449594,17446139,17446139,665,2796,392869,20379,413248,de26294d9e630a05611d5ed088404396fe81ea1b
20200531,56,1795481,15237410,3270,33840,210464,7623,8445,3669,704,444758,2020-05-31T00:00:00Z,98781,210464,2020-05-31T00:00:00Z,17036161,17032891,17032891,649,976,377749,21672,399421,c07ce8fd6f418f98f44348c34ecff612c9a16cac
20200530,56,1773809,14859661,1668,34650,209488,7956,8305,4004,698,416461,2020-05-30T00:00:00Z,98132,209488,2020-05-30T00:00:00Z,16635138,16633470,16633470,929,1424,403942,23842,427784,1132e9f5ea4880bb26b297c15037daf19ca2192c
20200529,56,1749967,14455719,2978,35871,208064,8175,8235,4032,689,406446,2020-05-29T00:00:00Z,97203,208064,2020-05-29T00:00:00Z,16208664,16205686,16205686,1179,1715,468019,23485,491504,c06eb12a529b5079cd176596060fb87560dc1566
20200528,56,1726482,13987700,1906,36967,206349,8389,8109,4080,676,399991,2020-05-28T00:00:00Z,96024,206349,2020-05-28T00:00:00Z,15716088,15714182,15714182,1226,1630,392705,22610,415315,714e77e88c8420d65871e86e26e631d720f02714
20200527,56,1703872,13594995,3132,37241,204719,8547,8015,4222,666,391508,2020-05-27T00:00:00Z,94798,204719,2020-05-27T00:00:00Z,15301999,15298867,15298867,1318,1713,290821,19395,310216,614801a058da60590cea81eeb2be2946178b11ce
20200526,56,1684477,13304174,1549,36609,203006,8585,7899,4215,650,384902,2020-05-26T00:00:00Z,93480,203006,2020-05-26T00:00:00Z,14990200,14988651,14988651,640,17320,290094,16620,306714,2d2a556f47b88ba995f29e1b78628ecb19028687
20200525,56,1667857,13014080,3368,36668,185686,8472,7847,4237,642,379157,2020-05-25T00:00:00Z,92840,185686,2020-05-25T00:00:00Z,14685305,14681937,14681937,555,1002,403040,18728,421768,ae620501760f0b7fe1d99cf1b3b1a322c3a1813c
20200524,56,1649129,12611040,3860,36706,184684,8487,7801,4383,639,366736,2020-05-24T00:00:00Z,92285,184684,2020-05-24T00:00:00Z,14264029,14260169,14260169,678,921,363099,20134,383233,b7d77fcd884dcb7e073ec09b76abb507697d9643
20200523,56,1628995,12247941,4084,37873,183763,8812,7770,4620,638,361239,2020-05-23T00:00:00Z,91607,183763,2020-05-23T00:00:00Z,13881020,13876936,13876936,1060,1378,369870,21698,391568,a7d0d0d257af037d4a68bac1d9664d1ca2367529
20200522,56,1607297,11878071,3709,38802,182385,9048,7689,4716,633,350135,2020-05-22T00:00:00Z,90547,182385,2020-05-22T00:00:00Z,13489077,13485368,13485368,1335,4046,386689,24519,411208,fb3429b900208bd40eb74409cb295322c90f2433
20200521,56,1582778,11491382,3641,39915,178339,9090,7412,4868,616,298418,2020-05-21T00:00:00Z,89212,178339,2020-05-21T00:00:00Z,13077801,13074160,13074160,1388,4630,395503,26559,422062,076e4a45183a68479ebaabb56f412ae517b156a0
20200520,56,1556219,11095879,2973,40884,173709,9829,7319,4911,613,294312,2020-05-20T00:00:00Z,87824,173709,2020-05-20T00:00:00Z,12655071,12652098,12652098,1392,1996,387192,21537,408729,3cede2b1e448265cae726d1e6aff306c0d1d4cb7
20200519,56,1534682,10708687,2944,41091,171713,9829,7217,5032,606,289484,2020-05-19T00:00:00Z,86432,171713,2020-05-19T00:00:00Z,12246313,12243369,12243369,1325,1597,380314,20794,401108,71887346b27378702ce92ea4a9a3b71b43b7f220
20200518,56,1513888,10328373,3596,40869,170116,9987,7064,5257,602,283178,2020-05-18T00:00:00Z,85107,170116,2020-05-18T00:00:00Z,11845857,11842261,11842261,844,1157,335145,20976,356121,be008c13900ae302c7f049df9351f325dbd8b386
20200517,56,1492912,9993228,3449,41108,168959,10164,7003,5467,593,272265,2020-05-17T00:00:00Z,84263,168959,2020-05-17T00:00:00Z,11489589,11486140,11486140,846,1199,353276,20286,373562,8465b873d07bb4b09c40d8a0316734e7e3c04263
20200516,56,1472626,9639952,3788,42896,167760,10509,6945,5529,592,268376,2020-05-16T00:00:00Z,83417,167760,2020-05-16T00:00:00Z,11116366,11112578,11112578,984,1856,338942,24664,363606,3822795bf8510db2ac619a126d9c8b15caff7581
20200515,56,1447962,9301010,2457,42854,165904,10704,6890,5746,589,250747,2020-05-15T00:00:00Z,82433,165904,2020-05-15T00:00:00Z,10751429,10748972,10748972,1502,1353,335087,24681,359768,f09e124cfb52113c9e2eec0d1f037104bc67e49d
20200514,56,1423281,8965923,2673,44075,164551,10888,6795,5940,582,246414,2020-05-14T00:00:00Z,80931,164551,2020-05-14T00:00:00Z,10391877,10389204,10389204,1871,3206,338940,26658,365598,824a9776eebf2a0ac53953e0f44623b78307c84a
20200513,56,1396623,8626983,1983,44514,161345,10978,6713,6156,572,243430,2020-05-13T00:00:00Z,79060,161345,2020-05-13T00:00:00Z,10025589,10023606,10023606,1696,1809,298386,21218,319604,f06ac152d5c420b71e674273f90088d315e50fea
20200512,56,1375405,8328597,1803,45199,159536,11241,5595,6352,559,238857,2020-05-12T00:00:00Z,77364,159536,2020-05-12T00:00:00Z,9705805,9704002,9704002,1472,1579,286084,22608,308692,236750db3cf8a5b1bfc4415aef1b66d7b11341a7
20200511,56,1352797,8042513,1989,44191,157957,11147,6488,6350,551,232142,2020-05-11T00:00:00Z,75892,157957,2020-05-11T00:00:00Z,9397299,9395310,9395310,887,1238,364571,18237,382808,5e27259e6621332f136c25d00a7388d4bf8a5f9a
20200510,56,1334560,7677942,3095,44943,156719,11393,6445,6395,547,215591,2020-05-10T00:00:00Z,75005,156719,2020-05-10T00:00:00Z,9015597,9012502,9012502,1024,1055,246437,21603,268040,a164bd5468d6c0242d2fd9ca48eae012c3c41dad
20200509,56,1312957,7431505,3054,46637,155664,11496,6367,6551,543,211976,2020-05-09T00:00:00Z,73981,155664,2020-05-09T00:00:00Z,8747516,8744462,8744462,1432,1708,266872,24734,291606,b1e52abb8b56aa2805e3b24c61ef1175815b707c
20200508,56,1288223,7164633,3307,47718,153956,11780,6294,6788,531,198459,2020-05-08T00:00:00Z,72549,153956,2020-05-08T00:00:00Z,8456163,8452856,8452856,1779,6892,271253,27623,298876,77f58078980d9336bea48e7c7499f4dc5c471dc0
20200507,56,1260600,6893380,3171,49130,147064,12137,5174,7070,529,194528,2020-05-07T00:00:00Z,70770,147064,2020-05-07T00:00:00Z,8157151,8153980,8153980,2740,3742,274845,27544,302389,c173715fe3f38fd1c79af0240cab3c1891469a15
20200506,56,1233056,6618535,2742,50227,143322,9380,4911,4753,449,189425,2020-05-06T00:00:00Z,68030,143322,2020-05-06T00:00:00Z,7854333,7851591,7851591,1932,2119,220506,24986,245492,467587bc0468f2988de16fd2b74678b559e67369
20200505,56,1208070,6398029,2633,50906,141203,9348,4794,4818,439,189336,2020-05-05T00:00:00Z,66098,141203,2020-05-05T00:00:00Z,7608732,7606099,7606099,2445,1983,249061,22427,271488,c55312b09de341ac1e88866693b500653999e074
20200504,56,1185643,6148968,2791,50062,139220,9366,4579,4848,430,186752,2020-05-04T00:00:00Z,63653,139220,2020-05-04T00:00:00Z,7337402,7334611,7334611,1012,1651,209398,22407,231805,7e9f2fa7a09451d14ea5ea02688ca9b483a00c05
20200503,56,1163236,5939570,2812,50312,137569,9292,4502,4761,425,179733,2020-05-03T00:00:00Z,62641,137569,2020-05-03T00:00:00Z,7105618,7102806,7102806,1206,1963,210948,25774,236722,3d3f35ea580f5f676adcd7f1b9fb9418053aef99
20200502,56,1137462,5728622,1578,51734,135606,9403,4386,4845,375,174987,2020-05-02T00:00:00Z,61435,135606,2020-05-02T00:00:00Z,6867662,6866084,6866084,1541,2031,219557,29323,248880,8026a672c056cab4de81c4ee66dfcd20ee64b42f
20200501,56,1108139,5509065,1639,52370,133575,9205,4300,4707,376,163644,2020-05-01T00:00:00Z,59894,133575,2020-05-01T00:00:00Z,6618843,6617204,6617204,1753,9789,262539,33080,295619,37e14f5d38543cf5d86c20f9aa4cb143d1d16d72
20200430,56,1075059,5246526,2775,53793,123786,9486,4192,4712,373,154648,2020-04-30T00:00:00Z,58141,123786,2020-04-30T00:00:00Z,6324360,6321585,6321585,2117,2290,204242,29645,233887,412dce06c5822f0f1272bf77271b44e7f836ea5c
20200429,56,1045414,5042284,4832,54930,121496,9612,4093,4796,365,147165,2020-04-29T00:00:00Z,56024,121496,2020-04-29T00:00:00Z,6092530,6087698,6087698,2692,3415,211873,27180,239053,6264fd323113826fb7482e0462d8300bca859f4f
20200428,56,1018234,4830411,4206,54940,118081,9491,3798,4760,195,139041,2020-04-28T00:00:00Z,53332,118081,2020-04-28T00:00:00Z,5852851,5848645,5848645,2042,2079,181211,25098,206309,1860c08bda6ed35b7ed4485b946fe96cdc1f60a4
20200427,56,993136,4649200,4077,54971,116002,9655,3720,4867,195,121323,2020-04-27T00:00:00Z,51290,116002,2020-04-27T00:00:00Z,5646413,5642336,5642336,1237,3076,173839,22045,195884,8f9b1f92031f90b8392dc77d30c04645e2149577
20200426,56,971091,4475361,4445,55050,112926,14831,2571,5121,227,116529,2020-04-26T00:00:00Z,50053,112926,2020-04-26T00:00:00Z,5450897,5446452,5446452,1188,2192,179224,27414,206638,67bfaf7fc3ddb380158766a4a9dea79d3cc66e83
20200425,56,943677,4296137,5315,56344,110734,15020,2516,5266,227,112539,2020-04-25T00:00:00Z,48865,110734,2020-04-25T00:00:00Z,5245129,5239814,5239814,1714,2456,241664,36026,277690,bc39f9d090284288f0ac5a969900472ab186267d
20200424,56,907651,4054473,4396,56075,108278,15078,2468,5187,227,101296,2020-04-24T00:00:00Z,47151,108278,2020-04-24T00:00:00Z,4966520,4962124,4962124,1865,2338,201430,34196,235626,d2bfac0d74b7b75126174f432dbf5c23b221a67f
20200423,56,873455,3853043,4258,57889,105940,15163,2428,5464,227,96921,2020-04-23T00:00:00Z,45286,105940,2020-04-23T00:00:00Z,4730756,4726498,4726498,1764,2802,161413,31786,193199,23da564df86efab74f7536c99fe990c47776850b
20200422,56,841669,3691630,4191,58130,103138,15341,2370,5474,227,92978,2020-04-22T00:00:00Z,43522,103138,2020-04-22T00:00:00Z,4537490,4533299,4533299,2065,3087,294693,28908,323601,3b2a6efd3cd40153a3c3d4b2677620ad36bce8d9
20200421,56,812761,3396937,3956,58579,100051,15228,2315,5514,214,72842,2020-04-21T00:00:00Z,41457,100051,2020-04-21T00:00:00Z,4213654,4209698,4209698,2429,2682,126621,26315,152936,fedca8a532d8fc456f7be755b814ab844c706603
20200420,56,786446,3270316,4037,55677,97369,14691,2193,5567,214,69493,2020-04-20T00:00:00Z,39028,97369,2020-04-20T00:00:00Z,4060799,4056762,4056762,1765,2211,120219,25837,146056,81f05d02985336566ca6b2e26eb000f858e63119
20200419,56,760609,3150097,11324,55570,95158,14548,2145,5603,214,67205,2020-04-19T00:00:00Z,37263,95158,2020-04-19T00:00:00Z,3922030,3910706,3910706,1733,2239,126358,27405,153763,0ef4adefb4f6371d628966b4e849d49333bfb5b4
20200418,56,733204,3023739,9906,56591,92919,14788,2096,5729,205,62840,2020-04-18T00:00:00Z,35530,92919,2020-04-18T00:00:00Z,3766849,3756943,3756943,1837,3563,118252,27982,146234,0b70c9594e1b0f3d014bf6d15c6241b84d06b09b
20200417,56,705222,2905487,10889,57808,89356,14910,2052,6096,148,53533,2020-04-17T00:00:00Z,33693,89356,2020-04-17T00:00:00Z,3621598,3610709,3610709,2077,3405,127578,32013,159591,f0dc9e8739aa1e915a4c12c78ea042099e5cc7c5
20200416,56,673209,2777909,16927,58625,85951,15150,1834,5940,137,48851,2020-04-16T00:00:00Z,31616,85951,2020-04-16T00:00:00Z,3468045,3451118,3451118,2141,3071,132643,30840,163483,785a739d517c2ae0b9eb7e0d180d6da96eabb6b6
20200415,56,642369,2645266,16901,59260,82880,14667,1783,6032,223,43435,2020-04-15T00:00:00Z,29475,82880,2020-04-15T00:00:00Z,3304536,3287635,3287635,2486,4434,107826,30269,138095,a7763897372684d3627b8eb7c7e2e2851fe44bf6
20200414,56,612100,2537440,16615,58719,78446,14039,1715,5975,221,39268,2020-04-14T00:00:00Z,26989,78446,2020-04-14T00:00:00Z,3166155,3149540,3149540,2287,3282,126546,25639,152185,3358e8a973afeb06ef93cdccb99a32985e7d1eb7
20200413,56,586461,2410894,17159,55295,75164,13632,1628,6168,210,35372,2020-04-13T00:00:00Z,24702,75164,2020-04-13T00:00:00Z,3014514,2997355,2997355,1572,4285,108197,25257,133454,16d58ce6d445731068959b5f32a28b92fc39252f
20200412,56,561204,2302697,16419,54749,70879,13623,1455,5986,160,34081,2020-04-12T00:00:00Z,23130,70879,2020-04-12T00:00:00Z,2880320,2863901,2863901,1630,3288,111452,27871,139323,647d13999f0367ff4edcd8649ab76f374cb8e059
20200411,56,533333,2191245,16593,54757,67591,13280,1405,5978,154,31567,2020-04-11T00:00:00Z,21500,67591,2020-04-11T00:00:00Z,2741171,2724578,2724578,1982,2825,108276,30615,138891,46789e4f596a90c3be9bde8192100efab5c1e74e
20200410,56,502718,2082969,17435,51745,64766,12698,1185,5937,41,28997,2020-04-10T00:00:00Z,19518,64766,2020-04-10T00:00:00Z,2603122,2585687,2585687,2055,4934,123267,34235,157502,3d7ae44ad79bb9ce50dccdffc5a247fb6ef89c4b
20200409,56,468483,1959702,17622,49826,59832,12254,924,5794,39,24819,2020-04-09T00:00:00Z,17463,59832,2020-04-09T00:00:00Z,2445807,2428185,2428185,1972,3923,135277,34417,169694,9394ac315cea4ea6994d69478e79a602c463e11f
20200408,56,434066,1824425,17219,44063,55909,9932,1013,4131,216,21102,2020-04-08T00:00:00Z,15491,55909,2020-04-08T00:00:00Z,2275710,2258491,2258491,1944,4311,116987,30481,147468,73593ce7c4f4258442c9af1e1e73d8042b44c05c
20200407,56,403585,1707438,16548,42294,51598,9875,889,4076,151,18443,2020-04-07T00:00:00Z,13547,51598,2020-04-07T00:00:00Z,2127571,2111023,2111023,1956,2981,123697,30624,154321,816bf7277243a0a390157e840e854aa1f9bb4467
20200406,56,372961,1583741,17283,34663,48617,6943,814,2961,147,16554,2020-04-06T00:00:00Z,11591,48617,2020-04-06T00:00:00Z,1973985,1956702,1956702,1254,2946,122634,28891,151525,de7056b9e5077615aa1c3e73e7182f4ae3493a26
20200405,56,344070,1461107,17303,30905,45671,5677,760,652,147,14513,2020-04-05T00:00:00Z,10337,45671,2020-04-05T00:00:00Z,1822480,1805177,1805177,1285,3903,93710,25484,119194,3ec53a2cb0443f3b4b0d5651ff235d8267ebe6aa
20200404,56,318586,1367397,15569,29095,41768,5383,554,656,147,12816,2020-04-04T00:00:00Z,9052,41768,2020-04-04T00:00:00Z,1701552,1685983,1685983,1440,5086,196048,33212,229260,be7d29f86a796603bd42fb0da9cb1c56881d2b5b
20200403,56,285374,1171349,61976,24564,36682,4811,486,605,147,10861,2020-04-03T00:00:00Z,7612,36682,2020-04-03T00:00:00Z,1518699,1456723,1456723,1259,4554,100673,31896,132569,5c6e75992d07621257065882bce467f324c4d01e
20200402,56,253478,1070676,62097,21833,32128,4410,456,574,140,8586,2020-04-02T00:00:00Z,6353,32128,2020-04-02T00:00:00Z,1386251,1324154,1324154,1149,4175,91004,28021,119025,f53247dc7bbfcb93222311bb835f5b87c03cf254
20200401,56,225457,979672,59665,19982,27953,3937,407,561,140,7084,2020-04-01T00:00:00Z,5204,27953,2020-04-01T00:00:00Z,1264794,1205129,1205129,988,4228,82458,25750,108208,b01b71d127220863bc1a10afb4840038dc3b4cd1
20200331,56,199707,897214,59518,17856,23725,3487,236,507,,5666,2020-03-31T00:00:00Z,4216,23725,2020-03-31T00:00:00Z,1156439,1096921,1096921,861,3906,87627,24708,112335,b17be1fb02197d874b3fc7de0244dde74d07f5f0
20200330,56,174999,809587,65369,15574,19819,3087,187,451,,4560,2020-03-30T00:00:00Z,3355,19819,2020-03-30T00:00:00Z,1049955,984586,984586,577,2536,96721,21927,118648,8b7655cff0b13b501b86e061d9049c940ca76c49
20200329,56,153072,712866,65545,13833,17283,2456,156,439,,4052,2020-03-29T00:00:00Z,2778,17283,2020-03-29T00:00:00Z,931483,865938,865938,516,2775,67942,19605,87547,8e551053252e6f9d19f8420f7097a92418ad1a26
20200328,56,133467,644924,65709,12179,14508,2174,140,390,,3143,2020-03-28T00:00:00Z,2262,14508,2020-03-28T00:00:00Z,844100,778391,778391,519,2425,87141,19696,106837,809b2268d3694f5d16c45ef6b251debea264a360
20200327,56,113771,557783,60091,10789,12083,1792,124,324,,2418,2020-03-27T00:00:00Z,1743,12083,2020-03-27T00:00:00Z,731645,671554,671554,401,2563,84454,19051,103505,cffd414ec41a95e79ffcd2302d6ce11b1e9a2a94
20200326,56,94720,473329,60251,7617,9520,1299,91,258,,97,2020-03-26T00:00:00Z,1342,9520,2020-03-26T00:00:00Z,628300,568049,568049,311,2499,83983,17648,101631,11882014894f8d4950af14bab0ad1d24abac6ca5
20200325,56,77072,389346,51235,4971,7021,,74,167,,146,2020-03-25T00:00:00Z,1031,7021,2020-03-25T00:00:00Z,517653,466418,466418,232,1904,71410,12853,84263,f02a855b1096d817ea7fbd513eedefc33ede2018
20200324,56,64219,317936,14433,3828,5117,,,,,,2020-03-24T00:00:00Z,799,5117,2020-03-24T00:00:00Z,396588,382155,382155,231,1180,58324,10631,68955,c289053d6b8813c06bfec434a7f8c4ec7cb892d6
20200323,56,53588,259612,14571,2770,3937,,,,,,2020-03-23T00:00:00Z,568,3937,2020-03-23T00:00:00Z,327771,313200,313200,97,914,46751,11449,58200,51f2ae7890937e2bd34a7cc88d6fb35eaf5a5462
20200322,56,42139,212861,2842,2155,3023,,,,,,2020-03-22T00:00:00Z,471,3023,2020-03-22T00:00:00Z,257842,255000,255000,143,1003,36021,9251,45272,76e4473b1bab38361a1fce5f13490424849d946e
20200321,56,32888,176840,3468,1436,2020,,,,,,2020-03-21T00:00:00Z,328,2020,2020-03-21T00:00:00Z,213196,209728,209728,61,1912,38387,6883,45270,edd8fc30f91133c4d13ed017863c1d3009d5008d
20200320,56,26005,138453,3330,1042,108,,,,,,2020-03-20T00:00:00Z,267,108,2020-03-20T00:00:00Z,167788,164458,164458,68,23,30360,6252,36612,9974f8e4ab633b7b00956815cb1c85f864f154c4
20200319,56,19753,108093,3016,617,85,,,,,,2020-03-19T00:00:00Z,199,85,2020-03-19T00:00:00Z,130862,127846,127846,46,18,23275,4665,27940,4ff26a870ff33450f94c19c7808524ad00e2ae57
20200318,56,15088,84818,2526,416,67,,,,,,2020-03-18T00:00:00Z,153,67,2020-03-18T00:00:00Z,102432,99906,99906,31,12,21919,3170,25089,31a0f2ece3951143068772951ece0133a16a4045
20200317,56,11918,62899,1687,325,55,,,,,,2020-03-17T00:00:00Z,122,55,2020-03-17T00:00:00Z,76504,74817,74817,22,13,13649,3604,17253,5edea2541c17824154fb32ce68396ce1bc5026bf
20200316,56,8314,49250,1691,,42,,,,,,2020-03-16T00:00:00Z,100,42,2020-03-16T00:00:00Z,59255,57564,57564,21,6,16301,1568,17869,b01b32004ba85498bfb75873b4c548f79f1401ba
20200315,51,6746,32949,2242,,36,,,,,,2020-03-15T00:00:00Z,79,36,2020-03-15T00:00:00Z,41937,39695,39695,15,10,6372,1250,7622,6d5bd5188c5ea2f65f326a2e2ba414177dc1483c
20200314,51,5496,26577,1236,,26,,,,,,2020-03-14T00:00:00Z,64,26,2020-03-14T00:00:00Z,33309,32073,32073,9,4,3665,921,4586,a27c70dda6d17c0846628b56d107b1913a82c469
20200313,51,4575,22912,1130,,22,,,,,,2020-03-13T00:00:00Z,55,22,2020-03-13T00:00:00Z,28617,27487,27487,4,6,8146,1028,9174,1f3eb0b2add18c605dfb9a9e2f4511c2a1e229c0
20200312,51,3547,14766,673,,16,,,,,,2020-03-12T00:00:00Z,51,16,2020-03-12T00:00:00Z,18986,18313,18313,8,5,4591,674,5265,3f550126586b5bc908a5c8306ba30a83a0896d0e
20200311,50,2873,10175,563,,11,,,,,,2020-03-11T00:00:00Z,43,11,2020-03-11T00:00:00Z,13611,13048,13048,6,3,3293,529,3822,93ffb17217de9698e9f39c99670e5a86f219414c
20200310,50,2344,6882,469,,8,,,,,,2020-03-10T00:00:00Z,37,8,2020-03-10T00:00:00Z,9695,9226,9226,2,0,2054,440,2494,09066fc307542de553d3b8e7fc124da75b1436ea
20200309,50,1904,4828,313,,8,,,,,,2020-03-09T00:00:00Z,35,8,2020-03-09T00:00:00Z,7045,6732,6732,4,2,1391,366,1757,2ae1cc734cdb1e4572e29d6080089291515da76e
20200308,50,1538,3437,347,,6,,,,,,2020-03-08T00:00:00Z,31,6,2020-03-08T00:00:00Z,5322,4975,4975,4,0,589,267,856,e1c9dcba16d40cbdcd9e01f7c3648a39de40bdc5
20200307,50,1271,2848,602,,6,,,,,,2020-03-07T00:00:00Z,27,6,2020-03-07T00:00:00Z,4721,4119,4119,1,0,572,220,792,b77bd5621bcc7f3900851c47f8852b6c8cac7203
20200306,36,1051,2276,458,,6,,,,,,2020-03-06T00:00:00Z,26,6,2020-03-06T00:00:00Z,3785,3327,3327,6,1,634,142,776,343da9953787d25bbcd4dd3db6d98f296ba5ec44
20200305,24,909,1642,197,,5,,,,,,2020-03-05T00:00:00Z,20,5,2020-03-05T00:00:00Z,2748,2551,2551,4,1,466,152,618,882efdc6f8ce0ebaab96a06901a89240381f5fd9
20200304,15,757,1176,103,,4,,,,,,2020-03-04T00:00:00Z,16,4,2020-03-04T00:00:00Z,2036,1933,1933,2,4,906,187,1093,c33d0dd860ccd83ff8c7b24ad7b797d147b5186d
20200303,3,570,270,,,,,,,,,2020-03-03T00:00:00Z,14,,2020-03-03T00:00:00Z,840,840,840,3,0,147,101,248,28386bb9a453ffa91c9519b6f24ae4538e5f0279
20200302,3,469,123,,,,,,,,,2020-03-02T00:00:00Z,11,,2020-03-02T00:00:00Z,592,592,592,3,0,111,82,193,38ffce22f29c4bafa74e120dec774d3f23ecd9e4
20200301,3,387,12,,,,,,,,,2020-03-01T00:00:00Z,8,,2020-03-01T00:00:00Z,399,399,399,3,0,-5,88,83,59d2831cc1624aebcfbe04697962dff78d8208f4
20200229,1,299,17,,,,,,,,,2020-02-29T00:00:00Z,5,,2020-02-29T00:00:00Z,316,316,316,1,0,17,24,41,27c8dfcf504c66796dd4842c82d37d8a8b7d0c88
20200228,1,275,0,,,,,,,,,2020-02-28T00:00:00Z,4,,2020-02-28T00:00:00Z,275,275,275,2,0,0,40,40,0063e380f01c09a74ff18ab1940b36390ef365d9
20200227,1,235,0,,,,,,,,,2020-02-27T00:00:00Z,2,,2020-02-27T00:00:00Z,235,235,235,0,0,0,27,27,ffe41d6947d93d86a6f85189d9d0461c93f93d5e
20200226,1,208,0,,,,,,,,,2020-02-26T00:00:00Z,2,,2020-02-26T00:00:00Z,208,208,208,2,0,0,29,29,52535d8139a745270672daabd2f8824e38f7acee
20200225,1,179,0,,,,,,,,,2020-02-25T00:00:00Z,,,2020-02-25T00:00:00Z,179,179,179,0,0,0,31,31,fe9bd7ac1b1bb0403591268e0e18c10c7dd677f1
20200224,1,148,0,,,,,,,,,2020-02-24T00:00:00Z,,,2020-02-24T00:00:00Z,148,148,148,0,0,0,26,26,40f040514bdd96cea0529aa4fab368bf810ce3de
20200223,1,122,0,,,,,,,,,2020-02-23T00:00:00Z,,,2020-02-23T00:00:00Z,122,122,122,0,0,0,16,16,512963fd5bbfd45e6812ee673008fd7f1d9e9051
20200222,1,106,0,,,,,,,,,2020-02-22T00:00:00Z,,,2020-02-22T00:00:00Z,106,106,106,0,0,0,13,13,1e2edd13a951b782f2e36aa1335da750c5d605f6
20200221,1,93,0,,,,,,,,,2020-02-21T00:00:00Z,,,2020-02-21T00:00:00Z,93,93,93,0,0,0,11,11,775bae89a8c7819e65d3b0b1e05ad1a33b6bb9b7
20200220,1,82,0,,,,,,,,,2020-02-20T00:00:00Z,,,2020-02-20T00:00:00Z,82,82,82,0,0,0,13,13,d3832ff43d2ad63fbbac69ccc3a6f7a425671626
20200219,1,69,0,,,,,,,,,2020-02-19T00:00:00Z,,,2020-02-19T00:00:00Z,69,69,69,0,0,0,10,10,4eaba6a35cee6bf7863c306d80ebccead4f9e0b8
20200218,1,59,0,,,,,,,,,2020-02-18T00:00:00Z,,,2020-02-18T00:00:00Z,59,59,59,0,0,0,9,9,037f86e217230eeb1f82483e7bc38c3575d92f9b
20200217,1,50,0,,,,,,,,,2020-02-17T00:00:00Z,,,2020-02-17T00:00:00Z,50,50,50,0,0,0,15,15,654825b140100438046a5320976ca872c886835f
20200216,1,35,0,,,,,,,,,2020-02-16T00:00:00Z,,,2020-02-16T00:00:00Z,35,35,35,0,0,0,7,7,0d0ac95120a24edf715c33b7042a673a3ac72c22
20200215,1,28,0,,,,,,,,,2020-02-15T00:00:00Z,,,2020-02-15T00:00:00Z,28,28,28,0,0,0,7,7,aa97543642db531c4455dcfbff575626241a3bbb
20200214,1,21,0,,,,,,,,,2020-02-14T00:00:00Z,,,2020-02-14T00:00:00Z,21,21,21,0,0,0,3,3,98bad0bbf2467633c3ba4522edc9da4a5a896bd1
20200213,1,18,0,,,,,,,,,2020-02-13T00:00:00Z,,,2020-02-13T00:00:00Z,18,18,18,0,0,0,0,0,7033407474f6f0f59a7b74854fcc812d655434c2
20200212,1,18,0,,,,,,,,,2020-02-12T00:00:00Z,,,2020-02-12T00:00:00Z,18,18,18,0,0,0,1,1,3b69cfc2335143142dbfcde2ba5732d7b892d037
20200211,1,17,0,,,,,,,,,2020-02-11T00:00:00Z,,,2020-02-11T00:00:00Z,17,17,17,0,0,0,1,1,cfe56ace9b8e5eae7ccc0dcb3ce89369077642ab
20200210,1,16,0,,,,,,,,,2020-02-10T00:00:00Z,,,2020-02-10T00:00:00Z,16,16,16,0,0,0,3,3,a620e75c6dc4c685fc26d5cca336cfc6ff614506
20200209,1,13,0,,,,,,,,,2020-02-09T00:00:00Z,,,2020-02-09T00:00:00Z,13,13,13,0,0,0,0,0,b71f4996ae8c6f14b2d694af20ae26e0fdc68f14
20200208,1,13,0,,,,,,,,,2020-02-08T00:00:00Z,,,2020-02-08T00:00:00Z,13,13,13,0,0,0,1,1,27c3180319798290a1198cbbee0c1ed2379fdc2e
20200207,1,12,0,,,,,,,,,2020-02-07T00:00:00Z,,,2020-02-07T00:00:00Z,12,12,12,0,0,0,1,1,b396ed198a3b1a49e6d52705bd47baf45e9c5ae3
20200206,1,11,0,,,,,,,,,2020-02-06T00:00:00Z,,,2020-02-06T00:00:00Z,11,11,11,0,0,0,3,3,d7fb4549ba2c79b594b34fa9ed191b58d71e3696
20200205,1,8,0,,,,,,,,,2020-02-05T00:00:00Z,,,2020-02-05T00:00:00Z,8,8,8,0,0,0,0,0,4ca0fa2b0948956f33b5a5788abefaf56f1fce99
20200204,1,8,0,,,,,,,,,2020-02-04T00:00:00Z,,,2020-02-04T00:00:00Z,8,8,8,0,0,0,1,1,a2c106780077754f6fc62f322ee1bb13059abf01
20200203,1,7,0,,,,,,,,,2020-02-03T00:00:00Z,,,2020-02-03T00:00:00Z,7,7,7,0,0,0,1,1,f675e1b9bbb0cae5b545c12b528a2d123c419fb9
20200202,1,6,0,,,,,,,,,2020-02-02T00:00:00Z,,,2020-02-02T00:00:00Z,6,6,6,0,0,0,2,2,cabf736289065d789dd6100385a980d65a1fbeeb
20200201,1,4,0,,,,,,,,,2020-02-01T00:00:00Z,,,2020-02-01T00:00:00Z,4,4,4,0,0,0,1,1,5d928ca7c6802a3183d4d549f6f746cde73b00ae
20200131,1,3,0,,,,,,,,,2020-01-31T00:00:00Z,,,2020-01-31T00:00:00Z,3,3,3,0,0,0,0,0,c5e11f3f448ee066a5d4ba1b23fc91ec00c54e86
20200130,1,3,0,,,,,,,,,2020-01-30T00:00:00Z,,,2020-01-30T00:00:00Z,3,3,3,0,0,0,0,0,0a8e7117d2571e8984618900ff1d40d7f2c944fe
20200129,1,3,0,,,,,,,,,2020-01-29T00:00:00Z,,,2020-01-29T00:00:00Z,3,3,3,0,0,0,1,1,e960a515d1779fa15049c5935ab0574e595a87c8
20200128,1,2,0,,,,,,,,,2020-01-28T00:00:00Z,,,2020-01-28T00:00:00Z,2,2,2,0,0,0,0,0,0c443fe4c026a213030f976017c9fa95f115d5a7
20200127,1,2,0,,,,,,,,,2020-01-27T00:00:00Z,,,2020-01-27T00:00:00Z,2,2,2,0,0,0,0,0,3dde2425e73c17b4e6cbf0e4432340298c0a94f5
20200126,1,2,0,,,,,,,,,2020-01-26T00:00:00Z,,,2020-01-26T00:00:00Z,2,2,2,0,0,0,0,0,e1cf59ab48e1cf367c4a6798a508a23d9d36bd18
20200125,1,2,0,,,,,,,,,2020-01-25T00:00:00Z,,,2020-01-25T00:00:00Z,2,2,2,0,0,0,0,0,bef2a1d5f2a13491e0e0369bbd46c10cdd12973b
20200124,1,2,0,,,,,,,,,2020-01-24T00:00:00Z,,,2020-01-24T00:00:00Z,2,2,2,0,0,0,0,0,bfffe76fc0b7cf11efe8aecd3cc7b22598d77d61
20200123,1,2,0,,,,,,,,,2020-01-23T00:00:00Z,,,2020-01-23T00:00:00Z,2,2,2,0,0,0,0,0,cee36ebf3174bf1df0daa36e1e8088a157406fad
20200122,1,2,0,,,,,,,,,2020-01-22T00:00:00Z,,,2020-01-22T00:00:00Z,2,2,2,0,0,0,0,0,d538c99729d1fee626212d1878a100c1e1204a5f
