date,states,positive,negative,pending,hospitalizedCurrently,hospitalizedCumulative,inIcuCurrently,inIcuCumulative,onVentilatorCurrently,onVentilatorCumulative,recovered,dateChecked,death,hospitalized,lastModified,total,totalTestResults,posNeg,deathIncrease,hospitalizedIncrease,negativeIncrease,positiveIncrease,totalTestResultsIncrease,hash
20200729,56,4394906,49430539,3840,57306,302057,10531,13744,2776,1400,1389425,2020-07-29T00:00:00Z,142848,302057,2020-07-29T00:00:00Z,53829285,53825445,53825445,1418,2913,773657,66211,839868,a2e1d4a308f87fa1c4938a8f20bc81a26295b8e7
20200728,56,4328695,48656882,3600,57091,299144,10463,13559,2752,1372,1355363,2020-07-28T00:00:00Z,141430,299144,2020-07-28T00:00:00Z,52989177,52985577,52985577,1121,4672,679736,53507,733243,10729af9f291bbb18e37d56f0bc31ff802f09672
20200727,56,4275188,47977146,3398,59023,294472,10328,13412,2720,1356,1325804,2020-07-27T00:00:00Z,140309,294472,2020-07-27T00:00:00Z,52255732,52252334,52252334,1059,1690,705706,55134,760840,021bea33ea5ddba5408c2a928ad900ae036a25dc
20200726,56,4220054,47271440,3361,58614,292782,10353,13343,2723,1336,1297863,2020-07-26T00:00:00Z,139250,292782,2020-07-26T00:00:00Z,51494855,51491494,51491494,558,1435,794098,61713,855811,820426c4c5479c7a0f8974e68aa7016f2082a93e
20200725,56,4158341,46477342,3377,59227,291347,10380,13279,2729,1300,1279414,2020-07-25T00:00:00Z,138692,291347,2020-07-25T00:00:00Z,50639060,50635683,50635683,1037,1992,732176,65413,797589,ea28b353271e8d21ff5f3b189169c0d974de8b29
20200724,56,4092928,45745166,3409,59670,289355,10405,13182,2712,1297,1261624,2020-07-24T00:00:00Z,137655,289355,2020-07-24T00:00:00Z,49841503,49838094,49838094,1178,3026,854645,75193,929838,5a28d1fb68592ad25bd4746557e1f68250423dea
20200723,56,4017735,44890521,3179,59885,286329,10418,12933,2472,1280,1233269,2020-07-23T00:00:00Z,136477,286329,2020-07-23T00:00:00Z,48911435,48908256,48908256,1039,2500,753372,71027,824399,1d8eb95c208f9afdd53bc9946b37be590b17a635
20200722,56,3946708,44137149,3051,59675,283829,10457,12790,2440,1258,1210849,2020-07-22T00:00:00Z,135438,283829,2020-07-22T00:00:00Z,48086908,48083857,48083857,1117,2248,726352,69150,795502,c28c2ce1af7dcb4a6dfc783c222acb7387b19277
20200721,56,3877558,43410797,3197,59362,281581,6711,12629,2414,1242,1182931,2020-07-21T00:00:00Z,134321,281581,2020-07-21T00:00:00Z,47291552,47288355,47288355,1038,2551,686606,63642,750248,b315275d3d2251da5af96422594a53d6d0508aad
20200720,56,3813916,42724191,3003,58371,279030,6558,12475,2403,1223,1160087,2020-07-20T00:00:00Z,133283,279030,2020-07-20T00:00:00Z,46541110,46538107,46538107,362,1647,654044,56971,711015,6223e4e1a7003f68d8bd1f30742ea4d8e283b834
20200719,56,3756945,42070147,3052,57885,277383,6384,12393,2362,1216,1131171,2020-07-19T00:00:00Z,132921,277383,2020-07-19T00:00:00Z,45830144,45827092,45827092,526,944,733624,64884,798508,1499d2e73cb541b93e54d866237647b154d79450
20200718,56,3692061,41336523,3032,57645,276439,6396,12342,2343,1211,1122720,2020-07-18T00:00:00Z,132395,276439,2020-07-18T00:00:00Z,45031616,45028584,45028584,872,2003,696452,65180,761632,289cc193d3592f21659da868ca7c2c853e737474
20200717,56,3626881,40640071,3002,57761,274436,6453,12243,2353,1200,1106844,2020-07-17T00:00:00Z,131523,274436,2020-07-17T00:00:00Z,44269954,44266952,44266952,951,2678,760159,77233,837392,79012ed297c137312e1eec66f88514e0eea0b96a
20200716,56,3549648,39879912,2929,57442,271758,6359,12091,2317,1175,1090645,2020-07-16T00:00:00Z,130572,271758,2020-07-16T00:00:00Z,43432489,43429560,43429560,974,2215,756611,70953,827564,0e32aba19ddfcd0d0b35661f5b01e5820789af60
20200715,56,3478695,39123301,2947,56144,269543,6317,12002,2317,1166,1075882,2020-07-15T00:00:00Z,129598,269543,2020-07-15T00:00:00Z,42604943,42601996,42601996,858,2416,696615,65382,761997,5af1b31d4fa8496e1130b69f4a55607578d379a5
20200714,56,3413313,38426686,960,55565,267127,6235,11857,2263,1154,1049098,2020-07-14T00:00:00Z,128740,267127,2020-07-14T00:00:00Z,41840959,41839999,41839999,736,2262,707103,62879,769982,6d933647c35df987255ff6dec892d08d64fc078b
20200713,56,3350434,37719583,2610,53988,264865,6074,11749,2259,1142,1031939,2020-07-13T00:00:00Z,128004,264865,2020-07-13T00:00:00Z,41072627,41070017,41070017,327,1214,635111,58465,693576,8005d7fa1de9121885e9ae0e5fad89c8bff696a5
20200712,56,3291969,37084472,2639,52727,263651,5930,11679,2182,1136,1006326,2020-07-12T00:00:00Z,127677,263651,2020-07-12T00:00:00Z,40379080,40376441,40376441,476,939,697346,60978,758324,76fc1c6c482f104eb8f4ad40cd04185bb1ee7061
20200711,56,3230991,36387126,2618,51859,262712,5939,11612,2169,1128,995576,2020-07-11T00:00:00Z,127201,262712,2020-07-11T00:00:00Z,39620735,39618117,39618117,757,5141,635437,63007,698444,c01d2eef35d92ed71ecd939b2cd4ea983752f315
20200710,56,3167984,35751689,2493,51595,257571,5896,11523,2197,1118,983185,2020-07-10T00:00:00Z,126444,257571,2020-07-10T00:00:00Z,38922166,38919673,38919673,854,2318,744161,66645,810806,10a3d73c1872fec28d44e9c69bf30069980e0c7f
20200709,56,3101339,35007528,2530,43934,255253,5845,11370,2127,1138,969111,2020-07-09T00:00:00Z,125590,255253,2020-07-09T00:00:00Z,38111397,38108867,38108867,867,1719,644214,58836,703050,915a3f3a6bae40b19f1668d28a4d11a6ebaad527
20200708,56,3042503,34363314,2360,43078,253534,5874,11303,2172,1103,953420,2020-07-08T00:00:00Z,124723,253534,2020-07-08T00:00:00Z,37408177,37405817,37405817,897,2035,566955,62147,629102,e7813b143ca2959d3d5b56e1f3ec4646d21cce7a
20200707,56,2980356,33796359,2136,41760,251499,5832,11177,2098,1084,936476,2020-07-07T00:00:00Z,123826,251499,2020-07-07T00:00:00Z,36778851,36776715,36776715,922,1960,583025,51766,634791,4b8167baea130a2be23bdc624d0f21d7b48fbc7b
20200706,56,2928590,33213334,1907,39768,249539,5684,11058,2105,1070,924148,2020-07-06T00:00:00Z,122904,249539,2020-07-06T00:00:00Z,36143831,36141924,36141924,242,794,459601,41600,501201,85e1519238eb752ab769bab982b6b2f42c6ab482
20200705,56,2886990,32753733,1885,38764,248745,5653,11010,2080,1064,902558,2020-07-05T00:00:00Z,122662,248745,2020-07-05T00:00:00Z,35642608,35640723,35640723,209,590,635661,45789,681450,a2f14c1171de42e6bd78a37b53fbd2b53edc3719
20200704,56,2841201,32118072,2083,38146,248155,5633,10977,1982,1063,894325,2020-07-04T00:00:00Z,122453,248155,2020-07-04T00:00:00Z,34961356,34959273,34959273,306,871,587437,54734,642171,1aac9fd9d659fca300e2b9c41e86da4cb9f4d1a5
20200703,56,2786467,31530635,2237,37798,247284,5597,10936,2049,1059,883561,2020-07-03T00:00:00Z,122147,247284,2020-07-03T00:00:00Z,34319339,34317102,34317102,597,1435,656726,54223,710949,c9846ec840958623bd88c1b6ce8632bc39f9d21c
20200702,56,2732244,30873909,2208,37500,245849,5626,10843,2105,1041,875127,2020-07-02T00:00:00Z,121550,245849,2020-07-02T00:00:00Z,33608361,33606153,33606153,697,2003,608490,53826,662316,71c02f066149f6038c9ead044b87c3956b87eb66
20200701,56,2678418,30265419,2604,36405,243846,5512,10752,2098,1027,823151,2020-07-01T00:00:00Z,120853,243846,2020-07-01T00:00:00Z,32946441,32943837,32943837,701,1438,582612,50674,633286,7f75a162d3d980d40eca9662ed2cbd8e41eeef84
20200630,56,2627744,29682807,2432,35248,242408,5424,10669,2044,1008,813788,2020-06-30T00:00:00Z,120152,242408,2020-06-30T00:00:00Z,32312983,32310551,32310551,596,1582,576601,47462,624063,ddf26c0774c337c3dd5d184c040a12bdefcc24ab
20200629,56,2580282,29106206,2194,33586,240826,5380,10542,2011,990,798360,2020-06-29T00:00:00Z,119556,240826,2020-06-29T00:00:00Z,31688682,31686488,31686488,330,670,607649,39175,646824,b17f5b69f414f98bb82460397845bf06a58b0818
20200628,56,2541107,28498557,2198,32476,240156,5248,10473,2077,983,778321,2020-06-28T00:00:00Z,119226,240156,2020-06-28T00:00:00Z,31041862,31039664,31039664,271,580,542041,41857,583898,458bf1b3bada62d97ea6ac49897ac424e8241ee2
20200627,56,2499250,27956516,2186,32483,239576,5315,10415,2159,977,772465,2020-06-27T00:00:00Z,118955,239576,2020-06-27T00:00:00Z,30457952,30455766,30455766,509,1057,555603,43783,599386,bcadad3a97a0b094b6ec64cb1d6978022a714074
20200626,56,2455467,27400913,2201,31738,238519,5283,10334,2075,966,763966,2020-06-26T00:00:00Z,118446,238519,2020-06-26T00:00:00Z,29858581,29856380,29856380,636,1526,562326,44421,606747,cdd98dcde1b078cb59c799c5950e059c3cbe44d5
20200625,56,2411046,26838587,2133,31844,236993,5319,10257,2214,951,756719,2020-06-25T00:00:00Z,117810,236993,2020-06-25T00:00:00Z,29251766,29249633,29249633,2501,1257,598076,39072,637148,455b2f4aa0220f021c6209c403625b22dc13beb8
20200624,56,2371974,26240511,2049,31102,235736,5293,10173,2248,934,747565,2020-06-24T00:00:00Z,115309,235736,2020-06-24T00:00:00Z,28614534,28612485,28612485,724,1310,480518,38684,519202,2ea186acab4ecac27d61e009731a23914798cbd1
20200623,56,2333290,25759993,1891,30235,234426,5402,10077,2293,918,738952,2020-06-23T00:00:00Z,114585,234426,2020-06-23T00:00:00Z,28095174,28093283,28093283,708,1257,458698,33021,491719,d9043ac92e295c6b03f1d4ff4238ba9f1f6f6c04
20200622,56,2300269,25301295,2028,28799,233169,5323,10002,2299,909,731602,2020-06-22T00:00:00Z,113877,233169,2020-06-22T00:00:00Z,27603592,27601564,27601564,283,800,439588,27017,466605,386c8be74515a809f78bb86764f7c2473cc8ef54
20200621,56,2273252,24861707,2084,28219,232369,5195,9944,2321,904,713537,2020-06-21T00:00:00Z,113594,232369,2020-06-21T00:00:00Z,27137043,27134959,27134959,292,514,483814,27284,511098,5f2e9b2eb653cf52d30fdbae573d28ea6576f1b3
20200620,56,2245968,24377893,2108,27967,231855,5229,9908,2380,888,708864,2020-06-20T00:00:00Z,113302,231855,2020-06-20T00:00:00Z,26625969,26623861,26623861,628,745,527221,31994,559215,46e2f0919ab7fc054823e472eba4229a490ebfb1
20200619,56,2213974,23850672,2032,28615,231110,5341,9876,2434,884,698119,2020-06-19T00:00:00Z,112674,231110,2020-06-19T00:00:00Z,26066678,26064646,26064646,655,1613,542946,31046,573992,cd0d07cf1d18eb13d63c1e274768abb00e3b7136
20200618,56,2182928,23307726,1903,28414,229497,5465,9736,2520,869,690692,2020-06-18T00:00:00Z,112019,229497,2020-06-18T00:00:00Z,25492557,25490654,25490654,704,1040,488666,27527,516193,5dfe11154b6aa80396729a48f931c1dd32494579
20200617,56,2155401,22819060,1745,28573,228457,5613,9665,2588,857,680916,2020-06-17T00:00:00Z,111315,228457,2020-06-17T00:00:00Z,24976206,24974461,24974461,767,1130,461417,23873,485290,9ef44126955c36d39c8856729cdc06e558b30667
20200616,56,2131528,22357643,1604,28270,227327,5570,9590,2594,845,672228,2020-06-16T00:00:00Z,110548,227327,2020-06-16T00:00:00Z,24490775,24489171,24489171,729,1301,441094,23435,464529,efdd42ce29b9191ce86b7b1811fa6af7b5864c33
20200615,56,2108093,21916549,1619,27867,226026,5703,9516,2640,835,665059,2020-06-15T00:00:00Z,109819,226026,2020-06-15T00:00:00Z,24026261,24024642,24024642,380,543,414301,18510,432811,4161e588c0044bc556d94b0e64d1b780076d9908
20200614,56,2089583,21502248,1672,27893,225483,5749,9466,2716,834,650541,2020-06-14T00:00:00Z,109439,225483,2020-06-14T00:00:00Z,23593503,23591831,23591831,355,640,463847,21373,485220,5ee8826e4e4098f37b9c55e443e5894d0caba7f8
20200613,56,2068210,21038401,1698,28450,224843,5883,9430,2726,830,645331,2020-06-13T00:00:00Z,109084,224843,2020-06-13T00:00:00Z,23108309,23106611,23106611,691,1105,471087,25341,496428,fcead0ec38a2854ec2a22f86682f8012898b1965
20200612,56,2042869,20567314,1783,29154,223738,6017,9373,2734,814,636111,2020-06-12T00:00:00Z,108393,223738,2020-06-12T00:00:00Z,22611966,22610183,22610183,772,1245,599648,23477,623125,e938cec167594b6678e2110be11a969e9488baa2
20200611,56,2019392,19967666,1816,29698,222493,6074,9295,2886,792,629017,2020-06-11T00:00:00Z,107621,222493,2020-06-11T00:00:00Z,21988874,21987058,21987058,898,1367,437423,22032,459455,94b0bc2463b0fa46cdcaac7dd446ae52acf95a29
20200610,56,1997360,19530243,1737,30864,221126,6249,9225,3020,780,618125,2020-06-10T00:00:00Z,106723,221126,2020-06-10T00:00:00Z,21529340,21527603,21527603,885,1484,408196,20803,428999,947946003ca267f0de2e1cda7aa89c0d8446a582
20200609,56,1976557,19122047,1661,31183,219642,6457,9141,3090,771,609476,2020-06-09T00:00:00Z,105838,219642,2020-06-09T00:00:00Z,21100265,21098604,21098604,898,1527,402549,17175,419724,c6b6f77e99b0bbc1c77f0e53059bcb83b65a889c
20200608,56,1959382,18719498,1606,31202,218115,6402,9013,3240,762,603143,2020-06-08T00:00:00Z,104940,218115,2020-06-08T00:00:00Z,20680486,20678880,20678880,660,714,378134,17012,395146,9b78929c6a9a5c625a66b2c66f8b19bc880bd345
20200607,56,1942370,18341364,1733,31408,217401,6501,8957,3298,753,590988,2020-06-07T00:00:00Z,104280,217401,2020-06-07T00:00:00Z,20285467,20283734,20283734,446,685,427116,18823,445939,9770f9219744d58cb53b1b35d56f752e04c59605
20200606,56,1923547,17914248,1796,31938,216716,6762,8920,3476,750,585470,2020-06-06T00:00:00Z,103834,216716,2020-06-06T00:00:00Z,19839591,19837795,19837795,727,1017,497145,23106,520251,35fff61034b49e854f1295cbafbb91939b99acbb
20200605,56,1900441,17417103,1749,32451,215699,6920,8863,3523,740,576327,2020-06-05T00:00:00Z,103107,215699,2020-06-05T00:00:00Z,19319293,19317544,19317544,823,1440,482923,23352,506275,7af506cf32975751d80d72439379666c98f85dfa
20200604,56,1877089,16934180,3474,32835,214259,7057,8787,3665,723,569623,2020-06-04T00:00:00Z,102284,214259,2020-06-04T00:00:00Z,18814743,18811269,18811269,888,-2841,440145,20839,460984,db7d231129d6c8d1d87917f1fe0b7841ffd4b649
20200603,56,1856250,16494035,3556,33269,217100,7227,8688,3749,717,557366,2020-06-03T00:00:00Z,101396,217100,2020-06-03T00:00:00Z,18353841,18350285,18350285,991,2255,446402,20312,466714,863c7aedc8abbc7c8d46c0bd31e2fe3ef9a7069d
20200602,56,1835938,16047633,4054,33933,214845,7407,8566,3852,710,541976,2020-06-02T00:00:00Z,100405,214845,2020-06-02T00:00:00Z,17887625,17883571,17883571,959,1585,398664,19982,418646,85a61f8355d36e0a9bba5a1ea0cbe5eb90c6512e
20200601,56,1815956,15648969,3455,34285,213260,7591,8485,3950,704,536339,2020-06-01T00:00:00Z,99446,213260,2020-06-01T00:00:00Z,17468380,17464925,17464925,665,2796,391912,20415,412327,7fa31a39b34a9e31a1fea1ab73c5b9d830d52550
20200531,56,1795541,15257057,3270,34859,210464,7626,8445,3669,704,522866,2020-05-31T00:00:00Z,98781,210464,2020-05-31T00:00:00Z,17055868,17052598,17052598,649,976,374532,21639,396171,606ef843708c649054734636c6ba9d5475edfc95
20200530,56,1773902,14882525,1668,35732,209488,7956,8305,4004,698,494569,2020-05-30T00:00:00Z,98132,209488,2020-05-30T00:00:00Z,16658095,16656427,16656427,929,1424,401992,23762,425754,4fbc1cf94fd3f702aa55a2efdc9bca2bac99fc6f
20200529,56,1750140,14480533,2978,36999,208064,8175,8235,4032,689,484554,2020-05-29T00:00:00Z,97203,208064,2020-05-29T00:00:00Z,16233651,16230673,16230673,1179,1715,463707,23522,487229,08d301f7fb1e1df6aacd4d967d718c9e4abc79a8
20200528,56,1726618,14016826,1906,38069,206349,8389,8109,4080,676,478099,2020-05-28T00:00:00Z,96024,206349,2020-05-28T00:00:00Z,15745350,15743444,15743444,1226,1630,411869,22601,434470,3a6633ade64a2430c16dd0ae66f65fe39046450b
20200527,56,1704017,13604957,3132,38373,204719,8547,8015,4222,666,391508,2020-05-27T00:00:00Z,94798,204719,2020-05-27T00:00:00Z,15312106,15308974,15308974,1318,1713,289048,19385,308433,fad223dd51972ad80e235e30e6352a515bafc64b
20200526,56,1684632,13315909,1549,37779,203006,8585,7899,4215,650,384902,2020-05-26T00:00:00Z,93480,203006,2020-05-26T00:00:00Z,15002090,15000541,15000541,640,17320,289303,16629,305932,2e3958768775401f362dc1016c2456e7b28a4d6d
20200525,56,1668003,13026606,3368,37650,185686,8472,7847,4237,642,379157,2020-05-25T00:00:00Z,92840,185686,2020-05-25T00:00:00Z,14697977,14694609,14694609,555,1002,403790,18798,422588,e4b3c098d2811ad3e271bb86d04260aef7e84c87
20200524,56,1649205,12622816,3860,37695,184684,8487,7801,4383,639,366736,2020-05-24T00:00:00Z,92285,184684,2020-05-24T00:00:00Z,14275881,14272021,14272021,678,921,361400,20105,381505,b29d2be3b4c0d404a323ff68c162823188edcd5b
20200523,56,1629100,12261416,4084,38614,183763,8733,7770,4620,638,361239,2020-05-23T00:00:00Z,91607,183763,2020-05-23T00:00:00Z,13894600,13890516,13890516,1060,1378,368410,21590,390000,ea0ea12e3b8141cb414ec6ae1ad07d64f5fa0911
20200522,56,1607510,11893006,3709,39989,182385,9048,7689,4716,633,350135,2020-05-22T00:00:00Z,90547,182385,2020-05-22T00:00:00Z,13504225,13500516,13500516,1335,4046,384533,24555,409088,7a7ff8dc1e891006674ed237aba478619c89050c
20200521,56,1582955,11508473,3641,41191,178339,9090,7412,4868,616,298418,2020-05-21T00:00:00Z,89212,178339,2020-05-21T00:00:00Z,13095069,13091428,13091428,1388,4630,435306,26513,461819,9468bae8d110de55946f0f687e9811fb052a2ba9
20200520,56,1556442,11073167,2973,41762,173709,9522,7319,4911,613,294312,2020-05-20T00:00:00Z,87824,173709,2020-05-20T00:00:00Z,12632582,12629609,12629609,1392,1996,385840,21319,407159,0e6e20c7dfec8f752bb6ed78b747518413c4bac8
20200519,56,1535123,10687327,2944,41872,171713,9597,7217,5032,606,289484,2020-05-19T00:00:00Z,86432,171713,2020-05-19T00:00:00Z,12225394,12222450,12222450,1325,1597,380486,20853,401339,060bf3e153d4ada40e0795ca3b654a65ece5d108
20200518,56,1514270,10306841,3596,41748,170116,9755,7064,5257,602,283178,2020-05-18T00:00:00Z,85107,170116,2020-05-18T00:00:00Z,11824707,11821111,11821111,844,1157,333721,20992,354713,9a141b4b042e58d25309356fbaa45ebf12b3184a
20200517,56,1493278,9973120,3449,41785,168959,9932,7003,5467,593,272265,2020-05-17T00:00:00Z,84263,168959,2020-05-17T00:00:00Z,11469847,11466398,11466398,846,1199,350983,20171,371154,c24eb74f6445fd434d1e29cf48ab0df8527fb09f
20200516,56,1473107,9622137,3788,43396,167760,10277,6945,5529,592,268376,2020-05-16T00:00:00Z,83417,167760,2020-05-16T00:00:00Z,11099032,11095244,11095244,984,1856,337419,24701,362120,ba6aa485e89250395acbc516e22491cd78c19059
20200515,56,1448406,9284718,2457,44491,165904,10472,6890,5746,589,250747,2020-05-15T00:00:00Z,82433,165904,2020-05-15T00:00:00Z,10735581,10733124,10733124,1502,1353,333613,24710,358323,86a55ca0ef2ad16352c5967ff26baf429c157b63
20200514,56,1423696,8951105,2673,45790,164551,10656,6795,5940,582,246414,2020-05-14T00:00:00Z,80931,164551,2020-05-14T00:00:00Z,10377474,10374801,10374801,1871,3206,337369,26705,364074,f4f698fcafc27b4b128b0f92809d867323f2e9a8
20200513,56,1396991,8613736,1983,46926,161345,10978,6713,6156,572,243430,2020-05-13T00:00:00Z,79060,161345,2020-05-13T00:00:00Z,10012710,10010727,10010727,1696,1809,297848,21193,319041,71fb9211ab152d40037a2956a262a879da333abb
20200512,56,1375798,8315888,1803,47596,159536,11241,5595,6352,559,238857,2020-05-12T00:00:00Z,77364,159536,2020-05-12T00:00:00Z,9693489,9691686,9691686,1472,1579,285892,22663,308555,b2403bd6ff071e037c68484b1c3b25310e54697a
20200511,56,1353135,8029996,1989,46552,157957,11147,6488,6350,551,232142,2020-05-11T00:00:00Z,75892,157957,2020-05-11T00:00:00Z,9385120,9383131,9383131,887,1238,363887,18236,382123,c3920b5bc47d9471f54504a7254a312b65278c70
20200510,56,1334899,7666109,3095,47163,156719,11393,6445,6395,547,215591,2020-05-10T00:00:00Z,75005,156719,2020-05-10T00:00:00Z,9004103,9001008,9001008,1024,1055,244826,21504,266330,23f0d514c31ff77ce4965c6bbfa0d7d4dd958e7a
20200509,56,1313395,7421283,3054,48768,155664,11496,6367,6551,543,211976,2020-05-09T00:00:00Z,73981,155664,2020-05-09T00:00:00Z,8737732,8734678,8734678,1432,1708,266799,24810,291609,0ed55abd5f5e9881886a2087611b4bc9f3b5d970
20200508,56,1288585,7154484,3307,49992,153956,11780,6294,6788,531,198459,2020-05-08T00:00:00Z,72549,153956,2020-05-08T00:00:00Z,8446376,8443069,8443069,1779,6892,270245,27605,297850,37f2e8c5fdda478dc758e5d7b1c15f802946766f
20200507,56,1260980,6884239,3171,51683,147064,12137,5174,7070,529,194528,2020-05-07T00:00:00Z,70770,147064,2020-05-07T00:00:00Z,8148390,8145219,8145219,2740,3742,274154,27490,301644,2be851e637535dad6c06f8896e16fe10aa08f7a4
20200506,56,1233490,6610085,2742,52773,143322,12478,4911,4753,449,189425,2020-05-06T00:00:00Z,68030,143322,2020-05-06T00:00:00Z,7846317,7843575,7843575,1932,2119,219777,25056,244833,85c1d4182f855d14d76b8ab95339b5a82d66fe31
20200505,56,1208434,6390308,2633,53455,141203,12629,4794,4818,439,189336,2020-05-05T00:00:00Z,66098,141203,2020-05-05T00:00:00Z,7601375,7598742,7598742,2445,1983,249022,22449,271471,8a76c0953a019de3da84c5249152c74ac6719463
20200504,56,1185985,6141286,2791,52634,139220,12696,4579,4848,430,186752,2020-05-04T00:00:00Z,63653,139220,2020-05-04T00:00:00Z,7330062,7327271,7327271,1012,1651,208933,22523,231456,0900deeb465630c7897b570653b405d002595e2e
20200503,56,1163462,5932353,2812,52857,137569,12722,4502,4761,425,179733,2020-05-03T00:00:00Z,62641,137569,2020-05-03T00:00:00Z,7098627,7095815,7095815,1206,1963,210747,25767,236514,6bf1a99939970b0686d12e89342f65dc8afe824d
20200502,56,1137695,5721606,1578,54278,135606,12904,4386,4845,375,174987,2020-05-02T00:00:00Z,61435,135606,2020-05-02T00:00:00Z,6860879,6859301,6859301,1541,2031,217899,29185,247084,f1413bd5784395412e0881b0a749723408ff334a
20200501,56,1108510,5503707,1639,55122,133575,12845,4300,4707,376,163644,2020-05-01T00:00:00Z,59894,133575,2020-05-01T00:00:00Z,6613856,6612217,6612217,1753,9789,262170,33056,295226,b6b66272849a395a212e7ad49edc1cdea894d6bd
20200430,56,1075454,5241537,2775,55114,123786,13255,4192,4712,373,154648,2020-04-30T00:00:00Z,58141,123786,2020-04-30T00:00:00Z,6319766,6316991,6316991,2117,2290,203240,29568,232808,23a423aef79a5eefb17da820bcbb1a845c4a1166
20200429,56,1045886,5038297,4832,56206,121496,13535,4093,4796,365,147165,2020-04-29T00:00:00Z,56024,121496,2020-04-29T00:00:00Z,6089015,6084183,6084183,2692,3415,211964,26641,238605,eb315e6a3bb1dcc83b5de44a3fb9c2b58ad86c05
20200428,56,1019245,4826333,4206,56255,118081,13562,3798,4760,195,139041,2020-04-28T00:00:00Z,53332,118081,2020-04-28T00:00:00Z,5849784,5845578,5845578,2042,2079,181395,25219,206614,326c3806e6b5174a76d0041c76f0ac3c0d8c1e95
20200427,56,994026,4644938,4077,56191,116002,13812,3720,4867,195,121323,2020-04-27T00:00:00Z,51290,116002,2020-04-27T00:00:00Z,5643041,5638964,5638964,1237,3076,172795,22605,195400,f7bd06e9998ca40f925bf382932d1a4feb4065e1
20200426,56,971421,4472143,4445,56186,112926,14099,2571,5121,227,116529,2020-04-26T00:00:00Z,50053,112926,2020-04-26T00:00:00Z,5448009,5443564,5443564,1188,2192,178908,27380,206288,70bba07d3f7572545444dc464e0ccec918f20f34
20200425,56,944041,4293235,5315,57377,110734,14414,2516,5266,227,112539,2020-04-25T00:00:00Z,48865,110734,2020-04-25T00:00:00Z,5242591,5237276,5237276,1714,2456,240249,35901,276150,377906401d59e940fc9edb081074eaeea1f7a349
20200424,56,908140,4052986,4396,57300,108278,14602,2468,5187,227,101296,2020-04-24T00:00:00Z,47151,108278,2020-04-24T00:00:00Z,4965522,4961126,4961126,1865,2338,201683,34174,235857,bc59ca2f7b89ce5f7b9ed45e2cdfe7cd3b80bdb5
20200423,56,873966,3851303,4258,58989,105940,14744,2428,5464,227,96921,2020-04-23T00:00:00Z,45286,105940,2020-04-23T00:00:00Z,4729527,4725269,4725269,1764,2802,161026,31784,192810,c60fcf415436700fcce887cda569af23ee4655a7
20200422,56,842182,3690277,4191,59205,103138,15015,2370,5474,227,92978,2020-04-22T00:00:00Z,43522,103138,2020-04-22T00:00:00Z,4536650,4532459,4532459,2065,3087,294567,28916,323483,6e6ad751e9e929a98ca329f142ceaf7eff37641e
20200421,56,813266,3395710,3956,59780,100051,14941,2315,5514,214,72842,2020-04-21T00:00:00Z,41457,100051,2020-04-21T00:00:00Z,4212932,4208976,4208976,2429,2682,126501,26333,152834,a2e9dd04de76b12127bea679332bf042f1069b80
20200420,56,786933,3269209,4037,56783,97369,14489,2193,5567,214,69493,2020-04-20T00:00:00Z,39028,97369,2020-04-20T00:00:00Z,4060179,4056142,4056142,1765,2211,119816,25872,145688,5200ef1426dff560a8bd499b5690322e135d1c3b
20200419,56,761061,3149393,11324,56526,95158,14410,2145,5603,214,67205,2020-04-19T00:00:00Z,37263,95158,2020-04-19T00:00:00Z,3921778,3910454,3910454,1733,2239,126462,27468,153930,c034b8883e27a4c5bbe45aee419bd0c3ed5cb62e
20200418,56,733593,3022931,9906,57761,92919,14768,2096,5729,205,62840,2020-04-18T00:00:00Z,35530,92919,2020-04-18T00:00:00Z,3766430,3756524,3756524,1837,3563,117871,27963,145834,1735f29d76b555a1c103204abe52037567bb3ad7
20200417,56,705630,2905060,10889,58895,89356,14890,2052,6096,148,53533,2020-04-17T00:00:00Z,33693,89356,2020-04-17T00:00:00Z,3621579,3610690,3610690,2077,3405,126720,31964,158684,59b00b689473f59601573a2509c0a7cd8df5fc6b
20200416,56,673666,2778340,16927,59499,85951,15130,1834,5940,137,48851,2020-04-16T00:00:00Z,31616,85951,2020-04-16T00:00:00Z,3468933,3452006,3452006,2141,3071,132875,30923,163798,2d6f23af93c527f13ded224668208b169760e6ac
20200415,56,642743,2645465,16901,59940,82880,14647,1783,6032,223,43435,2020-04-15T00:00:00Z,29475,82880,2020-04-15T00:00:00Z,3305109,3288208,3288208,2486,4434,106684,30298,136982,407002d6344d736d71074a7cca9d54f645300371
20200414,56,612445,2538781,16615,59601,78446,14039,1715,5975,221,39268,2020-04-14T00:00:00Z,26989,78446,2020-04-14T00:00:00Z,3167841,3151226,3151226,2287,3282,126141,25631,151772,e81577b229de81a231f3654519c190450b1ecbf3
20200413,56,586814,2412640,17159,56195,75164,13632,1628,6168,210,35372,2020-04-13T00:00:00Z,24702,75164,2020-04-13T00:00:00Z,3016613,2999454,2999454,1572,4285,109050,25133,134183,32bf8eed0aa91c90e37d264896bfc38175c6c3fc
20200412,56,561681,2303590,16419,55426,70879,13623,1455,5986,160,34081,2020-04-12T00:00:00Z,23130,70879,2020-04-12T00:00:00Z,2881690,2865271,2865271,1630,3288,111073,27844,138917,78e61f51e61e5a69e0f6d2ab01f2198f0d0e5f4c
20200411,56,533837,2192517,16593,55572,67591,13280,1405,5978,154,31567,2020-04-11T00:00:00Z,21500,67591,2020-04-11T00:00:00Z,2742947,2726354,2726354,1982,2825,106426,30561,136987,93fde136f405d2aae32d42b6fe5f0b2847947237
20200410,56,503276,2086091,17435,52723,64766,12698,1185,5937,41,28997,2020-04-10T00:00:00Z,19518,64766,2020-04-10T00:00:00Z,2606802,2589367,2589367,2055,4934,124042,34351,158393,5020a8ac93dd32ff72d5d9521b9323f3475a464b
20200409,56,468925,1962049,17622,50859,59832,12254,924,5794,39,24819,2020-04-09T00:00:00Z,17463,59832,2020-04-09T00:00:00Z,2448596,2430974,2430974,1972,3923,136639,34419,171058,627f31ed714d64d02ac2fb1d2324f76e05c32598
20200408,56,434506,1825410,17219,45141,55909,10180,1013,4131,216,21102,2020-04-08T00:00:00Z,15491,55909,2020-04-08T00:00:00Z,2277135,2259916,2259916,1944,4311,116954,30534,147488,cd1d3f9e2b2f16ec5484f89708b3851e6c262645
20200407,56,403972,1708456,16548,43465,51598,9821,889,4076,151,18443,2020-04-07T00:00:00Z,13547,51598,2020-04-07T00:00:00Z,2128976,2112428,2112428,1956,2981,123505,30737,154242,dff536999ed0964f366ab23de118438b9f8a5af0
20200406,56,373235,1584951,17283,35856,48617,6943,814,2961,147,16554,2020-04-06T00:00:00Z,11591,48617,2020-04-06T00:00:00Z,1975469,1958186,1958186,1254,2946,123071,28937,152008,e729f9b47be2bae439b707b10d843f006dd3670f
20200405,56,344298,1461880,17303,31875,45671,5677,760,652,147,14513,2020-04-05T00:00:00Z,10337,45671,2020-04-05T00:00:00Z,1823481,1806178,1806178,1285,3903,94105,25550,119655,fe23241dbbd30ed1d27b2d1a2f5ccddba0fbc87e
20200404,56,318748,1367775,15569,29987,41768,5383,554,656,147,12816,2020-04-04T00:00:00Z,9052,41768,2020-04-04T00:00:00Z,1702092,1686523,1686523,1440,5086,195941,33252,229193,345b3b99d14dc86e63a6d2beb826564932b07029
20200403,56,285496,1171834,61976,25472,36682,4811,486,605,147,10861,2020-04-03T00:00:00Z,7612,36682,2020-04-03T00:00:00Z,1519306,1457330,1457330,1259,4554,100945,31945,132890,91c749c06717a2e31ff59949c1a3cc855593bdba
20200402,56,253551,1070889,62097,22764,32128,4410,456,574,140,8586,2020-04-02T00:00:00Z,6353,32128,2020-04-02T00:00:00Z,1386537,1324440,1324440,1149,4175,90859,27992,118851,db385e98e7e0ca9d36288d9e5be624c717e32c1b
20200401,56,225559,980030,59665,20775,27953,3937,407,561,140,7084,2020-04-01T00:00:00Z,5204,27953,2020-04-01T00:00:00Z,1265254,1205589,1205589,988,4228,82748,25773,108521,ffc76ba56f6fee5d593b32fd7a30fb23ccd5e30e
20200331,56,199786,897282,59518,18082,23725,3487,236,507,,5666,2020-03-31T00:00:00Z,4216,23725,2020-03-31T00:00:00Z,1156586,1097068,1097068,861,3906,87636,24694,112330,1cb7d4e0ef9807fcf2a94932bb9b55bb9a1bd16d
20200330,56,175092,809646,65369,15772,19819,3087,187,451,,4560,2020-03-30T00:00:00Z,3355,19819,2020-03-30T00:00:00Z,1050107,984738,984738,577,2536,96564,21897,118461,9b975d704d47957023a24635ad87e862fc587dfa
20200329,56,153195,713082,65545,14026,17283,2456,156,439,,4052,2020-03-29T00:00:00Z,2778,17283,2020-03-29T00:00:00Z,931822,866277,866277,516,2775,67957,19655,87612,2605410d39dfbe405badd29d4bb3777049512678
20200328,56,133540,645125,65709,12350,14508,2174,140,390,,3143,2020-03-28T00:00:00Z,2262,14508,2020-03-28T00:00:00Z,844374,778665,778665,519,2425,87146,19724,106870,04cef5101f30dabc8780cca7dfd2d872096babf3
20200327,56,113816,557979,60091,10932,12083,1792,124,324,,2418,2020-03-27T00:00:00Z,1743,12083,2020-03-27T00:00:00Z,731886,671795,671795,401,2563,83612,19044,102656,b408d231da71bb2cd241b5fb6e161aa76d9756d8
20200326,56,94772,474367,60251,7757,9520,1299,91,258,,97,2020-03-26T00:00:00Z,1342,9520,2020-03-26T00:00:00Z,629390,569139,569139,311,2499,84159,17656,101815,3c8f170d23af93af244134a63a90b6a5ee4ce2f5
20200325,56,77116,390208,51235,5062,7021,,74,167,,146,2020-03-25T00:00:00Z,1031,7021,2020-03-25T00:00:00Z,518559,467324,467324,232,1904,71521,12873,84394,edea4bdc4c954599ba14d04653b5fbb6dbc0254f
20200324,56,64243,318687,14433,3902,5117,,,,,,2020-03-24T00:00:00Z,799,5117,2020-03-24T00:00:00Z,397363,382930,382930,231,1180,58505,10632,69137,9dc12a7be7f4a9432ec4219dddf44b034acdc983
20200323,56,53611,260182,14571,2770,3937,,,,,,2020-03-23T00:00:00Z,568,3937,2020-03-23T00:00:00Z,328364,313793,313793,97,914,46706,11442,58148,69b731e567219d6c83b1a201d02b1ad25237c001
20200322,56,42169,213476,2842,2155,3023,,,,,,2020-03-22T00:00:00Z,471,3023,2020-03-22T00:00:00Z,258487,255645,255645,143,1003,36214,9259,45473,b6f09490f0a6b206f260a63337096d9b7aa66103
20200321,56,32910,177262,3468,1436,2020,,,,,,2020-03-21T00:00:00Z,328,2020,2020-03-21T00:00:00Z,213640,210172,210172,61,1912,38448,6885,45333,29fbc4bcae2ba51d57a939c18bef4b29fdcceaa0
20200320,56,26025,138814,3330,1042,108,,,,,,2020-03-20T00:00:00Z,267,108,2020-03-20T00:00:00Z,168169,164839,164839,68,23,30407,6255,36662,09fb86c2fc17276f939b02e06769c4e272a04736
20200319,56,19770,108407,3016,617,85,,,,,,2020-03-19T00:00:00Z,199,85,2020-03-19T00:00:00Z,131193,128177,128177,46,18,23410,4671,28081,96cc0ff577ba54a62189e22f97a9e84b8a5d696d
20200318,56,15099,84997,2526,416,67,,,,,,2020-03-18T00:00:00Z,153,67,2020-03-18T00:00:00Z,102622,100096,100096,31,12,21893,3171,25064,45d96c40be4c956eb78422d3fc60ca8f7142758f
20200317,56,11928,63104,1687,325,55,,,,,,2020-03-17T00:00:00Z,122,55,2020-03-17T00:00:00Z,76719,75032,75032,22,13,13707,3613,17320,c3d5cf79abd31df00b2e9d41cb67f35b38ac1b81
20200316,56,8315,49397,1691,,42,,,,,,2020-03-16T00:00:00Z,100,42,2020-03-16T00:00:00Z,59403,57712,57712,21,6,16355,1569,17924,8ca2bf3f16866e855b0ec36e3481ceb7d3116d52
20200315,51,6746,33042,2242,,36,,,,,,2020-03-15T00:00:00Z,79,36,2020-03-15T00:00:00Z,42030,39788,39788,15,10,6353,1251,7604,d9129e8dd741b26b80d0b9180ccf7bd1ed98a480
20200314,51,5495,26689,1236,,26,,,,,,2020-03-14T00:00:00Z,64,26,2020-03-14T00:00:00Z,33420,32184,32184,9,4,3695,915,4610,49cc88b2bc27734b8f33ad1f66a723088a8b7c74
20200313,51,4580,22994,1130,,22,,,,,,2020-03-13T00:00:00Z,55,22,2020-03-13T00:00:00Z,28704,27574,27574,4,6,8146,1025,9171,682239005489591755bab6e073391e461b66d3e2
20200312,51,3555,14848,673,,16,,,,,,2020-03-12T00:00:00Z,51,16,2020-03-12T00:00:00Z,19076,18403,18403,8,5,4628,682,5310,531b3418e993cb86c70346d5cc2d763459f9221e
20200311,50,2873,10220,563,,11,,,,,,2020-03-11T00:00:00Z,43,11,2020-03-11T00:00:00Z,13656,13093,13093,6,3,3291,527,3818,58cdab18c3a7ebcf5c056033114d95e47c6580dc
20200310,50,2346,6929,469,,8,,,,,,2020-03-10T00:00:00Z,37,8,2020-03-10T00:00:00Z,9744,9275,9275,2,0,2049,441,2490,ab56d59efee3cc53d6b5ccb4ab2c2a013b3f288e
20200309,50,1905,4880,313,,8,,,,,,2020-03-09T00:00:00Z,35,8,2020-03-09T00:00:00Z,7098,6785,6785,4,2,1406,367,1773,eb067ecd1e4c000fa63581d54354a087acdb20a9
20200308,50,1538,3474,347,,6,,,,,,2020-03-08T00:00:00Z,31,6,2020-03-08T00:00:00Z,5359,5012,5012,4,0,607,267,874,123818b12d7bf319cf633fcae0eda458d42744f3
20200307,50,1271,2867,602,,6,,,,,,2020-03-07T00:00:00Z,27,6,2020-03-07T00:00:00Z,4740,4138,4138,1,0,578,220,798,65acb6af12715c6be8ca7b3803deb75ed408bd9f
20200306,36,1051,2289,458,,6,,,,,,2020-03-06T00:00:00Z,26,6,2020-03-06T00:00:00Z,3798,3340,3340,6,1,645,141,786,bff341983cc3d91067e76e695a7b20466039800f
20200305,24,910,1644,197,,5,,,,,,2020-03-05T00:00:00Z,20,5,2020-03-05T00:00:00Z,2751,2554,2554,4,1,464,153,617,bbeb057e0be9cfaa0574f478dd604069f36a2225
20200304,15,757,1180,103,,4,,,,,,2020-03-04T00:00:00Z,16,4,2020-03-04T00:00:00Z,2040,1937,1937,2,4,911,187,1098,3f96feb9ff9259be2ec3fbc99edc9eac7ff266e3
20200303,3,570,269,,,,,,,,,2020-03-03T00:00:00Z,14,,2020-03-03T00:00:00Z,839,839,839,3,0,143,100,243,f9727e4e13ad82cb735a5e52a102c5b76eeab777
20200302,3,470,126,,,,,,,,,2020-03-02T00:00:00Z,11,,2020-03-02T00:00:00Z,596,596,596,3,0,112,82,194,e34b83810217fb8afc398883fc82f67cd2a8978f
20200301,3,388,14,,,,,,,,,2020-03-01T00:00:00Z,8,,2020-03-01T00:00:00Z,402,402,402,3,0,-3,89,86,3d4d65c707c4ebccea4304d86716fb6e265762e1
20200229,1,299,17,,,,,,,,,2020-02-29T00:00:00Z,5,,2020-02-29T00:00:00Z,316,316,316,1,0,17,24,41,27c8dfcf504c66796dd4842c82d37d8a8b7d0c88
20200228,1,275,0,,,,,,,,,2020-02-28T00:00:00Z,4,,2020-02-28T00:00:00Z,275,275,275,2,0,0,40,40,0063e380f01c09a74ff18ab1940b36390ef365d9
20200227,1,235,0,,,,,,,,,2020-02-27T00:00:00Z,2,,2020-02-27T00:00:00Z,235,235,235,0,0,0,27,27,ffe41d6947d93d86a6f85189d9d0461c93f93d5e
20200226,1,208,0,,,,,,,,,2020-02-26T00:00:00Z,2,,2020-02-26T00:00:00Z,208,208,208,2,0,0,29,29,52535d8139a745270672daabd2f8824e38f7acee
20200225,1,179,0,,,,,,,,,2020-02-25T00:00:00Z,,,2020-02-25T00:00:00Z,179,179,179,0,0,0,31,31,fe9bd7ac1b1bb0403591268e0e18c10c7dd677f1
20200224,1,148,0,,,,,,,,,2020-02-24T00:00:00Z,,,2020-02-24T00:00:00Z,148,148,148,0,0,0,26,26,40f040514bdd96cea0529aa4fab368bf810ce3de
20200223,1,122,0,,,,,,,,,2020-02-23T00:00:00Z,,,2020-02-23T00:00:00Z,122,122,122,0,0,0,16,16,512963fd5bbfd45e6812ee673008fd7f1d9e9051
20200222,1,106,0,,,,,,,,,2020-02-22T00:00:00Z,,,2020-02-22T00:00:00Z,106,106,106,0,0,0,13,13,1e2edd13a951b782f2e36aa1335da750c5d605f6
20200221,1,93,0,,,,,,,,,2020-02-21T00:00:00Z,,,2020-02-21T00:00:00Z,93,93,93,0,0,0,11,11,775bae89a8c7819e65d3b0b1e05ad1a33b6bb9b7
20200220,1,82,0,,,,,,,,,2020-02-20T00:00:00Z,,,2020-02-20T00:00:00Z,82,82,82,0,0,0,13,13,d3832ff43d2ad63fbbac69ccc3a6f7a425671626
20200219,1,69,0,,,,,,,,,2020-02-19T00:00:00Z,,,2020-02-19T00:00:00Z,69,69,69,0,0,0,10,10,4eaba6a35cee6bf7863c306d80ebccead4f9e0b8
20200218,1,59,0,,,,,,,,,2020-02-18T00:00:00Z,,,2020-02-18T00:00:00Z,59,59,59,0,0,0,9,9,037f86e217230eeb1f82483e7bc38c3575d92f9b
20200217,1,50,0,,,,,,,,,2020-02-17T00:00:00Z,,,2020-02-17T00:00:00Z,50,50,50,0,0,0,15,15,654825b140100438046a5320976ca872c886835f
20200216,1,35,0,,,,,,,,,2020-02-16T00:00:00Z,,,2020-02-16T00:00:00Z,35,35,35,0,0,0,7,7,0d0ac95120a24edf715c33b7042a673a3ac72c22
20200215,1,28,0,,,,,,,,,2020-02-15T00:00:00Z,,,2020-02-15T00:00:00Z,28,28,28,0,0,0,7,7,aa97543642db531c4455dcfbff575626241a3bbb
20200214,1,21,0,,,,,,,,,2020-02-14T00:00:00Z,,,2020-02-14T00:00:00Z,21,21,21,0,0,0,3,3,98bad0bbf2467633c3ba4522edc9da4a5a896bd1
20200213,1,18,0,,,,,,,,,2020-02-13T00:00:00Z,,,2020-02-13T00:00:00Z,18,18,18,0,0,0,0,0,7033407474f6f0f59a7b74854fcc812d655434c2
20200212,1,18,0,,,,,,,,,2020-02-12T00:00:00Z,,,2020-02-12T00:00:00Z,18,18,18,0,0,0,1,1,3b69cfc2335143142dbfcde2ba5732d7b892d037
20200211,1,17,0,,,,,,,,,2020-02-11T00:00:00Z,,,2020-02-11T00:00:00Z,17,17,17,0,0,0,1,1,cfe56ace9b8e5eae7ccc0dcb3ce89369077642ab
20200210,1,16,0,,,,,,,,,2020-02-10T00:00:00Z,,,2020-02-10T00:00:00Z,16,16,16,0,0,0,3,3,a620e75c6dc4c685fc26d5cca336cfc6ff614506
20200209,1,13,0,,,,,,,,,2020-02-09T00:00:00Z,,,2020-02-09T00:00:00Z,13,13,13,0,0,0,0,0,b71f4996ae8c6f14b2d694af20ae26e0fdc68f14
20200208,1,13,0,,,,,,,,,2020-02-08T00:00:00Z,,,2020-02-08T00:00:00Z,13,13,13,0,0,0,1,1,27c3180319798290a1198cbbee0c1ed2379fdc2e
20200207,1,12,0,,,,,,,,,2020-02-07T00:00:00Z,,,2020-02-07T00:00:00Z,12,12,12,0,0,0,1,1,b396ed198a3b1a49e6d52705bd47baf45e9c5ae3
20200206,1,11,0,,,,,,,,,2020-02-06T00:00:00Z,,,2020-02-06T00:00:00Z,11,11,11,0,0,0,3,3,d7fb4549ba2c79b594b34fa9ed191b58d71e3696
20200205,1,8,0,,,,,,,,,2020-02-05T00:00:00Z,,,2020-02-05T00:00:00Z,8,8,8,0,0,0,0,0,4ca0fa2b0948956f33b5a5788abefaf56f1fce99
20200204,1,8,0,,,,,,,,,2020-02-04T00:00:00Z,,,2020-02-04T00:00:00Z,8,8,8,0,0,0,1,1,a2c106780077754f6fc62f322ee1bb13059abf01
20200203,1,7,0,,,,,,,,,2020-02-03T00:00:00Z,,,2020-02-03T00:00:00Z,7,7,7,0,0,0,1,1,f675e1b9bbb0cae5b545c12b528a2d123c419fb9
20200202,1,6,0,,,,,,,,,2020-02-02T00:00:00Z,,,2020-02-02T00:00:00Z,6,6,6,0,0,0,2,2,cabf736289065d789dd6100385a980d65a1fbeeb
20200201,1,4,0,,,,,,,,,2020-02-01T00:00:00Z,,,2020-02-01T00:00:00Z,4,4,4,0,0,0,1,1,5d928ca7c6802a3183d4d549f6f746cde73b00ae
20200131,1,3,0,,,,,,,,,2020-01-31T00:00:00Z,,,2020-01-31T00:00:00Z,3,3,3,0,0,0,0,0,c5e11f3f448ee066a5d4ba1b23fc91ec00c54e86
20200130,1,3,0,,,,,,,,,2020-01-30T00:00:00Z,,,2020-01-30T00:00:00Z,3,3,3,0,0,0,0,0,0a8e7117d2571e8984618900ff1d40d7f2c944fe
20200129,1,3,0,,,,,,,,,2020-01-29T00:00:00Z,,,2020-01-29T00:00:00Z,3,3,3,0,0,0,1,1,e960a515d1779fa15049c5935ab0574e595a87c8
20200128,1,2,0,,,,,,,,,2020-01-28T00:00:00Z,,,2020-01-28T00:00:00Z,2,2,2,0,0,0,0,0,0c443fe4c026a213030f976017c9fa95f115d5a7
20200127,1,2,0,,,,,,,,,2020-01-27T00:00:00Z,,,2020-01-27T00:00:00Z,2,2,2,0,0,0,0,0,3dde2425e73c17b4e6cbf0e4432340298c0a94f5
20200126,1,2,0,,,,,,,,,2020-01-26T00:00:00Z,,,2020-01-26T00:00:00Z,2,2,2,0,0,0,0,0,e1cf59ab48e1cf367c4a6798a508a23d9d36bd18
20200125,1,2,0,,,,,,,,,2020-01-25T00:00:00Z,,,2020-01-25T00:00:00Z,2,2,2,0,0,0,0,0,bef2a1d5f2a13491e0e0369bbd46c10cdd12973b
20200124,1,2,0,,,,,,,,,2020-01-24T00:00:00Z,,,2020-01-24T00:00:00Z,2,2,2,0,0,0,0,0,bfffe76fc0b7cf11efe8aecd3cc7b22598d77d61
20200123,1,2,0,,,,,,,,,2020-01-23T00:00:00Z,,,2020-01-23T00:00:00Z,2,2,2,0,0,0,0,0,cee36ebf3174bf1df0daa36e1e8088a157406fad
20200122,1,2,0,,,,,,,,,2020-01-22T00:00:00Z,,,2020-01-22T00:00:00Z,2,2,2,0,0,0,0,0,d538c99729d1fee626212d1878a100c1e1204a5f
